02;Albacete;001;Abengibre;782;386;396
02;Albacete;002;Alatoz;610;340;270
02;Albacete;003;Albacete;172121;84233;87888
02;Albacete;004;Albatana;744;380;364
02;Albacete;005;Alborea;754;394;360
02;Albacete;006;Alcadozo;699;372;327
02;Albacete;007;Alcalá del Júcar;1250;667;583
02;Albacete;008;Alcaraz;1529;774;755
02;Albacete;009;Almansa;24837;12359;12478
02;Albacete;010;Alpera;2326;1196;1130
02;Albacete;011;Ayna;717;385;332
02;Albacete;012;Balazote;2378;1228;1150
02;Albacete;014;Ballestero, El;442;226;216
02;Albacete;013;Balsa de Ves;172;102;70
02;Albacete;015;Barrax;1915;979;936
02;Albacete;016;Bienservida;664;346;318
02;Albacete;017;Bogarra;947;489;458
02;Albacete;018;Bonete;1127;580;547
02;Albacete;019;Bonillo, El;2915;1472;1443
02;Albacete;020;Carcelén;546;294;252
02;Albacete;021;Casas de Juan Núñez;1382;723;659
02;Albacete;022;Casas de Lázaro;403;228;175
02;Albacete;023;Casas de Ves;666;343;323
02;Albacete;024;Casas-Ibáñez;4658;2407;2251
02;Albacete;025;Caudete;10163;5167;4996
02;Albacete;026;Cenizate;1174;602;572
02;Albacete;029;Chinchilla de Monte-Aragón;4169;2165;2004
02;Albacete;027;Corral-Rubio;358;198;160
02;Albacete;028;Cotillas;141;75;66
02;Albacete;030;Elche de la Sierra;3761;1891;1870
02;Albacete;031;Férez;705;355;350
02;Albacete;032;Fuensanta;327;180;147
02;Albacete;033;Fuente-Álamo;2591;1366;1225
02;Albacete;034;Fuentealbilla;1901;962;939
02;Albacete;035;Gineta, La;2532;1294;1238
02;Albacete;036;Golosalvo;114;62;52
02;Albacete;037;Hellín;30592;15227;15365
02;Albacete;038;Herrera, La;347;180;167
02;Albacete;039;Higueruela;1249;649;600
02;Albacete;040;Hoya-Gonzalo;706;369;337
02;Albacete;041;Jorquera;400;213;187
02;Albacete;042;Letur;987;480;507
02;Albacete;043;Lezuza;1483;759;724
02;Albacete;044;Liétor;1321;686;635
02;Albacete;045;Madrigueras;4724;2424;2300
02;Albacete;046;Mahora;1422;722;700
02;Albacete;047;Masegoso;121;65;56
02;Albacete;048;Minaya;1564;801;763
02;Albacete;049;Molinicos;917;466;451
02;Albacete;050;Montalvos;108;56;52
02;Albacete;051;Montealegre del Castillo;2122;1075;1047
02;Albacete;052;Motilleja;555;290;265
02;Albacete;053;Munera;3643;1845;1798
02;Albacete;054;Navas de Jorquera;524;267;257
02;Albacete;055;Nerpio;1362;737;625
02;Albacete;056;Ontur;2141;1064;1077
02;Albacete;057;Ossa de Montiel;2510;1251;1259
02;Albacete;058;Paterna del Madera;378;205;173
02;Albacete;060;Peñas de San Pedro;1431;829;602
02;Albacete;059;Peñascosa;355;187;168
02;Albacete;061;Pétrola;737;382;355
02;Albacete;062;Povedilla;471;250;221
02;Albacete;901;Pozo Cañada;2811;1409;1402
02;Albacete;063;Pozohondo;1717;896;821
02;Albacete;064;Pozo-Lorente;415;210;205
02;Albacete;065;Pozuelo;542;284;258
02;Albacete;066;Recueja, La;275;141;134
02;Albacete;067;Riópar;1448;738;710
02;Albacete;068;Robledo;405;210;195
02;Albacete;069;Roda, La;15868;8011;7857
02;Albacete;070;Salobre;554;290;264
02;Albacete;071;San Pedro;1316;668;648
02;Albacete;072;Socovos;1832;942;890
02;Albacete;073;Tarazona de la Mancha;6543;3317;3226
02;Albacete;074;Tobarra;7973;4051;3922
02;Albacete;075;Valdeganga;1991;1011;980
02;Albacete;076;Vianos;376;192;184
02;Albacete;077;Villa de Ves;59;33;26
02;Albacete;078;Villalgordo del Júcar;1147;596;551
02;Albacete;079;Villamalea;4106;2067;2039
02;Albacete;080;Villapalacios;628;327;301
02;Albacete;081;Villarrobledo;25989;12894;13095
02;Albacete;082;Villatoya;115;68;47
02;Albacete;083;Villavaliente;238;138;100
02;Albacete;084;Villaverde de Guadalimar;373;200;173
02;Albacete;085;Viveros;300;151;149
02;Albacete;086;Yeste;2869;1471;1398
03;Alicante/Alacant;001;Adsubia;632;324;308
03;Alicante/Alacant;002;Agost;4707;2378;2329
03;Alicante/Alacant;003;Agres;574;307;267
03;Alicante/Alacant;004;Aigües;937;501;436
03;Alicante/Alacant;005;Albatera;11780;5993;5787
03;Alicante/Alacant;006;Alcalalí;1311;661;650
03;Alicante/Alacant;007;Alcocer de Planes;216;111;105
03;Alicante/Alacant;008;Alcoleja;184;96;88
03;Alicante/Alacant;009;Alcoy/Alcoi;59567;29007;30560
03;Alicante/Alacant;010;Alfafara;406;198;208
03;Alicante/Alacant;011;Alfàs del Pi, l';21700;10781;10919
03;Alicante/Alacant;012;Algorfa;3693;1852;1841
03;Alicante/Alacant;013;Algueña;1413;706;707
03;Alicante/Alacant;014;Alicante/Alacant;328648;159401;169247
03;Alicante/Alacant;015;Almoradí;19955;10098;9857
03;Alicante/Alacant;016;Almudaina;114;61;53
03;Alicante/Alacant;017;Alqueria d'Asnar, l';522;244;278
03;Alicante/Alacant;018;Altea;22385;11008;11377
03;Alicante/Alacant;019;Aspe;20406;10299;10107
03;Alicante/Alacant;020;Balones;133;69;64
03;Alicante/Alacant;021;Banyeres de Mariola;7155;3569;3586
03;Alicante/Alacant;022;Benasau;155;76;79
03;Alicante/Alacant;023;Beneixama;1746;864;882
03;Alicante/Alacant;024;Benejúzar;5398;2697;2701
03;Alicante/Alacant;025;Benferri;1899;992;907
03;Alicante/Alacant;026;Beniarbeig;1926;958;968
03;Alicante/Alacant;027;Beniardá;227;116;111
03;Alicante/Alacant;028;Beniarrés;1208;608;600
03;Alicante/Alacant;030;Benidoleig;1196;585;611
03;Alicante/Alacant;031;Benidorm;69045;34395;34650
03;Alicante/Alacant;032;Benifallim;114;63;51
03;Alicante/Alacant;033;Benifato;156;79;77
03;Alicante/Alacant;029;Benigembla;490;248;242
03;Alicante/Alacant;034;Benijófar;3655;1798;1857
03;Alicante/Alacant;035;Benilloba;786;399;387
03;Alicante/Alacant;036;Benillup;101;47;54
03;Alicante/Alacant;037;Benimantell;501;238;263
03;Alicante/Alacant;038;Benimarfull;433;217;216
03;Alicante/Alacant;039;Benimassot;111;61;50
03;Alicante/Alacant;040;Benimeli;416;202;214
03;Alicante/Alacant;041;Benissa;11598;5735;5863
03;Alicante/Alacant;042;Benitachell/Poble Nou de Benitatxell, el;4690;2317;2373
03;Alicante/Alacant;043;Biar;3657;1796;1861
03;Alicante/Alacant;044;Bigastro;6714;3424;3290
03;Alicante/Alacant;045;Bolulla;426;217;209
03;Alicante/Alacant;046;Busot;3075;1559;1516
03;Alicante/Alacant;049;Callosa de Segura;18200;9158;9042
03;Alicante/Alacant;048;Callosa d'en Sarrià;7133;3602;3531
03;Alicante/Alacant;047;Calp;21540;10917;10623
03;Alicante/Alacant;050;Campello, el;27356;13390;13966
03;Alicante/Alacant;051;Campo de Mirra/Camp de Mirra, el;445;232;213
03;Alicante/Alacant;052;Cañada;1229;607;622
03;Alicante/Alacant;053;Castalla;9994;5056;4938
03;Alicante/Alacant;054;Castell de Castells;431;214;217
03;Alicante/Alacant;075;Castell de Guadalest, el;224;114;110
03;Alicante/Alacant;055;Catral;8690;4405;4285
03;Alicante/Alacant;056;Cocentaina;11406;5752;5654
03;Alicante/Alacant;057;Confrides;208;118;90
03;Alicante/Alacant;058;Cox;7229;3701;3528
03;Alicante/Alacant;059;Crevillent;28465;14419;14046
03;Alicante/Alacant;061;Daya Nueva;1732;879;853
03;Alicante/Alacant;062;Daya Vieja;668;345;323
03;Alicante/Alacant;063;Dénia;41553;20290;21263
03;Alicante/Alacant;064;Dolores;7246;3624;3622
03;Alicante/Alacant;065;Elche/Elx;227312;112783;114529
03;Alicante/Alacant;066;Elda;53248;25978;27270
03;Alicante/Alacant;067;Facheca;103;56;47
03;Alicante/Alacant;068;Famorca;52;26;26
03;Alicante/Alacant;069;Finestrat;6239;3208;3031
03;Alicante/Alacant;077;Fondó de les Neus, el/Hondón de las Nieves;2583;1305;1278
03;Alicante/Alacant;070;Formentera del Segura;4206;2144;2062
03;Alicante/Alacant;072;Gaianes;457;237;220
03;Alicante/Alacant;071;Gata de Gorgos;5885;2974;2911
03;Alicante/Alacant;073;Gorga;275;151;124
03;Alicante/Alacant;074;Granja de Rocamora;2425;1257;1168
03;Alicante/Alacant;076;Guardamar del Segura;15589;7704;7885
03;Alicante/Alacant;078;Hondón de los Frailes;1160;604;556
03;Alicante/Alacant;079;Ibi;23321;11669;11652
03;Alicante/Alacant;080;Jacarilla;1930;973;957
03;Alicante/Alacant;082;Jávea/Xàbia;27681;13704;13977
03;Alicante/Alacant;083;Jijona/Xixona;7205;3508;3697
03;Alicante/Alacant;085;Llíber;1099;541;558
03;Alicante/Alacant;084;Lorcha/Orxa, l';650;323;327
03;Alicante/Alacant;086;Millena;224;115;109
03;Alicante/Alacant;088;Monforte del Cid;7603;3967;3636
03;Alicante/Alacant;089;Monóvar/Monòver;12381;6170;6211
03;Alicante/Alacant;903;Montesinos, Los;4921;2497;2424
03;Alicante/Alacant;091;Murla;516;241;275
03;Alicante/Alacant;092;Muro de Alcoy;9167;4541;4626
03;Alicante/Alacant;090;Mutxamel;24256;12072;12184
03;Alicante/Alacant;093;Novelda;26146;12968;13178
03;Alicante/Alacant;094;Nucia, la;20039;10154;9885
03;Alicante/Alacant;095;Ondara;6617;3319;3298
03;Alicante/Alacant;096;Onil;7548;3769;3779
03;Alicante/Alacant;097;Orba;2210;1097;1113
03;Alicante/Alacant;099;Orihuela;82675;41273;41402
03;Alicante/Alacant;098;Orxeta;850;436;414
03;Alicante/Alacant;100;Parcent;997;497;500
03;Alicante/Alacant;101;Pedreguer;7337;3636;3701
03;Alicante/Alacant;102;Pego;10331;5195;5136
03;Alicante/Alacant;103;Penàguila;353;193;160
03;Alicante/Alacant;104;Petrer;34586;17243;17343
03;Alicante/Alacant;902;Pilar de la Horadada;21629;11148;10481
03;Alicante/Alacant;105;Pinós, el/Pinoso;7695;3881;3814
03;Alicante/Alacant;106;Planes;753;396;357
03;Alicante/Alacant;901;Poblets, els;3303;1602;1701
03;Alicante/Alacant;107;Polop;4369;2252;2117
03;Alicante/Alacant;060;Quatretondeta;111;60;51
03;Alicante/Alacant;109;Rafal;4167;2094;2073
03;Alicante/Alacant;110;Ràfol d'Almúnia, el;635;318;317
03;Alicante/Alacant;111;Redován;7706;4006;3700
03;Alicante/Alacant;112;Relleu;1279;631;648
03;Alicante/Alacant;113;Rojales;18127;9188;8939
03;Alicante/Alacant;114;Romana, la;2431;1253;1178
03;Alicante/Alacant;115;Sagra;410;211;199
03;Alicante/Alacant;116;Salinas;1597;812;785
03;Alicante/Alacant;118;San Fulgencio;9021;4527;4494
03;Alicante/Alacant;904;San Isidro;1874;961;913
03;Alicante/Alacant;120;San Miguel de Salinas;6773;3379;3394
03;Alicante/Alacant;122;San Vicente del Raspeig/Sant Vicent del Raspeig;56302;27906;28396
03;Alicante/Alacant;117;Sanet y Negrals;674;329;345
03;Alicante/Alacant;119;Sant Joan d'Alacant;22825;11058;11767
03;Alicante/Alacant;121;Santa Pola;31657;15975;15682
03;Alicante/Alacant;123;Sax;9696;4881;4815
03;Alicante/Alacant;124;Sella;588;317;271
03;Alicante/Alacant;125;Senija;610;320;290
03;Alicante/Alacant;127;Tàrbena;661;346;315
03;Alicante/Alacant;128;Teulada;11460;5679;5781
03;Alicante/Alacant;129;Tibi;1656;866;790
03;Alicante/Alacant;130;Tollos;52;28;24
03;Alicante/Alacant;131;Tormos;312;161;151
03;Alicante/Alacant;132;Torremanzanas/Torre de les Maçanes, la;746;391;355
03;Alicante/Alacant;133;Torrevieja;88447;44526;43921
03;Alicante/Alacant;134;Vall d'Alcalà, la;169;87;82
03;Alicante/Alacant;136;Vall de Gallinera;609;331;278
03;Alicante/Alacant;137;Vall de Laguar, la;826;419;407
03;Alicante/Alacant;135;Vall d'Ebo, la;249;131;118
03;Alicante/Alacant;138;Verger, el;4627;2293;2334
03;Alicante/Alacant;139;Villajoyosa/Vila Joiosa, la;33878;16962;16916
03;Alicante/Alacant;140;Villena;34361;17151;17210
03;Alicante/Alacant;081;Xaló;2675;1338;1337
04;Almería;001;Abla;1342;689;653
04;Almería;002;Abrucena;1279;656;623
04;Almería;003;Adra;24670;12453;12217
04;Almería;004;Albánchez;805;404;401
04;Almería;005;Alboloduy;653;314;339
04;Almería;006;Albox;11429;5828;5601
04;Almería;007;Alcolea;812;423;389
04;Almería;008;Alcóntar;570;314;256
04;Almería;009;Alcudia de Monteagud;168;83;85
04;Almería;010;Alhabia;700;359;341
04;Almería;011;Alhama de Almería;3763;1897;1866
04;Almería;012;Alicún;220;113;107
04;Almería;013;Almería;194203;94475;99728
04;Almería;014;Almócita;173;85;88
04;Almería;015;Alsodux;138;75;63
04;Almería;016;Antas;3195;1597;1598
04;Almería;017;Arboleas;4670;2321;2349
04;Almería;018;Armuña de Almanzora;332;165;167
04;Almería;019;Bacares;278;142;136
04;Almería;020;Bayárcal;336;185;151
04;Almería;021;Bayarque;216;109;107
04;Almería;022;Bédar;990;484;506
04;Almería;023;Beires;119;55;64
04;Almería;024;Benahadux;4183;2071;2112
04;Almería;026;Benitagla;78;42;36
04;Almería;027;Benizalón;283;146;137
04;Almería;028;Bentarique;258;145;113
04;Almería;029;Berja;15174;7653;7521
04;Almería;030;Canjáyar;1342;698;644
04;Almería;031;Cantoria;3580;1805;1775
04;Almería;032;Carboneras;7838;4034;3804
04;Almería;033;Castro de Filabres;147;71;76
04;Almería;036;Chercos;275;145;130
04;Almería;037;Chirivel;1604;812;792
04;Almería;034;Cóbdar;183;103;80
04;Almería;035;Cuevas del Almanzora;13292;6882;6410
04;Almería;038;Dalías;3979;1968;2011
04;Almería;902;Ejido, El;85961;45335;40626
04;Almería;041;Enix;437;246;191
04;Almería;043;Felix;688;385;303
04;Almería;044;Fines;2143;1118;1025
04;Almería;045;Fiñana;2134;1078;1056
04;Almería;046;Fondón;1020;532;488
04;Almería;047;Gádor;3027;1577;1450
04;Almería;048;Gallardos, Los;2973;1521;1452
04;Almería;049;Garrucha;8577;4412;4165
04;Almería;050;Gérgal;1093;568;525
04;Almería;051;Huécija;515;247;268
04;Almería;052;Huércal de Almería;16823;8596;8227
04;Almería;053;Huércal-Overa;18530;9204;9326
04;Almería;054;Illar;380;199;181
04;Almería;055;Instinción;458;225;233
04;Almería;056;Laroya;178;100;78
04;Almería;057;Láujar de Andarax;1574;785;789
04;Almería;058;Líjar;431;222;209
04;Almería;059;Lubrín;1568;762;806
04;Almería;060;Lucainena de las Torres;606;315;291
04;Almería;061;Lúcar;772;382;390
04;Almería;062;Macael;5676;2904;2772
04;Almería;063;María;1285;661;624
04;Almería;064;Mojácar;6825;3387;3438
04;Almería;903;Mojonera, La;8963;4938;4025
04;Almería;065;Nacimiento;501;251;250
04;Almería;066;Níjar;28056;15163;12893
04;Almería;067;Ohanes;669;329;340
04;Almería;068;Olula de Castro;190;102;88
04;Almería;069;Olula del Río;6259;3223;3036
04;Almería;070;Oria;2428;1262;1166
04;Almería;071;Padules;464;237;227
04;Almería;072;Partaloa;673;321;352
04;Almería;073;Paterna del Río;376;215;161
04;Almería;074;Pechina;3860;1968;1892
04;Almería;075;Pulpí;8762;4524;4238
04;Almería;076;Purchena;1686;865;821
04;Almería;077;Rágol;338;177;161
04;Almería;078;Rioja;1374;686;688
04;Almería;079;Roquetas de Mar;90623;46592;44031
04;Almería;080;Santa Cruz de Marchena;254;128;126
04;Almería;081;Santa Fe de Mondújar;448;228;220
04;Almería;082;Senés;330;173;157
04;Almería;083;Serón;2167;1100;1067
04;Almería;084;Sierro;392;207;185
04;Almería;085;Somontín;492;244;248
04;Almería;086;Sorbas;2608;1373;1235
04;Almería;087;Suflí;252;132;120
04;Almería;088;Tabernas;3668;1910;1758
04;Almería;089;Taberno;1000;495;505
04;Almería;090;Tahal;396;203;193
04;Almería;091;Terque;417;207;210
04;Almería;092;Tíjola;3701;1826;1875
04;Almería;901;Tres Villas, Las;615;321;294
04;Almería;093;Turre;3346;1696;1650
04;Almería;094;Turrillas;242;137;105
04;Almería;095;Uleila del Campo;897;456;441
04;Almería;096;Urrácal;336;170;166
04;Almería;097;Velefique;268;145;123
04;Almería;098;Vélez-Blanco;2035;1057;978
04;Almería;099;Vélez-Rubio;6767;3304;3463
04;Almería;100;Vera;15108;7669;7439
04;Almería;101;Viator;5698;2947;2751
04;Almería;102;Vícar;24571;13011;11560
04;Almería;103;Zurgena;3030;1504;1526
01;Araba/Álava;001;Alegría-Dulantzi;2882;1491;1391
01;Araba/Álava;002;Amurrio;10263;5099;5164
01;Araba/Álava;049;Añana;157;87;70
01;Araba/Álava;003;Aramaio;1518;797;721
01;Araba/Álava;006;Armiñón;244;123;121
01;Araba/Álava;037;Arraia-Maeztu;712;404;308
01;Araba/Álava;008;Arratzua-Ubarrundia;997;542;455
01;Araba/Álava;004;Artziniega;1829;908;921
01;Araba/Álava;009;Asparrena;1647;834;813
01;Araba/Álava;010;Ayala/Aiara;2927;1477;1450
01;Araba/Álava;011;Baños de Ebro/Mañueta;311;169;142
01;Araba/Álava;013;Barrundia;905;500;405
01;Araba/Álava;014;Berantevilla;467;237;230
01;Araba/Álava;016;Bernedo;526;312;214
01;Araba/Álava;017;Campezo/Kanpezu;1069;565;504
01;Araba/Álava;021;Elburgo/Burgelu;608;318;290
01;Araba/Álava;022;Elciego;1051;521;530
01;Araba/Álava;023;Elvillar/Bilar;353;175;178
01;Araba/Álava;046;Erriberagoitia/Ribera Alta;773;442;331
01;Araba/Álava;056;Harana/Valle de Arana;242;140;102
01;Araba/Álava;901;Iruña Oka/Iruña de Oca;3172;1648;1524
01;Araba/Álava;027;Iruraiz-Gauna;509;281;228
01;Araba/Álava;019;Kripan;182;98;84
01;Araba/Álava;020;Kuartango;362;209;153
01;Araba/Álava;028;Labastida/Bastida;1471;759;712
01;Araba/Álava;030;Lagrán;163;87;76
01;Araba/Álava;031;Laguardia;1520;782;738
01;Araba/Álava;032;Lanciego/Lantziego;679;350;329
01;Araba/Álava;902;Lantarón;893;506;387
01;Araba/Álava;033;Lapuebla de Labarca;860;449;411
01;Araba/Álava;036;Laudio/Llodio;18300;9046;9254
01;Araba/Álava;058;Legutio;1716;913;803
01;Araba/Álava;034;Leza;216;107;109
01;Araba/Álava;039;Moreda de Álava/Moreda Araba;233;117;116
01;Araba/Álava;041;Navaridas;231;142;89
01;Araba/Álava;042;Okondo;1156;604;552
01;Araba/Álava;043;Oyón-Oion;3320;1684;1636
01;Araba/Álava;044;Peñacerrada-Urizaharra;270;164;106
01;Araba/Álava;047;Ribera Baja/Erribera Beitia;1359;739;620
01;Araba/Álava;051;Salvatierra/Agurain;4986;2483;2503
01;Araba/Álava;052;Samaniego;294;150;144
01;Araba/Álava;053;San Millán/Donemiliaga;722;403;319
01;Araba/Álava;054;Urkabustaiz;1300;688;612
01;Araba/Álava;055;Valdegovía/Gaubea;1013;559;454
01;Araba/Álava;057;Villabuena de Álava/Eskuernaga;306;160;146
01;Araba/Álava;059;Vitoria-Gasteiz;243918;119369;124549
01;Araba/Álava;060;Yécora/Iekora;266;141;125
01;Araba/Álava;061;Zalduondo;196;108;88
01;Araba/Álava;062;Zambrana;406;219;187
01;Araba/Álava;018;Zigoitia;1765;953;812
01;Araba/Álava;063;Zuia;2383;1235;1148
33;Asturias;001;Allande;1826;915;911
33;Asturias;002;Aller;11555;5693;5862
33;Asturias;003;Amieva;727;388;339
33;Asturias;004;Avilés;80880;38314;42566
33;Asturias;005;Belmonte de Miranda;1641;846;795
33;Asturias;006;Bimenes;1768;840;928
33;Asturias;007;Boal;1669;834;835
33;Asturias;008;Cabrales;2094;1064;1030
33;Asturias;009;Cabranes;1056;543;513
33;Asturias;010;Candamo;2055;1014;1041
33;Asturias;012;Cangas de Onís;6498;3168;3330
33;Asturias;011;Cangas del Narcea;13451;6677;6774
33;Asturias;013;Caravia;501;254;247
33;Asturias;014;Carreño;10704;5163;5541
33;Asturias;015;Caso;1663;940;723
33;Asturias;016;Castrillón;22735;11018;11717
33;Asturias;017;Castropol;3638;1749;1889
33;Asturias;018;Coaña;3419;1668;1751
33;Asturias;019;Colunga;3518;1717;1801
33;Asturias;020;Corvera de Asturias;16088;7934;8154
33;Asturias;021;Cudillero;5210;2596;2614
33;Asturias;022;Degaña;1082;560;522
33;Asturias;023;Franco, El;3859;1895;1964
33;Asturias;024;Gijón;274290;129372;144918
33;Asturias;025;Gozón;10588;5164;5424
33;Asturias;026;Grado;10309;4967;5342
33;Asturias;027;Grandas de Salime;927;474;453
33;Asturias;028;Ibias;1473;816;657
33;Asturias;029;Illano;389;197;192
33;Asturias;030;Illas;1030;524;506
33;Asturias;031;Langreo;41738;19807;21931
33;Asturias;032;Laviana;13582;6526;7056
33;Asturias;033;Lena;11654;5634;6020
33;Asturias;035;Llanera;13904;6908;6996
33;Asturias;036;Llanes;13694;6664;7030
33;Asturias;037;Mieres;40338;19138;21200
33;Asturias;038;Morcín;2746;1367;1379
33;Asturias;039;Muros de Nalón;1883;893;990
33;Asturias;040;Nava;5411;2660;2751
33;Asturias;041;Navia;8644;4189;4455
33;Asturias;042;Noreña;5333;2559;2774
33;Asturias;043;Onís;763;402;361
33;Asturias;044;Oviedo;221870;103063;118807
33;Asturias;045;Parres;5490;2680;2810
33;Asturias;046;Peñamellera Alta;559;280;279
33;Asturias;047;Peñamellera Baja;1291;633;658
33;Asturias;048;Pesoz;172;89;83
33;Asturias;049;Piloña;7412;3663;3749
33;Asturias;050;Ponga;655;385;270
33;Asturias;051;Pravia;8667;4196;4471
33;Asturias;052;Proaza;786;450;336
33;Asturias;053;Quirós;1250;701;549
33;Asturias;054;Regueras, Las;1934;988;946
33;Asturias;055;Ribadedeva;1836;890;946
33;Asturias;056;Ribadesella;5904;2821;3083
33;Asturias;057;Ribera de Arriba;1890;963;927
33;Asturias;058;Riosa;2061;1038;1023
33;Asturias;059;Salas;5371;2659;2712
33;Asturias;061;San Martín de Oscos;422;209;213
33;Asturias;060;San Martín del Rey Aurelio;17182;8245;8937
33;Asturias;063;San Tirso de Abres;473;233;240
33;Asturias;062;Santa Eulalia de Oscos;471;248;223
33;Asturias;064;Santo Adriano;263;131;132
33;Asturias;065;Sariego;1276;615;661
33;Asturias;066;Siero;52191;25452;26739
33;Asturias;067;Sobrescobio;855;458;397
33;Asturias;068;Somiedo;1231;719;512
33;Asturias;069;Soto del Barco;3978;1957;2021
33;Asturias;070;Tapia de Casariego;3906;1900;2006
33;Asturias;071;Taramundi;698;333;365
33;Asturias;072;Teverga;1768;929;839
33;Asturias;073;Tineo;10128;5073;5055
33;Asturias;034;Valdés;12421;6035;6386
33;Asturias;074;Vegadeo;3960;1901;2059
33;Asturias;075;Villanueva de Oscos;310;155;155
33;Asturias;076;Villaviciosa;14690;7229;7461
33;Asturias;077;Villayón;1366;711;655
33;Asturias;078;Yernes y Tameza;159;92;67
05;Ávila;001;Adanero;231;127;104
05;Ávila;002;Adrada, La;2640;1383;1257
05;Ávila;005;Albornos;205;108;97
05;Ávila;007;Aldeanueva de Santa Cruz;123;67;56
05;Ávila;008;Aldeaseca;262;128;134
05;Ávila;010;Aldehuela, La;173;91;82
05;Ávila;012;Amavida;147;73;74
05;Ávila;013;Arenal, El;1011;506;505
05;Ávila;014;Arenas de San Pedro;6671;3239;3432
05;Ávila;015;Arevalillo;92;46;46
05;Ávila;016;Arévalo;8172;3981;4191
05;Ávila;017;Aveinte;84;46;38
05;Ávila;018;Avellaneda;29;17;12
05;Ávila;019;Ávila;58358;27902;30456
05;Ávila;021;Barco de Ávila, El;2576;1248;1328
05;Ávila;022;Barraco, El;1968;1019;949
05;Ávila;023;Barromán;196;106;90
05;Ávila;024;Becedas;236;127;109
05;Ávila;025;Becedillas;103;58;45
05;Ávila;026;Bercial de Zapardiel;221;118;103
05;Ávila;027;Berlanas, Las;330;168;162
05;Ávila;029;Bernuy-Zapardiel;131;75;56
05;Ávila;030;Berrocalejo de Aragona;51;27;24
05;Ávila;033;Blascomillán;197;101;96
05;Ávila;034;Blasconuño de Matacabras;15;9;6
05;Ávila;035;Blascosancho;117;57;60
05;Ávila;036;Bohodón, El;129;68;61
05;Ávila;037;Bohoyo;304;168;136
05;Ávila;038;Bonilla de la Sierra;129;76;53
05;Ávila;039;Brabos;49;30;19
05;Ávila;040;Bularros;69;43;26
05;Ávila;041;Burgohondo;1228;647;581
05;Ávila;042;Cabezas de Alambre;168;83;85
05;Ávila;043;Cabezas del Pozo;88;50;38
05;Ávila;044;Cabezas del Villar;261;151;110
05;Ávila;045;Cabizuela;98;51;47
05;Ávila;046;Canales;56;30;26
05;Ávila;047;Candeleda;5104;2597;2507
05;Ávila;048;Cantiveros;126;69;57
05;Ávila;049;Cardeñosa;454;243;211
05;Ávila;051;Carrera, La;201;106;95
05;Ávila;052;Casas del Puerto;100;52;48
05;Ávila;053;Casasola;78;41;37
05;Ávila;054;Casavieja;1507;770;737
05;Ávila;055;Casillas;704;375;329
05;Ávila;056;Castellanos de Zapardiel;97;52;45
05;Ávila;057;Cebreros;3232;1649;1583
05;Ávila;058;Cepeda la Mora;85;45;40
05;Ávila;067;Chamartín;92;52;40
05;Ávila;059;Cillán;110;65;45
05;Ávila;060;Cisla;118;60;58
05;Ávila;061;Colilla, La;331;169;162
05;Ávila;062;Collado de Contreras;192;101;91
05;Ávila;063;Collado del Mirón;35;21;14
05;Ávila;064;Constanzana;116;68;48
05;Ávila;065;Crespos;526;282;244
05;Ávila;066;Cuevas del Valle;516;278;238
05;Ávila;903;Diego del Carpio;161;90;71
05;Ávila;069;Donjimeno;82;50;32
05;Ávila;070;Donvidas;37;20;17
05;Ávila;072;Espinosa de los Caballeros;102;55;47
05;Ávila;073;Flores de Ávila;320;175;145
05;Ávila;074;Fontiveros;770;404;366
05;Ávila;075;Fresnedilla;131;54;77
05;Ávila;076;Fresno, El;601;308;293
05;Ávila;077;Fuente el Saúz;182;98;84
05;Ávila;078;Fuentes de Año;126;69;57
05;Ávila;079;Gallegos de Altamiros;72;45;27
05;Ávila;080;Gallegos de Sobrinos;56;25;31
05;Ávila;081;Garganta del Villar;40;29;11
05;Ávila;082;Gavilanes;619;329;290
05;Ávila;083;Gemuño;169;87;82
05;Ávila;085;Gil García;43;21;22
05;Ávila;084;Gilbuena;73;43;30
05;Ávila;086;Gimialcón;85;52;33
05;Ávila;087;Gotarrendura;164;58;106
05;Ávila;088;Grandes y San Martín;30;14;16
05;Ávila;089;Guisando;534;269;265
05;Ávila;090;Gutierre-Muñoz;90;45;45
05;Ávila;092;Hernansancho;184;99;85
05;Ávila;093;Herradón de Pinares;549;314;235
05;Ávila;094;Herreros de Suso;145;78;67
05;Ávila;095;Higuera de las Dueñas;302;164;138
05;Ávila;096;Hija de Dios, La;82;47;35
05;Ávila;097;Horcajada, La;525;266;259
05;Ávila;099;Horcajo de las Torres;556;311;245
05;Ávila;100;Hornillo, El;317;169;148
05;Ávila;102;Hoyo de Pinares, El;2308;1205;1103
05;Ávila;101;Hoyocasero;369;206;163
05;Ávila;103;Hoyorredondo;77;43;34
05;Ávila;106;Hoyos de Miguel Muñoz;35;18;17
05;Ávila;104;Hoyos del Collado;33;20;13
05;Ávila;105;Hoyos del Espino;364;195;169
05;Ávila;107;Hurtumpascual;62;38;24
05;Ávila;108;Junciana;53;28;25
05;Ávila;109;Langa;520;269;251
05;Ávila;110;Lanzahíta;905;470;435
05;Ávila;113;Llanos de Tormes, Los;82;39;43
05;Ávila;112;Losar del Barco, El;109;54;55
05;Ávila;114;Madrigal de las Altas Torres;1524;777;747
05;Ávila;115;Maello;647;334;313
05;Ávila;116;Malpartida de Corneja;123;62;61
05;Ávila;117;Mamblas;220;122;98
05;Ávila;118;Mancera de Arriba;88;50;38
05;Ávila;119;Manjabálago y Ortigosa de Rioalmar;34;21;13
05;Ávila;120;Marlín;37;24;13
05;Ávila;121;Martiherrero;307;159;148
05;Ávila;122;Martínez;139;75;64
05;Ávila;123;Mediana de Voltoya;106;53;53
05;Ávila;124;Medinilla;112;53;59
05;Ávila;125;Mengamuñoz;63;31;32
05;Ávila;126;Mesegar de Corneja;75;41;34
05;Ávila;127;Mijares;767;418;349
05;Ávila;128;Mingorría;407;211;196
05;Ávila;129;Mirón, El;134;82;52
05;Ávila;130;Mironcillo;101;54;47
05;Ávila;131;Mirueña de los Infanzones;98;54;44
05;Ávila;132;Mombeltrán;1171;609;562
05;Ávila;133;Monsalupe;72;35;37
05;Ávila;134;Moraleja de Matacabras;47;27;20
05;Ávila;135;Muñana;435;229;206
05;Ávila;136;Muñico;111;56;55
05;Ávila;138;Muñogalindo;374;187;187
05;Ávila;139;Muñogrande;63;38;25
05;Ávila;140;Muñomer del Peco;131;68;63
05;Ávila;141;Muñopepe;112;67;45
05;Ávila;142;Muñosancho;104;50;54
05;Ávila;143;Muñotello;64;36;28
05;Ávila;144;Narrillos del Álamo;85;44;41
05;Ávila;145;Narrillos del Rebollar;56;30;26
05;Ávila;149;Narros de Saldueña;110;61;49
05;Ávila;147;Narros del Castillo;180;98;82
05;Ávila;148;Narros del Puerto;27;12;15
05;Ávila;152;Nava de Arévalo;801;422;379
05;Ávila;153;Nava del Barco;108;57;51
05;Ávila;151;Navacepedilla de Corneja;109;57;52
05;Ávila;154;Navadijos;38;28;10
05;Ávila;155;Navaescurial;60;37;23
05;Ávila;156;Navahondilla;335;191;144
05;Ávila;157;Navalacruz;259;133;126
05;Ávila;158;Navalmoral;353;187;166
05;Ávila;159;Navalonguilla;264;135;129
05;Ávila;160;Navalosa;333;185;148
05;Ávila;161;Navalperal de Pinares;867;446;421
05;Ávila;162;Navalperal de Tormes;98;51;47
05;Ávila;163;Navaluenga;2017;1002;1015
05;Ávila;164;Navaquesera;26;11;15
05;Ávila;165;Navarredonda de Gredos;473;239;234
05;Ávila;166;Navarredondilla;217;115;102
05;Ávila;167;Navarrevisca;307;167;140
05;Ávila;168;Navas del Marqués, Las;5420;2746;2674
05;Ávila;169;Navatalgordo;239;127;112
05;Ávila;170;Navatejares;54;26;28
05;Ávila;171;Neila de San Miguel;73;37;36
05;Ávila;172;Niharra;172;94;78
05;Ávila;173;Ojos-Albos;67;39;28
05;Ávila;174;Orbita;80;40;40
05;Ávila;175;Oso, El;176;100;76
05;Ávila;176;Padiernos;292;151;141
05;Ávila;177;Pajares de Adaja;191;95;96
05;Ávila;178;Palacios de Goda;418;218;200
05;Ávila;179;Papatrigo;253;127;126
05;Ávila;180;Parral, El;79;44;35
05;Ávila;181;Pascualcobo;39;26;13
05;Ávila;182;Pedro Bernardo;921;484;437
05;Ávila;183;Pedro-Rodríguez;158;82;76
05;Ávila;184;Peguerinos;312;183;129
05;Ávila;185;Peñalba de Ávila;114;62;52
05;Ávila;186;Piedrahíta;1884;897;987
05;Ávila;187;Piedralaves;2208;1119;1089
05;Ávila;188;Poveda;50;31;19
05;Ávila;189;Poyales del Hoyo;557;306;251
05;Ávila;190;Pozanco;53;31;22
05;Ávila;191;Pradosegar;139;74;65
05;Ávila;192;Puerto Castilla;116;73;43
05;Ávila;193;Rasueros;201;117;84
05;Ávila;194;Riocabado;150;84;66
05;Ávila;195;Riofrío;233;136;97
05;Ávila;196;Rivilla de Barajas;67;31;36
05;Ávila;197;Salobral;110;59;51
05;Ávila;198;Salvadiós;80;40;40
05;Ávila;199;San Bartolomé de Béjar;42;22;20
05;Ávila;200;San Bartolomé de Corneja;54;29;25
05;Ávila;201;San Bartolomé de Pinares;597;317;280
05;Ávila;206;San Esteban de los Patos;34;19;15
05;Ávila;208;San Esteban de Zapardiel;41;25;16
05;Ávila;207;San Esteban del Valle;800;426;374
05;Ávila;209;San García de Ingelmos;82;48;34
05;Ávila;901;San Juan de Gredos;291;160;131
05;Ávila;210;San Juan de la Encinilla;90;46;44
05;Ávila;211;San Juan de la Nava;518;268;250
05;Ávila;212;San Juan del Molinillo;227;131;96
05;Ávila;213;San Juan del Olmo;112;68;44
05;Ávila;214;San Lorenzo de Tormes;42;23;19
05;Ávila;215;San Martín de la Vega del Alberche;181;111;70
05;Ávila;216;San Martín del Pimpollar;185;107;78
05;Ávila;217;San Miguel de Corneja;62;33;29
05;Ávila;218;San Miguel de Serrezuela;137;74;63
05;Ávila;219;San Pascual;43;28;15
05;Ávila;220;San Pedro del Arroyo;455;240;215
05;Ávila;231;San Vicente de Arévalo;190;106;84
05;Ávila;204;Sanchidrián;768;391;377
05;Ávila;205;Sanchorreja;91;45;46
05;Ávila;222;Santa Cruz de Pinares;157;87;70
05;Ávila;221;Santa Cruz del Valle;385;198;187
05;Ávila;226;Santa María de los Caballeros;79;46;33
05;Ávila;224;Santa María del Arroyo;114;59;55
05;Ávila;225;Santa María del Berrocal;391;205;186
05;Ávila;902;Santa María del Cubillo;337;193;144
05;Ávila;227;Santa María del Tiétar;526;274;252
05;Ávila;228;Santiago del Collado;183;115;68
05;Ávila;904;Santiago del Tormes;146;82;64
05;Ávila;229;Santo Domingo de las Posadas;78;41;37
05;Ávila;230;Santo Tomé de Zabarcos;71;39;32
05;Ávila;232;Serrada, La;110;58;52
05;Ávila;233;Serranillos;262;142;120
05;Ávila;234;Sigeres;53;27;26
05;Ávila;235;Sinlabajos;127;66;61
05;Ávila;236;Solana de Ávila;138;76;62
05;Ávila;237;Solana de Rioalmar;185;104;81
05;Ávila;238;Solosancho;905;482;423
05;Ávila;239;Sotalbo;218;114;104
05;Ávila;240;Sotillo de la Adrada;4652;2308;2344
05;Ávila;241;Tiemblo, El;4231;2164;2067
05;Ávila;242;Tiñosillos;790;403;387
05;Ávila;243;Tolbaños;95;52;43
05;Ávila;244;Tormellas;55;31;24
05;Ávila;245;Tornadizos de Ávila;432;217;215
05;Ávila;247;Torre, La;273;149;124
05;Ávila;246;Tórtoles;64;34;30
05;Ávila;249;Umbrías;117;60;57
05;Ávila;251;Vadillo de la Sierra;70;42;28
05;Ávila;252;Valdecasa;77;45;32
05;Ávila;253;Vega de Santa María;94;47;47
05;Ávila;254;Velayos;234;116;118
05;Ávila;256;Villaflor;126;64;62
05;Ávila;257;Villafranca de la Sierra;134;76;58
05;Ávila;905;Villanueva de Ávila;239;121;118
05;Ávila;258;Villanueva de Gómez;142;81;61
05;Ávila;259;Villanueva del Aceral;139;69;70
05;Ávila;260;Villanueva del Campillo;100;60;40
05;Ávila;261;Villar de Corneja;41;24;17
05;Ávila;262;Villarejo del Valle;380;200;180
05;Ávila;263;Villatoro;184;104;80
05;Ávila;264;Viñegra de Moraña;49;26;23
05;Ávila;265;Vita;84;48;36
05;Ávila;266;Zapardiel de la Cañada;104;54;50
05;Ávila;267;Zapardiel de la Ribera;111;58;53
06;Badajoz;001;Acedera;816;419;397
06;Badajoz;002;Aceuchal;5471;2715;2756
06;Badajoz;003;Ahillones;960;480;480
06;Badajoz;004;Alange;1914;965;949
06;Badajoz;005;Albuera, La;2046;1053;993
06;Badajoz;006;Alburquerque;5486;2781;2705
06;Badajoz;007;Alconchel;1790;894;896
06;Badajoz;008;Alconera;747;367;380
06;Badajoz;009;Aljucén;240;137;103
06;Badajoz;010;Almendral;1296;632;664
06;Badajoz;011;Almendralejo;34265;17095;17170
06;Badajoz;012;Arroyo de San Serván;4175;2115;2060
06;Badajoz;013;Atalaya;302;154;148
06;Badajoz;014;Azuaga;8031;3978;4053
06;Badajoz;015;Badajoz;149892;72774;77118
06;Badajoz;016;Barcarrota;3634;1862;1772
06;Badajoz;017;Baterno;318;172;146
06;Badajoz;018;Benquerencia de la Serena;888;435;453
06;Badajoz;019;Berlanga;2434;1211;1223
06;Badajoz;020;Bienvenida;2218;1149;1069
06;Badajoz;021;Bodonal de la Sierra;1081;558;523
06;Badajoz;022;Burguillos del Cerro;3179;1574;1605
06;Badajoz;023;Cabeza del Buey;5138;2531;2607
06;Badajoz;024;Cabeza la Vaca;1391;713;678
06;Badajoz;025;Calamonte;6330;3125;3205
06;Badajoz;026;Calera de León;1014;513;501
06;Badajoz;027;Calzadilla de los Barros;845;425;420
06;Badajoz;028;Campanario;5150;2532;2618
06;Badajoz;029;Campillo de Llerena;1414;712;702
06;Badajoz;030;Capilla;191;98;93
06;Badajoz;031;Carmonita;561;278;283
06;Badajoz;032;Carrascalejo, El;71;36;35
06;Badajoz;033;Casas de Don Pedro;1560;795;765
06;Badajoz;034;Casas de Reina;199;94;105
06;Badajoz;035;Castilblanco;1085;554;531
06;Badajoz;036;Castuera;6163;3052;3111
06;Badajoz;042;Cheles;1221;587;634
06;Badajoz;037;Codosera, La;2197;1162;1035
06;Badajoz;038;Cordobilla de Lácara;960;492;468
06;Badajoz;039;Coronada, La;2195;1078;1117
06;Badajoz;040;Corte de Peleas;1312;651;661
06;Badajoz;041;Cristina;556;288;268
06;Badajoz;043;Don Álvaro;781;402;379
06;Badajoz;044;Don Benito;36971;18268;18703
06;Badajoz;045;Entrín Bajo;562;289;273
06;Badajoz;046;Esparragalejo;1489;722;767
06;Badajoz;047;Esparragosa de la Serena;1060;544;516
06;Badajoz;048;Esparragosa de Lares;972;477;495
06;Badajoz;049;Feria;1209;592;617
06;Badajoz;050;Fregenal de la Sierra;4968;2441;2527
06;Badajoz;051;Fuenlabrada de los Montes;1921;942;979
06;Badajoz;052;Fuente de Cantos;4941;2432;2509
06;Badajoz;053;Fuente del Arco;709;360;349
06;Badajoz;054;Fuente del Maestre;6856;3387;3469
06;Badajoz;055;Fuentes de León;2415;1189;1226
06;Badajoz;056;Garbayuela;543;285;258
06;Badajoz;057;Garlitos;630;328;302
06;Badajoz;058;Garrovilla, La;2453;1239;1214
06;Badajoz;059;Granja de Torrehermosa;2160;1073;1087
06;Badajoz;903;Guadiana del Caudillo;2527;1256;1271
06;Badajoz;060;Guareña;7151;3604;3547
06;Badajoz;061;Haba, La;1286;651;635
06;Badajoz;062;Helechosa de los Montes;716;397;319
06;Badajoz;063;Herrera del Duque;3686;1871;1815
06;Badajoz;064;Higuera de la Serena;969;513;456
06;Badajoz;065;Higuera de Llerena;352;179;173
06;Badajoz;066;Higuera de Vargas;2020;1010;1010
06;Badajoz;067;Higuera la Real;2359;1197;1162
06;Badajoz;068;Hinojosa del Valle;514;256;258
06;Badajoz;069;Hornachos;3749;1875;1874
06;Badajoz;070;Jerez de los Caballeros;9615;4781;4834
06;Badajoz;071;Lapa, La;287;144;143
06;Badajoz;073;Llera;888;459;429
06;Badajoz;074;Llerena;5929;2965;2964
06;Badajoz;072;Lobón;2837;1466;1371
06;Badajoz;075;Magacela;552;293;259
06;Badajoz;076;Maguilla;1007;502;505
06;Badajoz;077;Malcocinado;395;217;178
06;Badajoz;078;Malpartida de la Serena;599;304;295
06;Badajoz;079;Manchita;760;393;367
06;Badajoz;080;Medellín;2306;1157;1149
06;Badajoz;081;Medina de las Torres;1280;661;619
06;Badajoz;082;Mengabril;472;249;223
06;Badajoz;083;Mérida;58971;28796;30175
06;Badajoz;084;Mirandilla;1349;683;666
06;Badajoz;085;Monesterio;4306;2194;2112
06;Badajoz;086;Montemolín;1455;704;751
06;Badajoz;087;Monterrubio de la Serena;2490;1214;1276
06;Badajoz;088;Montijo;15789;7848;7941
06;Badajoz;089;Morera, La;736;370;366
06;Badajoz;090;Nava de Santiago, La;1005;503;502
06;Badajoz;091;Navalvillar de Pela;4671;2364;2307
06;Badajoz;092;Nogales;700;349;351
06;Badajoz;093;Oliva de la Frontera;5403;2718;2685
06;Badajoz;094;Oliva de Mérida;1798;925;873
06;Badajoz;095;Olivenza;12090;6040;6050
06;Badajoz;096;Orellana de la Sierra;245;134;111
06;Badajoz;097;Orellana la Vieja;2836;1473;1363
06;Badajoz;098;Palomas;697;345;352
06;Badajoz;099;Parra, La;1383;711;672
06;Badajoz;100;Peñalsordo;1042;502;540
06;Badajoz;101;Peraleda del Zaucejo;565;290;275
06;Badajoz;102;Puebla de Alcocer;1240;606;634
06;Badajoz;103;Puebla de la Calzada;5970;2974;2996
06;Badajoz;104;Puebla de la Reina;789;400;389
06;Badajoz;107;Puebla de Obando;1894;954;940
06;Badajoz;108;Puebla de Sancho Pérez;2793;1405;1388
06;Badajoz;105;Puebla del Maestre;759;391;368
06;Badajoz;106;Puebla del Prior;515;262;253
06;Badajoz;902;Pueblonuevo del Guadiana;2046;1041;1005
06;Badajoz;109;Quintana de la Serena;4818;2433;2385
06;Badajoz;110;Reina;169;81;88
06;Badajoz;111;Rena;655;337;318
06;Badajoz;112;Retamal de Llerena;475;249;226
06;Badajoz;113;Ribera del Fresno;3440;1711;1729
06;Badajoz;114;Risco;158;81;77
06;Badajoz;115;Roca de la Sierra, La;1515;741;774
06;Badajoz;116;Salvaleón;1893;937;956
06;Badajoz;117;Salvatierra de los Barros;1712;842;870
06;Badajoz;119;San Pedro de Mérida;877;447;430
06;Badajoz;123;San Vicente de Alcántara;5689;2863;2826
06;Badajoz;118;Sancti-Spíritus;227;125;102
06;Badajoz;120;Santa Amalia;4149;2089;2060
06;Badajoz;121;Santa Marta;4301;2163;2138
06;Badajoz;122;Santos de Maimona, Los;8254;4194;4060
06;Badajoz;124;Segura de León;2012;998;1014
06;Badajoz;125;Siruela;2017;1007;1010
06;Badajoz;126;Solana de los Barros;2692;1342;1350
06;Badajoz;127;Talarrubias;3576;1794;1782
06;Badajoz;128;Talavera la Real;5484;2749;2735
06;Badajoz;129;Táliga;721;365;356
06;Badajoz;130;Tamurejo;225;117;108
06;Badajoz;131;Torre de Miguel Sesmero;1261;634;627
06;Badajoz;132;Torremayor;1049;499;550
06;Badajoz;133;Torremejía;2259;1171;1088
06;Badajoz;134;Trasierra;654;352;302
06;Badajoz;135;Trujillanos;1442;759;683
06;Badajoz;136;Usagre;1851;922;929
06;Badajoz;137;Valdecaballeros;1135;585;550
06;Badajoz;901;Valdelacalzada;2784;1428;1356
06;Badajoz;138;Valdetorres;1246;616;630
06;Badajoz;139;Valencia de las Torres;645;353;292
06;Badajoz;140;Valencia del Mombuey;766;387;379
06;Badajoz;141;Valencia del Ventoso;2084;1029;1055
06;Badajoz;146;Valle de la Serena;1302;663;639
06;Badajoz;147;Valle de Matamoros;391;200;191
06;Badajoz;148;Valle de Santa Ana;1175;580;595
06;Badajoz;142;Valverde de Burguillos;296;153;143
06;Badajoz;143;Valverde de Leganés;4184;2110;2074
06;Badajoz;144;Valverde de Llerena;645;321;324
06;Badajoz;145;Valverde de Mérida;1086;551;535
06;Badajoz;149;Villafranca de los Barros;13289;6540;6749
06;Badajoz;150;Villagarcía de la Torre;945;497;448
06;Badajoz;151;Villagonzalo;1295;628;667
06;Badajoz;152;Villalba de los Barros;1574;798;776
06;Badajoz;153;Villanueva de la Serena;26021;12738;13283
06;Badajoz;154;Villanueva del Fresno;3489;1738;1751
06;Badajoz;156;Villar de Rena;1413;733;680
06;Badajoz;155;Villar del Rey;2273;1204;1069
06;Badajoz;157;Villarta de los Montes;516;259;257
06;Badajoz;158;Zafra;16857;8161;8696
06;Badajoz;159;Zahínos;2844;1406;1438
06;Badajoz;160;Zalamea de la Serena;3786;1904;1882
06;Badajoz;162;Zarza, La;3586;1809;1777
06;Badajoz;161;Zarza-Capilla;359;181;178
07;Balears, Illes;002;Alaior;8997;4490;4507
07;Balears, Illes;001;Alaró;5275;2592;2683
07;Balears, Illes;003;Alcúdia;19763;10045;9718
07;Balears, Illes;004;Algaida;5410;2765;2645
07;Balears, Illes;005;Andratx;11093;5532;5561
07;Balears, Illes;901;Ariany;871;460;411
07;Balears, Illes;006;Artà;7381;3693;3688
07;Balears, Illes;007;Banyalbufar;548;306;242
07;Balears, Illes;008;Binissalem;7850;3878;3972
07;Balears, Illes;009;Búger;1022;531;491
07;Balears, Illes;010;Bunyola;6706;3300;3406
07;Balears, Illes;011;Calvià;50328;25153;25175
07;Balears, Illes;012;Campanet;2524;1245;1279
07;Balears, Illes;013;Campos;9892;4943;4949
07;Balears, Illes;014;Capdepera;11420;5781;5639
07;Balears, Illes;064;Castell, Es;7635;3898;3737
07;Balears, Illes;015;Ciutadella de Menorca;29098;14488;14610
07;Balears, Illes;016;Consell;3862;1952;1910
07;Balears, Illes;017;Costitx;1205;591;614
07;Balears, Illes;018;Deià;713;347;366
07;Balears, Illes;026;Eivissa;49975;25264;24711
07;Balears, Illes;019;Escorca;236;137;99
07;Balears, Illes;020;Esporles;4922;2437;2485
07;Balears, Illes;021;Estellencs;336;181;155
07;Balears, Illes;022;Felanitx;17412;8760;8652
07;Balears, Illes;023;Ferreries;4571;2290;2281
07;Balears, Illes;024;Formentera;11878;6226;5652
07;Balears, Illes;025;Fornalutx;703;350;353
07;Balears, Illes;027;Inca;30651;15414;15237
07;Balears, Illes;028;Lloret de Vistalegre;1233;626;607
07;Balears, Illes;029;Lloseta;5639;2847;2792
07;Balears, Illes;030;Llubí;2176;1081;1095
07;Balears, Illes;031;Llucmajor;34618;17458;17160
07;Balears, Illes;033;Manacor;40170;19979;20191
07;Balears, Illes;034;Mancor de la Vall;1321;672;649
07;Balears, Illes;032;Maó-Mahón;28006;13710;14296
07;Balears, Illes;035;Maria de la Salut;2113;1071;1042
07;Balears, Illes;036;Marratxí;35726;17932;17794
07;Balears, Illes;037;Mercadal, Es;5091;2583;2508
07;Balears, Illes;902;Migjorn Gran, Es;1429;708;721
07;Balears, Illes;038;Montuïri;2850;1430;1420
07;Balears, Illes;039;Muro;6723;3367;3356
07;Balears, Illes;040;Palma de Mallorca;400578;195144;205434
07;Balears, Illes;041;Petra;2816;1395;1421
07;Balears, Illes;044;Pobla, Sa;12694;6473;6221
07;Balears, Illes;042;Pollença;16115;8016;8099
07;Balears, Illes;043;Porreres;5267;2703;2564
07;Balears, Illes;045;Puigpunyent;2018;1027;991
07;Balears, Illes;059;Salines, Ses;5018;2538;2480
07;Balears, Illes;046;Sant Antoni de Portmany;23631;12330;11301
07;Balears, Illes;049;Sant Joan;2035;998;1037
07;Balears, Illes;050;Sant Joan de Labritja;5872;3014;2858
07;Balears, Illes;048;Sant Josep de sa Talaia;25674;13381;12293
07;Balears, Illes;051;Sant Llorenç des Cardassar;8146;4027;4119
07;Balears, Illes;052;Sant Lluís;7521;3781;3740
07;Balears, Illes;053;Santa Eugènia;1638;829;809
07;Balears, Illes;054;Santa Eulària des Riu;35812;18214;17598
07;Balears, Illes;055;Santa Margalida;11672;5934;5738
07;Balears, Illes;056;Santa María del Camí;6685;3321;3364
07;Balears, Illes;057;Santanyí;11316;5682;5634
07;Balears, Illes;058;Selva;3890;1957;1933
07;Balears, Illes;047;Sencelles;3082;1555;1527
07;Balears, Illes;060;Sineu;3612;1799;1813
07;Balears, Illes;061;Sóller;13648;6864;6784
07;Balears, Illes;062;Son Servera;11449;5710;5739
07;Balears, Illes;063;Valldemossa;2005;1019;986
07;Balears, Illes;065;Vilafranca de Bonany;2913;1454;1459
08;Barcelona;001;Abrera;12071;6118;5953
08;Barcelona;002;Aguilar de Segarra;246;131;115
08;Barcelona;014;Aiguafreda;2465;1175;1290
08;Barcelona;003;Alella;9660;4726;4934
08;Barcelona;004;Alpens;290;156;134
08;Barcelona;005;Ametlla del Vallès, L';8303;4178;4125
08;Barcelona;006;Arenys de Mar;15289;7491;7798
08;Barcelona;007;Arenys de Munt;8736;4408;4328
08;Barcelona;008;Argençola;223;118;105
08;Barcelona;009;Argentona;11978;5899;6079
08;Barcelona;010;Artés;5665;2861;2804
08;Barcelona;011;Avià;2225;1102;1123
08;Barcelona;012;Avinyó;2248;1112;1136
08;Barcelona;013;Avinyonet del Penedès;1652;863;789
08;Barcelona;015;Badalona;215654;106424;109230
08;Barcelona;904;Badia del Vallès;13502;6571;6931
08;Barcelona;016;Bagà;2188;1080;1108
08;Barcelona;017;Balenyà;3711;1863;1848
08;Barcelona;018;Balsareny;3324;1636;1688
08;Barcelona;252;Barberà del Vallès;32545;16091;16454
08;Barcelona;019;Barcelona;1604555;759520;845035
08;Barcelona;020;Begues;6670;3317;3353
08;Barcelona;021;Bellprat;74;46;28
08;Barcelona;022;Berga;16238;7952;8286
08;Barcelona;023;Bigues i Riells;8858;4524;4334
08;Barcelona;024;Borredà;503;280;223
08;Barcelona;025;Bruc, El;2032;1097;935
08;Barcelona;026;Brull, El;254;138;116
08;Barcelona;027;Cabanyes, Les;967;501;466
08;Barcelona;028;Cabrera d'Anoia;1348;715;633
08;Barcelona;029;Cabrera de Mar;4522;2277;2245
08;Barcelona;030;Cabrils;7250;3590;3660
08;Barcelona;031;Calaf;3426;1749;1677
08;Barcelona;034;Calders;968;496;472
08;Barcelona;033;Caldes de Montbui;17098;8521;8577
08;Barcelona;032;Caldes d'Estrac;2717;1316;1401
08;Barcelona;035;Calella;18226;8886;9340
08;Barcelona;037;Calldetenes;2427;1240;1187
08;Barcelona;038;Callús;2024;994;1030
08;Barcelona;036;Calonge de Segarra;197;99;98
08;Barcelona;039;Campins;491;249;242
08;Barcelona;040;Canet de Mar;14177;6884;7293
08;Barcelona;041;Canovelles;15906;8205;7701
08;Barcelona;042;Cànoves i Samalús;2897;1473;1424
08;Barcelona;043;Canyelles;4375;2235;2140
08;Barcelona;044;Capellades;5268;2592;2676
08;Barcelona;045;Capolat;92;44;48
08;Barcelona;046;Cardedeu;17938;8799;9139
08;Barcelona;047;Cardona;4898;2404;2494
08;Barcelona;048;Carme;792;411;381
08;Barcelona;049;Casserres;1541;764;777
08;Barcelona;057;Castell de l'Areny;73;41;32
08;Barcelona;052;Castellar de n'Hug;159;86;73
08;Barcelona;050;Castellar del Riu;175;96;79
08;Barcelona;051;Castellar del Vallès;23442;11561;11881
08;Barcelona;053;Castellbell i el Vilar;3566;1820;1746
08;Barcelona;054;Castellbisbal;12364;6272;6092
08;Barcelona;055;Castellcir;694;345;349
08;Barcelona;056;Castelldefels;63891;31500;32391
08;Barcelona;058;Castellet i la Gornal;2212;1115;1097
08;Barcelona;060;Castellfollit de Riubregós;167;96;71
08;Barcelona;059;Castellfollit del Boix;434;220;214
08;Barcelona;061;Castellgalí;1996;1044;952
08;Barcelona;062;Castellnou de Bages;1266;638;628
08;Barcelona;063;Castellolí;574;280;294
08;Barcelona;064;Castellterçol;2368;1192;1176
08;Barcelona;065;Castellví de la Marca;1540;769;771
08;Barcelona;066;Castellví de Rosanes;1771;868;903
08;Barcelona;067;Centelles;7372;3601;3771
08;Barcelona;268;Cercs;1209;602;607
08;Barcelona;266;Cerdanyola del Vallès;57413;28124;29289
08;Barcelona;068;Cervelló;8851;4426;4425
08;Barcelona;069;Collbató;4389;2263;2126
08;Barcelona;070;Collsuspina;343;181;162
08;Barcelona;071;Copons;307;157;150
08;Barcelona;072;Corbera de Llobregat;14240;7127;7113
08;Barcelona;073;Cornellà de Llobregat;86376;42093;44283
08;Barcelona;074;Cubelles;14420;7325;7095
08;Barcelona;075;Dosrius;5215;2644;2571
08;Barcelona;076;Esparreguera;21701;10975;10726
08;Barcelona;077;Esplugues de Llobregat;45626;21965;23661
08;Barcelona;078;Espunyola, L';252;129;123
08;Barcelona;254;Esquirol, L';2150;1077;1073
08;Barcelona;079;Estany, L';398;199;199
08;Barcelona;134;Figaró-Montmany;1094;549;545
08;Barcelona;080;Fígols;43;23;20
08;Barcelona;082;Fogars de la Selva;1470;755;715
08;Barcelona;081;Fogars de Montclús;477;248;229
08;Barcelona;083;Folgueroles;2285;1156;1129
08;Barcelona;084;Fonollosa;1393;726;667
08;Barcelona;085;Font-rubí;1348;692;656
08;Barcelona;086;Franqueses del Vallès, Les;19446;9894;9552
08;Barcelona;090;Gaià;168;91;77
08;Barcelona;087;Gallifa;197;103;94
08;Barcelona;088;Garriga, La;15740;7646;8094
08;Barcelona;089;Gavà;46405;22851;23554
08;Barcelona;091;Gelida;7253;3629;3624
08;Barcelona;092;Gironella;4925;2422;2503
08;Barcelona;093;Gisclareny;27;16;11
08;Barcelona;094;Granada, La;2085;1070;1015
08;Barcelona;095;Granera;80;53;27
08;Barcelona;096;Granollers;60101;29712;30389
08;Barcelona;097;Gualba;1414;722;692
08;Barcelona;099;Guardiola de Berguedà;930;493;437
08;Barcelona;100;Gurb;2545;1318;1227
08;Barcelona;101;Hospitalet de Llobregat, L';252171;122224;129947
08;Barcelona;162;Hostalets de Pierola, Els;2887;1491;1396
08;Barcelona;102;Igualada;38751;18950;19801
08;Barcelona;103;Jorba;838;422;416
08;Barcelona;104;Llacuna, La;883;476;407
08;Barcelona;105;Llagosta, La;13252;6531;6721
08;Barcelona;107;Lliçà d'Amunt;14742;7498;7244
08;Barcelona;108;Lliçà de Vall;6383;3254;3129
08;Barcelona;106;Llinars del Vallès;9570;4742;4828
08;Barcelona;109;Lluçà;280;139;141
08;Barcelona;110;Malgrat de Mar;18371;9183;9188
08;Barcelona;111;Malla;262;132;130
08;Barcelona;112;Manlleu;20228;10096;10132
08;Barcelona;113;Manresa;74655;36397;38258
08;Barcelona;242;Marganell;280;132;148
08;Barcelona;114;Martorell;27694;14149;13545
08;Barcelona;115;Martorelles;4756;2370;2386
08;Barcelona;116;Masies de Roda, Les;715;354;361
08;Barcelona;117;Masies de Voltregà, Les;3165;1554;1611
08;Barcelona;118;Masnou, El;22923;11062;11861
08;Barcelona;119;Masquefa;8335;4214;4121
08;Barcelona;120;Matadepera;8900;4461;4439
08;Barcelona;121;Mataró;124867;62045;62822
08;Barcelona;122;Mediona;2273;1147;1126
08;Barcelona;138;Moià;5865;2942;2923
08;Barcelona;123;Molins de Rei;25155;12255;12900
08;Barcelona;124;Mollet del Vallès;51650;25648;26002
08;Barcelona;128;Monistrol de Calders;697;361;336
08;Barcelona;127;Monistrol de Montserrat;2901;1473;1428
08;Barcelona;125;Montcada i Reixac;34377;16941;17436
08;Barcelona;130;Montclar;120;60;60
08;Barcelona;131;Montesquiu;943;480;463
08;Barcelona;126;Montgat;11501;5721;5780
08;Barcelona;132;Montmajor;476;238;238
08;Barcelona;133;Montmaneu;156;83;73
08;Barcelona;135;Montmeló;8835;4331;4504
08;Barcelona;136;Montornès del Vallès;16172;8210;7962
08;Barcelona;137;Montseny;319;166;153
08;Barcelona;129;Muntanyola;606;313;293
08;Barcelona;139;Mura;203;109;94
08;Barcelona;140;Navarcles;6012;2936;3076
08;Barcelona;141;Navàs;6103;3049;3054
08;Barcelona;142;Nou de Berguedà, La;153;74;79
08;Barcelona;143;Òdena;3623;1848;1775
08;Barcelona;145;Olèrdola;3518;1823;1695
08;Barcelona;146;Olesa de Bonesvalls;1715;881;834
08;Barcelona;147;Olesa de Montserrat;23536;11791;11745
08;Barcelona;148;Olivella;3569;1895;1674
08;Barcelona;149;Olost;1182;596;586
08;Barcelona;144;Olvan;856;423;433
08;Barcelona;150;Orís;308;154;154
08;Barcelona;151;Oristà;559;275;284
08;Barcelona;152;Orpí;139;76;63
08;Barcelona;153;Òrrius;688;356;332
08;Barcelona;154;Pacs del Penedès;893;451;442
08;Barcelona;155;Palafolls;9132;4550;4582
08;Barcelona;156;Palau-solità i Plegamans;14457;7087;7370
08;Barcelona;157;Pallejà;11298;5634;5664
08;Barcelona;905;Palma de Cervelló, La;2966;1492;1474
08;Barcelona;158;Papiol, El;4071;2033;2038
08;Barcelona;159;Parets del Vallès;18901;9495;9406
08;Barcelona;160;Perafita;419;212;207
08;Barcelona;161;Piera;14991;7621;7370
08;Barcelona;163;Pineda de Mar;25968;12986;12982
08;Barcelona;164;Pla del Penedès, El;1230;614;616
08;Barcelona;165;Pobla de Claramunt, La;2150;1089;1061
08;Barcelona;166;Pobla de Lillet, La;1139;561;578
08;Barcelona;167;Polinyà;8226;4180;4046
08;Barcelona;182;Pont de Vilomara i Rocafort, El;3715;1901;1814
08;Barcelona;168;Pontons;483;273;210
08;Barcelona;169;Prat de Llobregat, El;63014;30931;32083
08;Barcelona;171;Prats de Lluçanès;2580;1294;1286
08;Barcelona;170;Prats de Rei, Els;536;280;256
08;Barcelona;230;Premià de Dalt;10392;5231;5161
08;Barcelona;172;Premià de Mar;27944;13667;14277
08;Barcelona;174;Puigdàlber;539;266;273
08;Barcelona;175;Puig-reig;4167;2022;2145
08;Barcelona;176;Pujalt;198;109;89
08;Barcelona;177;Quar, La;52;28;24
08;Barcelona;178;Rajadell;524;268;256
08;Barcelona;179;Rellinars;748;388;360
08;Barcelona;180;Ripollet;37445;18544;18901
08;Barcelona;181;Roca del Vallès, La;10504;5278;5226
08;Barcelona;183;Roda de Ter;6122;3006;3116
08;Barcelona;184;Rubí;74536;36985;37551
08;Barcelona;185;Rubió;229;125;104
08;Barcelona;901;Rupit i Pruit;281;145;136
08;Barcelona;187;Sabadell;207814;101118;106696
08;Barcelona;188;Sagàs;157;85;72
08;Barcelona;190;Saldes;288;162;126
08;Barcelona;191;Sallent;6669;3215;3454
08;Barcelona;194;Sant Adrià de Besòs;35814;17638;18176
08;Barcelona;195;Sant Agustí de Lluçanès;90;45;45
08;Barcelona;196;Sant Andreu de la Barca;27340;13717;13623
08;Barcelona;197;Sant Andreu de Llavaneres;10493;5166;5327
08;Barcelona;198;Sant Antoni de Vilamajor;5789;2896;2893
08;Barcelona;199;Sant Bartomeu del Grau;863;447;416
08;Barcelona;200;Sant Boi de Llobregat;82195;40327;41868
08;Barcelona;201;Sant Boi de Lluçanès;544;264;280
08;Barcelona;203;Sant Cebrià de Vallalta;3326;1734;1592
08;Barcelona;202;Sant Celoni;17317;8582;8735
08;Barcelona;204;Sant Climent de Llobregat;4013;2011;2002
08;Barcelona;205;Sant Cugat del Vallès;87830;42743;45087
08;Barcelona;206;Sant Cugat Sesgarrigues;978;482;496
08;Barcelona;207;Sant Esteve de Palautordera;2568;1272;1296
08;Barcelona;208;Sant Esteve Sesrovires;7613;3805;3808
08;Barcelona;210;Sant Feliu de Codines;5908;2977;2931
08;Barcelona;211;Sant Feliu de Llobregat;43800;21259;22541
08;Barcelona;212;Sant Feliu Sasserra;628;330;298
08;Barcelona;209;Sant Fost de Campsentelles;8603;4298;4305
08;Barcelona;213;Sant Fruitós de Bages;8351;4165;4186
08;Barcelona;215;Sant Hipòlit de Voltregà;3429;1697;1732
08;Barcelona;193;Sant Iscle de Vallalta;1308;672;636
08;Barcelona;216;Sant Jaume de Frontanyà;26;16;10
08;Barcelona;218;Sant Joan de Vilatorrada;10768;5383;5385
08;Barcelona;217;Sant Joan Despí;33264;16264;17000
08;Barcelona;903;Sant Julià de Cerdanyola;242;134;108
08;Barcelona;220;Sant Julià de Vilatorta;3104;1518;1586
08;Barcelona;221;Sant Just Desvern;16631;7918;8713
08;Barcelona;222;Sant Llorenç d'Hortons;2557;1284;1273
08;Barcelona;223;Sant Llorenç Savall;2380;1208;1172
08;Barcelona;225;Sant Martí d'Albars;110;54;56
08;Barcelona;224;Sant Martí de Centelles;1103;562;541
08;Barcelona;226;Sant Martí de Tous;1186;599;587
08;Barcelona;227;Sant Martí Sarroca;3092;1509;1583
08;Barcelona;228;Sant Martí Sesgueioles;378;189;189
08;Barcelona;229;Sant Mateu de Bages;620;314;306
08;Barcelona;231;Sant Pere de Ribes;29666;14906;14760
08;Barcelona;232;Sant Pere de Riudebitlles;2374;1191;1183
08;Barcelona;233;Sant Pere de Torelló;2433;1255;1178
08;Barcelona;234;Sant Pere de Vilamajor;4281;2134;2147
08;Barcelona;189;Sant Pere Sallavinera;167;93;74
08;Barcelona;235;Sant Pol de Mar;5012;2486;2526
08;Barcelona;236;Sant Quintí de Mediona;2116;1074;1042
08;Barcelona;237;Sant Quirze de Besora;2132;1050;1082
08;Barcelona;238;Sant Quirze del Vallès;19602;9619;9983
08;Barcelona;239;Sant Quirze Safaja;622;332;290
08;Barcelona;240;Sant Sadurní d'Anoia;12689;6234;6455
08;Barcelona;241;Sant Sadurní d'Osormort;86;50;36
08;Barcelona;098;Sant Salvador de Guardiola;3126;1583;1543
08;Barcelona;262;Sant Vicenç de Castellet;9246;4584;4662
08;Barcelona;264;Sant Vicenç de Montalt;6049;3053;2996
08;Barcelona;265;Sant Vicenç de Torelló;2001;988;1013
08;Barcelona;263;Sant Vicenç dels Horts;27983;13952;14031
08;Barcelona;243;Santa Cecília de Voltregà;179;94;85
08;Barcelona;244;Santa Coloma de Cervelló;8022;3945;4077
08;Barcelona;245;Santa Coloma de Gramenet;116950;58265;58685
08;Barcelona;246;Santa Eugènia de Berga;2204;1131;1073
08;Barcelona;247;Santa Eulàlia de Riuprimer;1284;645;639
08;Barcelona;248;Santa Eulàlia de Ronçana;7080;3560;3520
08;Barcelona;249;Santa Fe del Penedès;378;190;188
08;Barcelona;250;Santa Margarida de Montbui;9648;4822;4826
08;Barcelona;251;Santa Margarida i els Monjos;7332;3732;3600
08;Barcelona;253;Santa Maria de Besora;158;79;79
08;Barcelona;256;Santa Maria de Martorelles;853;425;428
08;Barcelona;255;Santa Maria de Merlès;185;91;94
08;Barcelona;257;Santa Maria de Miralles;130;68;62
08;Barcelona;259;Santa Maria de Palautordera;9103;4584;4519
08;Barcelona;258;Santa Maria d'Oló;1063;548;515
08;Barcelona;260;Santa Perpètua de Mogoda;25466;12899;12567
08;Barcelona;261;Santa Susanna;3275;1662;1613
08;Barcelona;192;Santpedor;7459;3721;3738
08;Barcelona;267;Sentmenat;8652;4387;4265
08;Barcelona;269;Seva;3434;1750;1684
08;Barcelona;270;Sitges;28269;14082;14187
08;Barcelona;271;Sobremunt;82;35;47
08;Barcelona;272;Sora;184;104;80
08;Barcelona;273;Subirats;2988;1543;1445
08;Barcelona;274;Súria;5927;2858;3069
08;Barcelona;276;Tagamanent;319;170;149
08;Barcelona;277;Talamanca;189;108;81
08;Barcelona;278;Taradell;6262;3126;3136
08;Barcelona;275;Tavèrnoles;319;165;154
08;Barcelona;280;Tavertet;124;70;54
08;Barcelona;281;Teià;6238;3078;3160
08;Barcelona;279;Terrassa;215214;106067;109147
08;Barcelona;282;Tiana;8411;4035;4376
08;Barcelona;283;Tona;8021;3961;4060
08;Barcelona;284;Tordera;16433;8325;8108
08;Barcelona;285;Torelló;13881;6816;7065
08;Barcelona;286;Torre de Claramunt, La;3767;1925;1842
08;Barcelona;287;Torrelavit;1401;741;660
08;Barcelona;288;Torrelles de Foix;2246;1184;1062
08;Barcelona;289;Torrelles de Llobregat;5883;2902;2981
08;Barcelona;290;Ullastrell;2043;1023;1020
08;Barcelona;291;Vacarisses;6143;3175;2968
08;Barcelona;292;Vallbona d'Anoia;1417;732;685
08;Barcelona;293;Vallcebre;255;146;109
08;Barcelona;294;Vallgorguina;2749;1409;1340
08;Barcelona;295;Vallirana;14633;7307;7326
08;Barcelona;296;Vallromanes;2543;1295;1248
08;Barcelona;297;Veciana;175;97;78
08;Barcelona;298;Vic;42498;21146;21352
08;Barcelona;299;Vilada;427;227;200
08;Barcelona;301;Viladecans;65549;32541;33008
08;Barcelona;300;Viladecavalls;7365;3685;3680
08;Barcelona;305;Vilafranca del Penedès;39224;19282;19942
08;Barcelona;306;Vilalba Sasserra;709;352;357
08;Barcelona;303;Vilanova de Sau;312;157;155
08;Barcelona;302;Vilanova del Camí;12452;6250;6202
08;Barcelona;902;Vilanova del Vallès;5241;2661;2580
08;Barcelona;307;Vilanova i la Geltrú;65684;31821;33863
08;Barcelona;214;Vilassar de Dalt;8964;4406;4558
08;Barcelona;219;Vilassar de Mar;20447;9860;10587
08;Barcelona;304;Vilobí del Penedès;1085;564;521
08;Barcelona;308;Viver i Serrateix;168;90;78
48;Bizkaia;001;Abadiño;7516;3745;3771
48;Bizkaia;002;Abanto y Ciérvana-Abanto Zierbena;9635;4754;4881
48;Bizkaia;911;Ajangiz;459;236;223
48;Bizkaia;912;Alonsotegi;2856;1402;1454
48;Bizkaia;003;Amorebieta-Etxano;18736;9215;9521
48;Bizkaia;004;Amoroto;410;212;198
48;Bizkaia;005;Arakaldo;157;78;79
48;Bizkaia;006;Arantzazu;382;188;194
48;Bizkaia;093;Areatza;1195;575;620
48;Bizkaia;009;Arrankudiaga;973;478;495
48;Bizkaia;914;Arratzu;406;200;206
48;Bizkaia;010;Arrieta;572;294;278
48;Bizkaia;011;Arrigorriaga;12339;6008;6331
48;Bizkaia;023;Artea;768;385;383
48;Bizkaia;008;Artzentales;730;387;343
48;Bizkaia;091;Atxondo;1378;693;685
48;Bizkaia;070;Aulesti;658;330;328
48;Bizkaia;012;Bakio;2589;1319;1270
48;Bizkaia;090;Balmaseda;7800;3814;3986
48;Bizkaia;013;Barakaldo;100228;48446;51782
48;Bizkaia;014;Barrika;1539;758;781
48;Bizkaia;015;Basauri;41304;20073;21231
48;Bizkaia;092;Bedia;1022;485;537
48;Bizkaia;016;Berango;6961;3399;3562
48;Bizkaia;017;Bermeo;16947;8383;8564
48;Bizkaia;018;Berriatua;1220;659;561
48;Bizkaia;019;Berriz;4778;2386;2392
48;Bizkaia;020;Bilbao;345141;162564;182577
48;Bizkaia;021;Busturia;1687;839;848
48;Bizkaia;901;Derio;6022;2936;3086
48;Bizkaia;026;Dima;1424;728;696
48;Bizkaia;027;Durango;28899;14130;14769
48;Bizkaia;028;Ea;844;428;416
48;Bizkaia;031;Elantxobe;384;188;196
48;Bizkaia;032;Elorrio;7271;3620;3651
48;Bizkaia;902;Erandio;24234;11873;12361
48;Bizkaia;033;Ereño;252;132;120
48;Bizkaia;034;Ermua;16048;8048;8000
48;Bizkaia;079;Errigoiti;507;280;227
48;Bizkaia;029;Etxebarri;10881;5440;5441
48;Bizkaia;030;Etxebarria;787;399;388
48;Bizkaia;906;Forua;947;475;472
48;Bizkaia;035;Fruiz;547;278;269
48;Bizkaia;036;Galdakao;29344;14461;14883
48;Bizkaia;037;Galdames;813;424;389
48;Bizkaia;038;Gamiz-Fika;1344;669;675
48;Bizkaia;039;Garai;313;156;157
48;Bizkaia;040;Gatika;1653;836;817
48;Bizkaia;041;Gautegiz Arteaga;858;428;430
48;Bizkaia;046;Gernika-Lumo;16763;8079;8684
48;Bizkaia;044;Getxo;78846;37043;41803
48;Bizkaia;047;Gizaburuaga;213;110;103
48;Bizkaia;042;Gordexola;1710;869;841
48;Bizkaia;043;Gorliz;5670;2827;2843
48;Bizkaia;045;Güeñes;6578;3216;3362
48;Bizkaia;048;Ibarrangelu;640;323;317
48;Bizkaia;094;Igorre;4241;2062;2179
48;Bizkaia;049;Ispaster;702;373;329
48;Bizkaia;910;Iurreta;3753;1858;1895
48;Bizkaia;050;Izurtza;254;142;112
48;Bizkaia;022;Karrantza Harana/Valle de Carranza;2749;1422;1327
48;Bizkaia;907;Kortezubi;467;230;237
48;Bizkaia;051;Lanestosa;271;138;133
48;Bizkaia;052;Larrabetzu;2046;990;1056
48;Bizkaia;053;Laukiz;1145;571;574
48;Bizkaia;054;Leioa;30715;14973;15742
48;Bizkaia;057;Lekeitio;7229;3564;3665
48;Bizkaia;055;Lemoa;3505;1773;1732
48;Bizkaia;056;Lemoiz;1215;641;574
48;Bizkaia;081;Lezama;2406;1189;1217
48;Bizkaia;903;Loiu;2392;1175;1217
48;Bizkaia;058;Mallabia;1215;611;604
48;Bizkaia;059;Mañaria;527;270;257
48;Bizkaia;060;Markina-Xemein;4969;2547;2422
48;Bizkaia;061;Maruri-Jatabe;955;485;470
48;Bizkaia;062;Mendata;381;199;182
48;Bizkaia;063;Mendexa;463;239;224
48;Bizkaia;064;Meñaka;734;377;357
48;Bizkaia;066;Morga;420;219;201
48;Bizkaia;068;Mundaka;1892;912;980
48;Bizkaia;069;Mungia;17131;8348;8783
48;Bizkaia;007;Munitibar-Arbatzegi Gerrikaitz;461;247;214
48;Bizkaia;908;Murueta;310;163;147
48;Bizkaia;071;Muskiz;7601;3767;3834
48;Bizkaia;067;Muxika;1450;739;711
48;Bizkaia;909;Nabarniz;237;121;116
48;Bizkaia;073;Ondarroa;8527;4304;4223
48;Bizkaia;075;Orozko;2611;1287;1324
48;Bizkaia;083;Ortuella;8415;4116;4299
48;Bizkaia;072;Otxandio;1272;647;625
48;Bizkaia;077;Plentzia;4338;2117;2221
48;Bizkaia;078;Portugalete;46718;22337;24381
48;Bizkaia;082;Santurtzi;46284;22415;23869
48;Bizkaia;084;Sestao;28052;13598;14454
48;Bizkaia;904;Sondika;4535;2186;2349
48;Bizkaia;085;Sopela;13211;6486;6725
48;Bizkaia;086;Sopuerta;2599;1311;1288
48;Bizkaia;076;Sukarrieta;373;190;183
48;Bizkaia;087;Trucios-Turtzioz;513;278;235
48;Bizkaia;088;Ubide;179;90;89
48;Bizkaia;065;Ugao-Miraballes;4122;2065;2057
48;Bizkaia;089;Urduliz;4070;2022;2048
48;Bizkaia;074;Urduña/Orduña;4186;2132;2054
48;Bizkaia;080;Valle de Trápaga-Trapagaran;12093;5916;6177
48;Bizkaia;095;Zaldibar;3063;1534;1529
48;Bizkaia;096;Zalla;8477;4164;4313
48;Bizkaia;905;Zamudio;3244;1586;1658
48;Bizkaia;097;Zaratamo;1613;800;813
48;Bizkaia;024;Zeanuri;1258;642;616
48;Bizkaia;025;Zeberio;1081;537;544
48;Bizkaia;913;Zierbena;1493;793;700
48;Bizkaia;915;Ziortza-Bolibar;434;233;201
09;Burgos;001;Abajas;29;18;11
09;Burgos;003;Adrada de Haza;221;117;104
09;Burgos;006;Aguas Cándidas;58;35;23
09;Burgos;007;Aguilar de Bureba;68;39;29
09;Burgos;009;Albillos;221;118;103
09;Burgos;010;Alcocero de Mola;33;24;9
09;Burgos;011;Alfoz de Bricia;74;47;27
09;Burgos;907;Alfoz de Quintanadueñas;2019;1089;930
09;Burgos;012;Alfoz de Santa Gadea;105;61;44
09;Burgos;013;Altable;51;28;23
09;Burgos;014;Altos, Los;190;112;78
09;Burgos;016;Ameyugo;103;59;44
09;Burgos;017;Anguix;134;75;59
09;Burgos;018;Aranda de Duero;32880;16055;16825
09;Burgos;019;Arandilla;172;103;69
09;Burgos;020;Arauzo de Miel;350;184;166
09;Burgos;021;Arauzo de Salce;60;35;25
09;Burgos;022;Arauzo de Torre;78;43;35
09;Burgos;023;Arcos;1566;837;729
09;Burgos;024;Arenillas de Riopisuerga;179;102;77
09;Burgos;025;Arija;146;76;70
09;Burgos;026;Arlanzón;429;258;171
09;Burgos;027;Arraya de Oca;45;27;18
09;Burgos;029;Atapuerca;187;106;81
09;Burgos;030;Ausines, Los;126;78;48
09;Burgos;032;Avellanosa de Muñó;115;61;54
09;Burgos;033;Bahabón de Esgueva;89;55;34
09;Burgos;034;Balbases, Los;323;173;150
09;Burgos;035;Baños de Valdearados;361;213;148
09;Burgos;036;Bañuelos de Bureba;37;22;15
09;Burgos;037;Barbadillo de Herreros;116;69;47
09;Burgos;038;Barbadillo del Mercado;129;71;58
09;Burgos;039;Barbadillo del Pez;77;45;32
09;Burgos;041;Barrio de Muñó;32;17;15
09;Burgos;043;Barrios de Bureba, Los;199;122;77
09;Burgos;044;Barrios de Colina;52;26;26
09;Burgos;045;Basconcillos del Tozo;291;168;123
09;Burgos;046;Bascuñana;35;22;13
09;Burgos;047;Belbimbre;69;36;33
09;Burgos;048;Belorado;1969;1020;949
09;Burgos;050;Berberana;74;37;37
09;Burgos;051;Berlangas de Roa;185;96;89
09;Burgos;052;Berzosa de Bureba;32;23;9
09;Burgos;054;Bozoó;105;61;44
09;Burgos;055;Brazacorta;73;40;33
09;Burgos;056;Briviesca;7129;3606;3523
09;Burgos;057;Bugedo;175;112;63
09;Burgos;058;Buniel;516;285;231
09;Burgos;059;Burgos;177100;84478;92622
09;Burgos;060;Busto de Bureba;164;89;75
09;Burgos;061;Cabañes de Esgueva;180;96;84
09;Burgos;062;Cabezón de la Sierra;66;27;39
09;Burgos;064;Caleruega;470;232;238
09;Burgos;065;Campillo de Aranda;178;103;75
09;Burgos;066;Campolara;74;52;22
09;Burgos;067;Canicosa de la Sierra;514;274;240
09;Burgos;068;Cantabrana;31;18;13
09;Burgos;070;Carazo;34;24;10
09;Burgos;071;Carcedo de Bureba;50;28;22
09;Burgos;072;Carcedo de Burgos;388;216;172
09;Burgos;073;Cardeñadijo;1295;716;579
09;Burgos;074;Cardeñajimeno;1019;534;485
09;Burgos;075;Cardeñuela Riopico;127;73;54
09;Burgos;076;Carrias;23;20;3
09;Burgos;077;Cascajares de Bureba;36;17;19
09;Burgos;078;Cascajares de la Sierra;39;20;19
09;Burgos;079;Castellanos de Castro;48;30;18
09;Burgos;083;Castil de Peones;37;20;17
09;Burgos;082;Castildelgado;43;25;18
09;Burgos;084;Castrillo de la Reina;209;132;77
09;Burgos;085;Castrillo de la Vega;636;340;296
09;Burgos;088;Castrillo de Riopisuerga;61;39;22
09;Burgos;086;Castrillo del Val;839;504;335
09;Burgos;090;Castrillo Matajudíos;58;32;26
09;Burgos;091;Castrojeriz;845;437;408
09;Burgos;063;Cavia;247;146;101
09;Burgos;093;Cayuela;180;98;82
09;Burgos;094;Cebrecos;47;30;17
09;Burgos;095;Celada del Camino;97;51;46
09;Burgos;098;Cerezo de Río Tirón;598;322;276
09;Burgos;100;Cerratón de Juarros;55;37;18
09;Burgos;101;Ciadoncha;81;47;34
09;Burgos;102;Cillaperlata;37;25;12
09;Burgos;103;Cilleruelo de Abajo;237;129;108
09;Burgos;104;Cilleruelo de Arriba;59;31;28
09;Burgos;105;Ciruelos de Cervera;111;61;50
09;Burgos;108;Cogollos;451;249;202
09;Burgos;109;Condado de Treviño;1362;782;580
09;Burgos;110;Contreras;82;50;32
09;Burgos;112;Coruña del Conde;124;78;46
09;Burgos;113;Covarrubias;585;312;273
09;Burgos;114;Cubillo del Campo;100;54;46
09;Burgos;115;Cubo de Bureba;103;59;44
09;Burgos;117;Cueva de Roa, La;99;50;49
09;Burgos;119;Cuevas de San Clemente;49;17;32
09;Burgos;120;Encío;46;25;21
09;Burgos;122;Espinosa de Cervera;100;60;40
09;Burgos;124;Espinosa de los Monteros;1788;945;843
09;Burgos;123;Espinosa del Camino;44;26;18
09;Burgos;125;Estépar;664;396;268
09;Burgos;127;Fontioso;54;30;24
09;Burgos;128;Frandovínez;99;57;42
09;Burgos;129;Fresneda de la Sierra Tirón;123;85;38
09;Burgos;130;Fresneña;87;48;39
09;Burgos;131;Fresnillo de las Dueñas;636;336;300
09;Burgos;132;Fresno de Río Tirón;195;109;86
09;Burgos;133;Fresno de Rodilla;49;28;21
09;Burgos;134;Frías;265;143;122
09;Burgos;135;Fuentebureba;54;27;27
09;Burgos;136;Fuentecén;222;124;98
09;Burgos;137;Fuentelcésped;213;104;109
09;Burgos;138;Fuentelisendo;96;55;41
09;Burgos;139;Fuentemolinos;97;62;35
09;Burgos;140;Fuentenebro;139;84;55
09;Burgos;141;Fuentespina;769;404;365
09;Burgos;143;Galbarros;29;20;9
09;Burgos;144;Gallega, La;54;32;22
09;Burgos;148;Grijalba;104;53;51
09;Burgos;149;Grisaleña;39;28;11
09;Burgos;151;Gumiel de Izán;577;332;245
09;Burgos;152;Gumiel de Mercado;344;190;154
09;Burgos;154;Hacinas;166;93;73
09;Burgos;155;Haza;26;15;11
09;Burgos;159;Hontanas;67;42;25
09;Burgos;160;Hontangas;106;65;41
09;Burgos;162;Hontoria de la Cantera;157;86;71
09;Burgos;164;Hontoria de Valdearados;201;124;77
09;Burgos;163;Hontoria del Pinar;707;388;319
09;Burgos;166;Hormazas, Las;106;62;44
09;Burgos;167;Hornillos del Camino;56;32;24
09;Burgos;168;Horra, La;366;190;176
09;Burgos;169;Hortigüela;103;63;40
09;Burgos;170;Hoyales de Roa;211;109;102
09;Burgos;172;Huérmeces;131;63;68
09;Burgos;173;Huerta de Arriba;128;73;55
09;Burgos;174;Huerta de Rey;1007;542;465
09;Burgos;175;Humada;130;83;47
09;Burgos;176;Hurones;73;45;28
09;Burgos;177;Ibeas de Juarros;1400;778;622
09;Burgos;178;Ibrillos;55;31;24
09;Burgos;179;Iglesiarrubia;44;25;19
09;Burgos;180;Iglesias;140;78;62
09;Burgos;181;Isar;331;169;162
09;Burgos;182;Itero del Castillo;84;46;38
09;Burgos;183;Jaramillo de la Fuente;52;30;22
09;Burgos;184;Jaramillo Quemado;5;3;2
09;Burgos;189;Junta de Traslaloma;136;72;64
09;Burgos;190;Junta de Villalba de Losa;89;49;40
09;Burgos;191;Jurisdicción de Lara;47;25;22
09;Burgos;192;Jurisdicción de San Zadornil;51;27;24
09;Burgos;194;Lerma;2703;1345;1358
09;Burgos;195;Llano de Bureba;63;38;25
09;Burgos;196;Madrigal del Monte;169;103;66
09;Burgos;197;Madrigalejo del Monte;181;114;67
09;Burgos;198;Mahamud;123;70;53
09;Burgos;199;Mambrilla de Castrejón;100;53;47
09;Burgos;200;Mambrillas de Lara;48;27;21
09;Burgos;201;Mamolar;31;22;9
09;Burgos;202;Manciles;19;12;7
09;Burgos;206;Mazuela;63;34;29
09;Burgos;208;Mecerreyes;259;134;125
09;Burgos;209;Medina de Pomar;5983;3040;2943
09;Burgos;211;Melgar de Fernamental;1744;952;792
09;Burgos;213;Merindad de Cuesta-Urria;366;195;171
09;Burgos;214;Merindad de Montija;803;474;329
09;Burgos;906;Merindad de Río Ubierna;1456;800;656
09;Burgos;215;Merindad de Sotoscueva;436;244;192
09;Burgos;216;Merindad de Valdeporres;440;229;211
09;Burgos;217;Merindad de Valdivielso;400;230;170
09;Burgos;218;Milagros;460;249;211
09;Burgos;219;Miranda de Ebro;36173;17798;18375
09;Burgos;220;Miraveche;79;52;27
09;Burgos;221;Modúbar de la Emparedada;597;335;262
09;Burgos;223;Monasterio de la Sierra;48;32;16
09;Burgos;224;Monasterio de Rodilla;181;98;83
09;Burgos;225;Moncalvillo;86;51;35
09;Burgos;226;Monterrubio de la Demanda;64;36;28
09;Burgos;227;Montorio;162;86;76
09;Burgos;228;Moradillo de Roa;192;100;92
09;Burgos;229;Nava de Roa;221;113;108
09;Burgos;230;Navas de Bureba;35;15;20
09;Burgos;231;Nebreda;70;49;21
09;Burgos;232;Neila;173;100;73
09;Burgos;235;Olmedillo de Roa;199;116;83
09;Burgos;236;Olmillos de Muñó;38;22;16
09;Burgos;238;Oña;1088;568;520
09;Burgos;239;Oquillas;59;35;24
09;Burgos;241;Orbaneja Riopico;243;128;115
09;Burgos;242;Padilla de Abajo;89;52;37
09;Burgos;243;Padilla de Arriba;78;49;29
09;Burgos;244;Padrones de Bureba;52;25;27
09;Burgos;246;Palacios de la Sierra;744;372;372
09;Burgos;247;Palacios de Riopisuerga;28;14;14
09;Burgos;248;Palazuelos de la Sierra;79;45;34
09;Burgos;249;Palazuelos de Muñó;54;29;25
09;Burgos;250;Pampliega;332;176;156
09;Burgos;251;Pancorbo;453;251;202
09;Burgos;253;Pardilla;126;72;54
09;Burgos;255;Partido de la Sierra en Tobalina;84;50;34
09;Burgos;256;Pedrosa de Duero;455;251;204
09;Burgos;259;Pedrosa de Río Úrbel;249;151;98
09;Burgos;257;Pedrosa del Páramo;103;60;43
09;Burgos;258;Pedrosa del Príncipe;175;92;83
09;Burgos;261;Peñaranda de Duero;552;286;266
09;Burgos;262;Peral de Arlanza;163;87;76
09;Burgos;265;Piérnigas;40;25;15
09;Burgos;266;Pineda de la Sierra;101;62;39
09;Burgos;267;Pineda Trasmonte;126;79;47
09;Burgos;268;Pinilla de los Barruecos;111;65;46
09;Burgos;269;Pinilla de los Moros;42;26;16
09;Burgos;270;Pinilla Trasmonte;176;100;76
09;Burgos;272;Poza de la Sal;337;175;162
09;Burgos;273;Prádanos de Bureba;58;35;23
09;Burgos;274;Pradoluengo;1282;638;644
09;Burgos;275;Presencio;195;114;81
09;Burgos;276;Puebla de Arganzón, La;519;283;236
09;Burgos;277;Puentedura;129;86;43
09;Burgos;279;Quemada;259;152;107
09;Burgos;281;Quintana del Pidio;164;81;83
09;Burgos;280;Quintanabureba;30;18;12
09;Burgos;283;Quintanaélez;52;27;25
09;Burgos;287;Quintanaortuño;281;153;128
09;Burgos;288;Quintanapalla;110;63;47
09;Burgos;289;Quintanar de la Sierra;1845;973;872
09;Burgos;292;Quintanavides;96;57;39
09;Burgos;294;Quintanilla de la Mata;130;79;51
09;Burgos;901;Quintanilla del Agua y Tordueles;419;216;203
09;Burgos;295;Quintanilla del Coco;61;29;32
09;Burgos;298;Quintanilla San García;88;48;40
09;Burgos;301;Quintanilla Vivar;766;408;358
09;Burgos;297;Quintanillas, Las;391;222;169
09;Burgos;302;Rabanera del Pinar;121;72;49
09;Burgos;303;Rábanos;96;56;40
09;Burgos;304;Rabé de las Calzadas;228;119;109
09;Burgos;306;Rebolledo de la Torre;122;64;58
09;Burgos;307;Redecilla del Camino;136;81;55
09;Burgos;308;Redecilla del Campo;71;42;29
09;Burgos;309;Regumiel de la Sierra;367;187;180
09;Burgos;310;Reinoso;11;8;3
09;Burgos;311;Retuerta;65;40;25
09;Burgos;314;Revilla del Campo;96;64;32
09;Burgos;316;Revilla Vallejera;115;76;39
09;Burgos;312;Revilla y Ahedo, La;114;63;51
09;Burgos;315;Revillarruz;512;266;246
09;Burgos;317;Rezmondo;15;6;9
09;Burgos;318;Riocavado de la Sierra;59;36;23
09;Burgos;321;Roa;2373;1221;1152
09;Burgos;323;Rojas;72;47;25
09;Burgos;325;Royuela de Río Franco;212;126;86
09;Burgos;326;Rubena;176;103;73
09;Burgos;327;Rublacedo de Abajo;37;21;16
09;Burgos;328;Rucandio;77;38;39
09;Burgos;329;Salas de Bureba;133;81;52
09;Burgos;330;Salas de los Infantes;2091;1074;1017
09;Burgos;332;Saldaña de Burgos;203;111;92
09;Burgos;334;Salinillas de Bureba;48;37;11
09;Burgos;335;San Adrián de Juarros;93;55;38
09;Burgos;337;San Juan del Monte;139;81;58
09;Burgos;338;San Mamés de Burgos;286;161;125
09;Burgos;339;San Martín de Rubiales;142;80;62
09;Burgos;340;San Millán de Lara;78;54;24
09;Burgos;360;San Vicente del Valle;29;19;10
09;Burgos;343;Santa Cecilia;105;63;42
09;Burgos;345;Santa Cruz de la Salceda;152;88;64
09;Burgos;346;Santa Cruz del Valle Urbión;103;63;40
09;Burgos;347;Santa Gadea del Cid;155;84;71
09;Burgos;348;Santa Inés;155;78;77
09;Burgos;350;Santa María del Campo;595;324;271
09;Burgos;351;Santa María del Invierno;63;44;19
09;Burgos;352;Santa María del Mercadillo;114;68;46
09;Burgos;353;Santa María Rivarredonda;94;58;36
09;Burgos;354;Santa Olalla de Bureba;33;24;9
09;Burgos;355;Santibáñez de Esgueva;99;54;45
09;Burgos;356;Santibáñez del Val;50;30;20
09;Burgos;358;Santo Domingo de Silos;287;175;112
09;Burgos;361;Sargentes de la Lora;129;73;56
09;Burgos;362;Sarracín;246;140;106
09;Burgos;363;Sasamón;1073;602;471
09;Burgos;365;Sequera de Haza, La;34;22;12
09;Burgos;366;Solarana;93;48;45
09;Burgos;368;Sordillos;24;15;9
09;Burgos;369;Sotillo de la Ribera;520;274;246
09;Burgos;372;Sotragero;286;154;132
09;Burgos;373;Sotresgudo;482;276;206
09;Burgos;374;Susinos del Páramo;103;67;36
09;Burgos;375;Tamarón;38;20;18
09;Burgos;377;Tardajos;803;417;386
09;Burgos;378;Tejada;28;20;8
09;Burgos;380;Terradillos de Esgueva;86;39;47
09;Burgos;381;Tinieblas de la Sierra;37;21;16
09;Burgos;382;Tobar;27;16;11
09;Burgos;384;Tordómar;343;190;153
09;Burgos;386;Torrecilla del Monte;69;38;31
09;Burgos;387;Torregalindo;136;84;52
09;Burgos;388;Torrelara;37;20;17
09;Burgos;389;Torrepadre;78;45;33
09;Burgos;390;Torresandino;691;373;318
09;Burgos;391;Tórtoles de Esgueva;498;260;238
09;Burgos;392;Tosantos;56;32;24
09;Burgos;394;Trespaderne;877;462;415
09;Burgos;395;Tubilla del Agua;154;96;58
09;Burgos;396;Tubilla del Lago;150;83;67
09;Burgos;398;Úrbel del Castillo;79;53;26
09;Burgos;400;Vadocondes;382;210;172
09;Burgos;403;Valdeande;100;66;34
09;Burgos;405;Valdezate;140;74;66
09;Burgos;406;Valdorros;332;186;146
09;Burgos;408;Vallarta de Bureba;45;28;17
09;Burgos;904;Valle de las Navas;533;309;224
09;Burgos;908;Valle de Losa;538;319;219
09;Burgos;409;Valle de Manzanedo;132;71;61
09;Burgos;410;Valle de Mena;3826;1955;1871
09;Burgos;411;Valle de Oca;159;99;60
09;Burgos;902;Valle de Santibáñez;505;281;224
09;Burgos;905;Valle de Sedano;472;273;199
09;Burgos;412;Valle de Tobalina;1026;559;467
09;Burgos;413;Valle de Valdebezana;506;270;236
09;Burgos;414;Valle de Valdelaguna;213;122;91
09;Burgos;415;Valle de Valdelucio;309;163;146
09;Burgos;416;Valle de Zamanzas;68;35;33
09;Burgos;417;Vallejera;42;25;17
09;Burgos;418;Valles de Palenzuela;89;45;44
09;Burgos;419;Valluércanes;77;51;26
09;Burgos;407;Valmala;28;15;13
09;Burgos;422;Vid de Bureba, La;20;9;11
09;Burgos;421;Vid y Barrios, La;274;155;119
09;Burgos;423;Vileña;29;18;11
09;Burgos;427;Villadiego;1593;870;723
09;Burgos;428;Villaescusa de Roa;113;63;50
09;Burgos;429;Villaescusa la Sombría;69;49;20
09;Burgos;430;Villaespasa;26;15;11
09;Burgos;431;Villafranca Montes de Oca;129;78;51
09;Burgos;432;Villafruela;209;118;91
09;Burgos;433;Villagalijo;66;43;23
09;Burgos;434;Villagonzalo Pedernales;1774;930;844
09;Burgos;437;Villahoz;320;174;146
09;Burgos;438;Villalba de Duero;683;358;325
09;Burgos;439;Villalbilla de Burgos;1279;675;604
09;Burgos;440;Villalbilla de Gumiel;93;56;37
09;Burgos;441;Villaldemiro;68;39;29
09;Burgos;442;Villalmanzo;450;243;207
09;Burgos;443;Villamayor de los Montes;202;101;101
09;Burgos;444;Villamayor de Treviño;76;37;39
09;Burgos;445;Villambistia;46;32;14
09;Burgos;446;Villamedianilla;12;7;5
09;Burgos;447;Villamiel de la Sierra;40;24;16
09;Burgos;448;Villangómez;239;147;92
09;Burgos;449;Villanueva de Argaño;106;65;41
09;Burgos;450;Villanueva de Carazo;32;21;11
09;Burgos;451;Villanueva de Gumiel;284;143;141
09;Burgos;454;Villanueva de Teba;48;30;18
09;Burgos;455;Villaquirán de la Puebla;47;27;20
09;Burgos;456;Villaquirán de los Infantes;146;77;69
09;Burgos;903;Villarcayo de Merindad de Castilla la Vieja;4372;2259;2113
09;Burgos;458;Villariezo;612;340;272
09;Burgos;460;Villasandino;192;115;77
09;Burgos;463;Villasur de Herreros;265;151;114
09;Burgos;464;Villatuelda;43;24;19
09;Burgos;466;Villaverde del Monte;134;76;58
09;Burgos;467;Villaverde-Mogina;86;57;29
09;Burgos;471;Villayerno Morquillas;207;110;97
09;Burgos;472;Villazopeque;57;36;21
09;Burgos;473;Villegas;90;51;39
09;Burgos;476;Villoruebo;85;53;32
09;Burgos;424;Viloria de Rioja;39;23;16
09;Burgos;425;Vilviestre del Pinar;616;337;279
09;Burgos;478;Vizcaínos;49;31;18
09;Burgos;480;Zael;115;59;56
09;Burgos;482;Zarzosa de Río Pisuerga;31;19;12
09;Burgos;483;Zazuar;242;128;114
09;Burgos;485;Zuñeda;57;35;22
10;Cáceres;001;Abadía;336;188;148
10;Cáceres;002;Abertura;429;214;215
10;Cáceres;003;Acebo;569;290;279
10;Cáceres;004;Acehúche;822;402;420
10;Cáceres;005;Aceituna;623;323;300
10;Cáceres;006;Ahigal;1421;742;679
10;Cáceres;903;Alagón del Río;923;468;455
10;Cáceres;007;Albalá;730;366;364
10;Cáceres;008;Alcántara;1571;782;789
10;Cáceres;009;Alcollarín;256;123;133
10;Cáceres;010;Alcuéscar;2759;1425;1334
10;Cáceres;012;Aldea del Cano;667;316;351
10;Cáceres;013;Aldea del Obispo, La;331;174;157
10;Cáceres;011;Aldeacentenera;646;331;315
10;Cáceres;014;Aldeanueva de la Vera;2155;1051;1104
10;Cáceres;015;Aldeanueva del Camino;791;383;408
10;Cáceres;016;Aldehuela de Jerte;367;200;167
10;Cáceres;017;Alía;936;466;470
10;Cáceres;018;Aliseda;1957;983;974
10;Cáceres;019;Almaraz;1669;855;814
10;Cáceres;020;Almoharín;1933;948;985
10;Cáceres;021;Arroyo de la Luz;6042;2996;3046
10;Cáceres;023;Arroyomolinos;787;420;367
10;Cáceres;022;Arroyomolinos de la Vera;471;238;233
10;Cáceres;024;Baños de Montemayor;774;372;402
10;Cáceres;025;Barrado;434;224;210
10;Cáceres;026;Belvís de Monroy;650;337;313
10;Cáceres;027;Benquerencia;80;44;36
10;Cáceres;028;Berrocalejo;125;66;59
10;Cáceres;029;Berzocana;461;236;225
10;Cáceres;030;Bohonal de Ibor;499;253;246
10;Cáceres;031;Botija;189;101;88
10;Cáceres;032;Brozas;1953;977;976
10;Cáceres;033;Cabañas del Castillo;470;253;217
10;Cáceres;034;Cabezabellosa;381;198;183
10;Cáceres;035;Cabezuela del Valle;2267;1170;1097
10;Cáceres;036;Cabrero;356;196;160
10;Cáceres;037;Cáceres;95617;45947;49670
10;Cáceres;038;Cachorrilla;93;49;44
10;Cáceres;039;Cadalso;468;233;235
10;Cáceres;040;Calzadilla;501;256;245
10;Cáceres;041;Caminomorisco;1268;667;601
10;Cáceres;042;Campillo de Deleitosa;52;22;30
10;Cáceres;043;Campo Lugar;916;459;457
10;Cáceres;044;Cañamero;1709;898;811
10;Cáceres;045;Cañaveral;1081;530;551
10;Cáceres;046;Carbajo;217;109;108
10;Cáceres;047;Carcaboso;1136;572;564
10;Cáceres;048;Carrascalejo;257;126;131
10;Cáceres;049;Casar de Cáceres;4664;2313;2351
10;Cáceres;050;Casar de Palomero;1245;631;614
10;Cáceres;051;Casares de las Hurdes;449;233;216
10;Cáceres;052;Casas de Don Antonio;204;101;103
10;Cáceres;053;Casas de Don Gómez;301;160;141
10;Cáceres;056;Casas de Millán;653;331;322
10;Cáceres;057;Casas de Miravete;157;101;56
10;Cáceres;054;Casas del Castañar;604;295;309
10;Cáceres;055;Casas del Monte;828;416;412
10;Cáceres;058;Casatejada;1428;737;691
10;Cáceres;059;Casillas de Coria;416;200;216
10;Cáceres;060;Castañar de Ibor;1112;571;541
10;Cáceres;061;Ceclavín;1943;988;955
10;Cáceres;062;Cedillo;490;254;236
10;Cáceres;063;Cerezo;186;89;97
10;Cáceres;064;Cilleros;1757;889;868
10;Cáceres;065;Collado de la Vera;181;100;81
10;Cáceres;066;Conquista de la Sierra;191;110;81
10;Cáceres;067;Coria;12930;6353;6577
10;Cáceres;068;Cuacos de Yuste;865;444;421
10;Cáceres;069;Cumbre, La;914;460;454
10;Cáceres;070;Deleitosa;775;392;383
10;Cáceres;071;Descargamaría;147;83;64
10;Cáceres;072;Eljas;941;478;463
10;Cáceres;073;Escurial;755;399;356
10;Cáceres;075;Fresnedoso de Ibor;293;156;137
10;Cáceres;076;Galisteo;992;485;507
10;Cáceres;077;Garciaz;804;422;382
10;Cáceres;079;Garganta la Olla;1010;528;482
10;Cáceres;078;Garganta, La;446;238;208
10;Cáceres;080;Gargantilla;409;208;201
10;Cáceres;081;Gargüera;126;70;56
10;Cáceres;082;Garrovillas de Alconétar;2205;1071;1134
10;Cáceres;083;Garvín;92;52;40
10;Cáceres;084;Gata;1593;820;773
10;Cáceres;085;Gordo, El;394;199;195
10;Cáceres;086;Granja, La;357;193;164
10;Cáceres;087;Guadalupe;2013;988;1025
10;Cáceres;088;Guijo de Coria;216;114;102
10;Cáceres;089;Guijo de Galisteo;1576;794;782
10;Cáceres;090;Guijo de Granadilla;581;308;273
10;Cáceres;091;Guijo de Santa Bárbara;431;229;202
10;Cáceres;092;Herguijuela;336;171;165
10;Cáceres;093;Hernán-Pérez;485;243;242
10;Cáceres;094;Herrera de Alcántara;270;137;133
10;Cáceres;095;Herreruela;375;189;186
10;Cáceres;096;Hervás;4194;2074;2120
10;Cáceres;097;Higuera;114;68;46
10;Cáceres;098;Hinojal;417;210;207
10;Cáceres;099;Holguera;692;344;348
10;Cáceres;100;Hoyos;934;461;473
10;Cáceres;101;Huélaga;220;111;109
10;Cáceres;102;Ibahernando;554;269;285
10;Cáceres;103;Jaraicejo;510;248;262
10;Cáceres;104;Jaraíz de la Vera;6481;3242;3239
10;Cáceres;105;Jarandilla de la Vera;2955;1471;1484
10;Cáceres;106;Jarilla;146;75;71
10;Cáceres;107;Jerte;1282;650;632
10;Cáceres;108;Ladrillar;222;117;105
10;Cáceres;109;Logrosán;2068;1047;1021
10;Cáceres;110;Losar de la Vera;2833;1456;1377
10;Cáceres;111;Madrigal de la Vera;1705;891;814
10;Cáceres;112;Madrigalejo;1855;930;925
10;Cáceres;113;Madroñera;2695;1345;1350
10;Cáceres;114;Majadas;1343;670;673
10;Cáceres;115;Malpartida de Cáceres;4337;2168;2169
10;Cáceres;116;Malpartida de Plasencia;4714;2365;2349
10;Cáceres;117;Marchagaz;220;118;102
10;Cáceres;118;Mata de Alcántara;320;166;154
10;Cáceres;119;Membrío;695;340;355
10;Cáceres;120;Mesas de Ibor;187;101;86
10;Cáceres;121;Miajadas;9944;4944;5000
10;Cáceres;122;Millanes;257;135;122
10;Cáceres;123;Mirabel;687;343;344
10;Cáceres;124;Mohedas de Granadilla;849;429;420
10;Cáceres;125;Monroy;1037;516;521
10;Cáceres;126;Montánchez;1828;913;915
10;Cáceres;127;Montehermoso;5844;2984;2860
10;Cáceres;128;Moraleja;6963;3480;3483
10;Cáceres;129;Morcillo;407;193;214
10;Cáceres;130;Navaconcejo;2030;1032;998
10;Cáceres;131;Navalmoral de la Mata;17156;8284;8872
10;Cáceres;132;Navalvillar de Ibor;447;224;223
10;Cáceres;133;Navas del Madroño;1372;679;693
10;Cáceres;134;Navezuelas;664;341;323
10;Cáceres;135;Nuñomoral;1392;739;653
10;Cáceres;136;Oliva de Plasencia;336;188;148
10;Cáceres;137;Palomero;378;202;176
10;Cáceres;138;Pasarón de la Vera;655;314;341
10;Cáceres;139;Pedroso de Acim;104;54;50
10;Cáceres;140;Peraleda de la Mata;1403;711;692
10;Cáceres;141;Peraleda de San Román;306;153;153
10;Cáceres;142;Perales del Puerto;970;496;474
10;Cáceres;143;Pescueza;165;77;88
10;Cáceres;144;Pesga, La;1130;594;536
10;Cáceres;145;Piedras Albas;156;74;82
10;Cáceres;146;Pinofranqueado;1762;938;824
10;Cáceres;147;Piornal;1555;789;766
10;Cáceres;148;Plasencia;40755;19786;20969
10;Cáceres;149;Plasenzuela;501;248;253
10;Cáceres;150;Portaje;397;203;194
10;Cáceres;151;Portezuelo;246;130;116
10;Cáceres;152;Pozuelo de Zarzón;483;243;240
10;Cáceres;153;Puerto de Santa Cruz;363;183;180
10;Cáceres;154;Rebollar;219;107;112
10;Cáceres;155;Riolobos;1310;680;630
10;Cáceres;156;Robledillo de Gata;99;53;46
10;Cáceres;157;Robledillo de la Vera;301;157;144
10;Cáceres;158;Robledillo de Trujillo;372;197;175
10;Cáceres;159;Robledollano;327;182;145
10;Cáceres;160;Romangordo;263;125;138
10;Cáceres;901;Rosalejo;1495;787;708
10;Cáceres;161;Ruanes;75;41;34
10;Cáceres;162;Salorino;630;328;302
10;Cáceres;163;Salvatierra de Santiago;239;120;119
10;Cáceres;164;San Martín de Trevejo;851;425;426
10;Cáceres;165;Santa Ana;276;149;127
10;Cáceres;166;Santa Cruz de la Sierra;329;163;166
10;Cáceres;167;Santa Cruz de Paniagua;326;177;149
10;Cáceres;168;Santa Marta de Magasca;295;148;147
10;Cáceres;169;Santiago de Alcántara;583;283;300
10;Cáceres;170;Santiago del Campo;279;139;140
10;Cáceres;171;Santibáñez el Alto;349;178;171
10;Cáceres;172;Santibáñez el Bajo;738;387;351
10;Cáceres;173;Saucedilla;877;466;411
10;Cáceres;174;Segura de Toro;189;86;103
10;Cáceres;175;Serradilla;1637;832;805
10;Cáceres;176;Serrejón;443;225;218
10;Cáceres;177;Sierra de Fuentes;2040;1034;1006
10;Cáceres;178;Talaván;887;449;438
10;Cáceres;179;Talaveruela de la Vera;345;183;162
10;Cáceres;180;Talayuela;8240;4435;3805
10;Cáceres;181;Tejeda de Tiétar;837;455;382
10;Cáceres;904;Tiétar;940;493;447
10;Cáceres;182;Toril;170;111;59
10;Cáceres;183;Tornavacas;1144;595;549
10;Cáceres;184;Torno, El;956;501;455
10;Cáceres;187;Torre de Don Miguel;503;268;235
10;Cáceres;188;Torre de Santa María;582;293;289
10;Cáceres;185;Torrecilla de los Ángeles;653;337;316
10;Cáceres;186;Torrecillas de la Tiesa;1134;563;571
10;Cáceres;190;Torrejón el Rubio;628;315;313
10;Cáceres;189;Torrejoncillo;3184;1571;1613
10;Cáceres;191;Torremenga;629;341;288
10;Cáceres;192;Torremocha;915;449;466
10;Cáceres;193;Torreorgaz;1695;819;876
10;Cáceres;194;Torrequemada;601;285;316
10;Cáceres;195;Trujillo;9510;4620;4890
10;Cáceres;196;Valdastillas;334;170;164
10;Cáceres;197;Valdecañas de Tajo;137;76;61
10;Cáceres;198;Valdefuentes;1293;637;656
10;Cáceres;199;Valdehúncar;187;99;88
10;Cáceres;200;Valdelacasa de Tajo;455;227;228
10;Cáceres;201;Valdemorales;198;99;99
10;Cáceres;202;Valdeobispo;701;340;361
10;Cáceres;203;Valencia de Alcántara;5699;2811;2888
10;Cáceres;204;Valverde de la Vera;529;266;263
10;Cáceres;205;Valverde del Fresno;2422;1227;1195
10;Cáceres;902;Vegaviana;863;446;417
10;Cáceres;206;Viandar de la Vera;255;132;123
10;Cáceres;207;Villa del Campo;515;250;265
10;Cáceres;208;Villa del Rey;130;66;64
10;Cáceres;209;Villamesías;289;141;148
10;Cáceres;210;Villamiel;518;262;256
10;Cáceres;211;Villanueva de la Sierra;460;228;232
10;Cáceres;212;Villanueva de la Vera;2122;1079;1043
10;Cáceres;214;Villar de Plasencia;223;116;107
10;Cáceres;213;Villar del Pedroso;636;331;305
10;Cáceres;215;Villasbuenas de Gata;388;200;188
10;Cáceres;216;Zarza de Granadilla;1843;950;893
10;Cáceres;217;Zarza de Montánchez;594;295;299
10;Cáceres;218;Zarza la Mayor;1359;673;686
10;Cáceres;219;Zorita;1502;751;751
11;Cádiz;001;Alcalá de los Gazules;5326;2734;2592
11;Cádiz;002;Alcalá del Valle;5224;2620;2604
11;Cádiz;003;Algar;1448;750;698
11;Cádiz;004;Algeciras;118920;58776;60144
11;Cádiz;005;Algodonales;5649;2876;2773
11;Cádiz;006;Arcos de la Frontera;31193;15624;15569
11;Cádiz;007;Barbate;22808;11435;11373
11;Cádiz;008;Barrios, Los;23167;11614;11553
11;Cádiz;901;Benalup-Casas Viejas;7000;3560;3440
11;Cádiz;009;Benaocaz;720;383;337
11;Cádiz;010;Bornos;7934;3956;3978
11;Cádiz;011;Bosque, El;2067;1046;1021
11;Cádiz;012;Cádiz;120468;57001;63467
11;Cádiz;013;Castellar de la Frontera;3045;1527;1518
11;Cádiz;015;Chiclana de la Frontera;82777;41691;41086
11;Cádiz;016;Chipiona;19062;9578;9484
11;Cádiz;014;Conil de la Frontera;22136;11183;10953
11;Cádiz;017;Espera;3915;1970;1945
11;Cádiz;018;Gastor, El;1809;942;867
11;Cádiz;019;Grazalema;2165;1085;1080
11;Cádiz;020;Jerez de la Frontera;212876;104237;108639
11;Cádiz;021;Jimena de la Frontera;9772;5016;4756
11;Cádiz;022;Línea de la Concepción, La;63352;31073;32279
11;Cádiz;023;Medina-Sidonia;11749;5990;5759
11;Cádiz;024;Olvera;8289;4089;4200
11;Cádiz;025;Paterna de Rivera;5585;2880;2705
11;Cádiz;026;Prado del Rey;5819;2908;2911
11;Cádiz;027;Puerto de Santa María, El;88335;43424;44911
11;Cádiz;028;Puerto Real;41509;20911;20598
11;Cádiz;029;Puerto Serrano;7145;3613;3532
11;Cádiz;030;Rota;29123;14545;14578
11;Cádiz;031;San Fernando;96131;47132;48999
11;Cádiz;902;San José del Valle;4427;2261;2166
11;Cádiz;033;San Roque;29373;14652;14721
11;Cádiz;032;Sanlúcar de Barrameda;67433;33621;33812
11;Cádiz;034;Setenil de las Bodegas;2845;1457;1388
11;Cádiz;035;Tarifa;18011;9127;8884
11;Cádiz;036;Torre Alháquime;779;399;380
11;Cádiz;037;Trebujena;7072;3542;3530
11;Cádiz;038;Ubrique;16836;8294;8542
11;Cádiz;039;Vejer de la Frontera;12812;6412;6400
11;Cádiz;040;Villaluenga del Rosario;471;248;223
11;Cádiz;041;Villamartín;12271;6177;6094
11;Cádiz;042;Zahara;1436;735;701
39;Cantabria;001;Alfoz de Lloredo;2485;1269;1216
39;Cantabria;002;Ampuero;4184;2141;2043
39;Cantabria;003;Anievas;326;165;161
39;Cantabria;004;Arenas de Iguña;1752;904;848
39;Cantabria;005;Argoños;1744;908;836
39;Cantabria;006;Arnuero;2125;1073;1052
39;Cantabria;007;Arredondo;498;285;213
39;Cantabria;008;Astillero, El;18297;8954;9343
39;Cantabria;009;Bárcena de Cicero;4127;2151;1976
39;Cantabria;010;Bárcena de Pie de Concha;728;359;369
39;Cantabria;011;Bareyo;2011;1012;999
39;Cantabria;012;Cabezón de la Sal;8353;4047;4306
39;Cantabria;013;Cabezón de Liébana;622;363;259
39;Cantabria;014;Cabuérniga;998;541;457
39;Cantabria;015;Camaleño;1008;542;466
39;Cantabria;016;Camargo;30766;15125;15641
39;Cantabria;027;Campoo de Enmedio;3780;1938;1842
39;Cantabria;017;Campoo de Yuso;685;373;312
39;Cantabria;018;Cartes;5670;2860;2810
39;Cantabria;019;Castañeda;2681;1365;1316
39;Cantabria;020;Castro-Urdiales;31833;15896;15937
39;Cantabria;021;Cieza;560;284;276
39;Cantabria;022;Cillorigo de Liébana;1318;707;611
39;Cantabria;023;Colindres;8271;4089;4182
39;Cantabria;024;Comillas;2267;1070;1197
39;Cantabria;025;Corrales de Buelna, Los;11077;5432;5645
39;Cantabria;026;Corvera de Toranzo;2080;1058;1022
39;Cantabria;028;Entrambasaguas;4931;2513;2418
39;Cantabria;029;Escalante;758;393;365
39;Cantabria;030;Guriezo;2354;1211;1143
39;Cantabria;031;Hazas de Cesto;1520;767;753
39;Cantabria;032;Hermandad de Campoo de Suso;1679;913;766
39;Cantabria;033;Herrerías;657;373;284
39;Cantabria;034;Lamasón;302;192;110
39;Cantabria;035;Laredo;11643;5553;6090
39;Cantabria;036;Liendo;1223;630;593
39;Cantabria;037;Liérganes;2386;1186;1200
39;Cantabria;038;Limpias;1815;905;910
39;Cantabria;039;Luena;634;345;289
39;Cantabria;040;Marina de Cudeyo;5203;2613;2590
39;Cantabria;041;Mazcuerras;2127;1090;1037
39;Cantabria;042;Medio Cudeyo;7530;3671;3859
39;Cantabria;043;Meruelo;1922;980;942
39;Cantabria;044;Miengo;4675;2367;2308
39;Cantabria;045;Miera;410;214;196
39;Cantabria;046;Molledo;1595;790;805
39;Cantabria;047;Noja;2587;1293;1294
39;Cantabria;048;Penagos;2017;1022;995
39;Cantabria;049;Peñarrubia;351;191;160
39;Cantabria;050;Pesaguero;312;180;132
39;Cantabria;051;Pesquera;73;42;31
39;Cantabria;052;Piélagos;24360;12135;12225
39;Cantabria;053;Polaciones;241;154;87
39;Cantabria;054;Polanco;5705;2867;2838
39;Cantabria;055;Potes;1413;697;716
39;Cantabria;056;Puente Viesgo;2886;1471;1415
39;Cantabria;057;Ramales de la Victoria;2820;1434;1386
39;Cantabria;058;Rasines;990;525;465
39;Cantabria;059;Reinosa;9605;4516;5089
39;Cantabria;060;Reocín;8382;4124;4258
39;Cantabria;061;Ribamontán al Mar;4419;2241;2178
39;Cantabria;062;Ribamontán al Monte;2267;1174;1093
39;Cantabria;063;Rionansa;1051;588;463
39;Cantabria;064;Riotuerto;1638;797;841
39;Cantabria;065;Rozas de Valdearroyo, Las;282;159;123
39;Cantabria;066;Ruente;1037;559;478
39;Cantabria;067;Ruesga;903;484;419
39;Cantabria;068;Ruiloba;768;399;369
39;Cantabria;069;San Felices de Buelna;2408;1192;1216
39;Cantabria;070;San Miguel de Aguayo;164;83;81
39;Cantabria;071;San Pedro del Romeral;461;256;205
39;Cantabria;072;San Roque de Riomiera;394;233;161
39;Cantabria;080;San Vicente de la Barquera;4247;2117;2130
39;Cantabria;073;Santa Cruz de Bezana;12560;6188;6372
39;Cantabria;074;Santa María de Cayón;9090;4598;4492
39;Cantabria;075;Santander;173957;80318;93639
39;Cantabria;076;Santillana del Mar;4203;2036;2167
39;Cantabria;077;Santiurde de Reinosa;279;162;117
39;Cantabria;078;Santiurde de Toranzo;1619;824;795
39;Cantabria;079;Santoña;11088;5428;5660
39;Cantabria;081;Saro;511;268;243
39;Cantabria;082;Selaya;1922;959;963
39;Cantabria;083;Soba;1260;684;576
39;Cantabria;084;Solórzano;1010;535;475
39;Cantabria;085;Suances;8612;4286;4326
39;Cantabria;086;Tojos, Los;404;238;166
39;Cantabria;087;Torrelavega;53496;25405;28091
39;Cantabria;088;Tresviso;71;48;23
39;Cantabria;089;Tudanca;154;110;44
39;Cantabria;090;Udías;895;450;445
39;Cantabria;095;Val de San Vicente;2797;1448;1349
39;Cantabria;091;Valdáliga;2309;1205;1104
39;Cantabria;092;Valdeolea;1020;530;490
39;Cantabria;093;Valdeprado del Río;331;189;142
39;Cantabria;094;Valderredible;1001;556;445
39;Cantabria;101;Valle de Villaverde;336;167;169
39;Cantabria;096;Vega de Liébana;793;422;371
39;Cantabria;097;Vega de Pas;814;417;397
39;Cantabria;098;Villacarriedo;1669;875;794
39;Cantabria;099;Villaescusa;3826;1907;1919
39;Cantabria;100;Villafufre;1032;540;492
39;Cantabria;102;Voto;2729;1445;1284
12;Castellón/Castelló;002;Aín;131;71;60
12;Castellón/Castelló;003;Albocàsser;1334;662;672
12;Castellón/Castelló;004;Alcalà de Xivert;7255;3687;3568
12;Castellón/Castelló;005;Alcora, l';10591;5372;5219
12;Castellón/Castelló;006;Alcudia de Veo;209;113;96
12;Castellón/Castelló;007;Alfondeguilla;901;456;445
12;Castellón/Castelló;008;Algimia de Almonacid;281;161;120
12;Castellón/Castelló;009;Almazora/Almassora;25488;12785;12703
12;Castellón/Castelló;010;Almedíjar;275;142;133
12;Castellón/Castelló;011;Almenara;6031;2994;3037
12;Castellón/Castelló;901;Alquerías del Niño Perdido;4503;2231;2272
12;Castellón/Castelló;012;Altura;3647;1879;1768
12;Castellón/Castelló;013;Arañuel;171;91;80
12;Castellón/Castelló;014;Ares del Maestrat;208;116;92
12;Castellón/Castelló;015;Argelita;103;57;46
12;Castellón/Castelló;016;Artana;1992;1021;971
12;Castellón/Castelló;001;Atzeneta del Maestrat;1307;671;636
12;Castellón/Castelló;017;Ayódar;175;93;82
12;Castellón/Castelló;018;Azuébar;325;170;155
12;Castellón/Castelló;020;Barracas;181;99;82
12;Castellón/Castelló;022;Bejís;399;228;171
12;Castellón/Castelló;024;Benafer;170;88;82
12;Castellón/Castelló;025;Benafigos;156;89;67
12;Castellón/Castelló;026;Benasal;1150;584;566
12;Castellón/Castelló;027;Benicarló;26403;13161;13242
12;Castellón/Castelló;028;Benicasim/Benicàssim;18098;9083;9015
12;Castellón/Castelló;029;Benlloch;1119;562;557
12;Castellón/Castelló;021;Betxí;5763;2842;2921
12;Castellón/Castelló;032;Borriana/Burriana;34708;17244;17464
12;Castellón/Castelló;031;Borriol;5176;2615;2561
12;Castellón/Castelló;033;Cabanes;2939;1474;1465
12;Castellón/Castelló;034;Càlig;2049;1049;1000
12;Castellón/Castelló;036;Canet lo Roig;746;364;382
12;Castellón/Castelló;037;Castell de Cabres;16;10;6
12;Castellón/Castelló;038;Castellfort;206;104;102
12;Castellón/Castelló;039;Castellnovo;1003;505;498
12;Castellón/Castelló;040;Castellón de la Plana/Castelló de la Plana;171669;83406;88263
12;Castellón/Castelló;041;Castillo de Villamalefa;112;72;40
12;Castellón/Castelló;042;Catí;779;395;384
12;Castellón/Castelló;043;Caudiel;700;359;341
12;Castellón/Castelló;044;Cervera del Maestre;653;312;341
12;Castellón/Castelló;053;Chilches/Xilxes;2752;1440;1312
12;Castellón/Castelló;055;Chodos/Xodos;124;70;54
12;Castellón/Castelló;056;Chóvar;327;172;155
12;Castellón/Castelló;045;Cinctorres;424;207;217
12;Castellón/Castelló;046;Cirat;233;130;103
12;Castellón/Castelló;048;Cortes de Arenoso;308;165;143
12;Castellón/Castelló;049;Costur;550;287;263
12;Castellón/Castelló;050;Coves de Vinromà, les;1870;933;937
12;Castellón/Castelló;051;Culla;535;271;264
12;Castellón/Castelló;057;Eslida;833;415;418
12;Castellón/Castelló;058;Espadilla;86;48;38
12;Castellón/Castelló;059;Fanzara;314;158;156
12;Castellón/Castelló;060;Figueroles;539;276;263
12;Castellón/Castelló;061;Forcall;476;231;245
12;Castellón/Castelló;063;Fuente la Reina;51;29;22
12;Castellón/Castelló;064;Fuentes de Ayódar;130;68;62
12;Castellón/Castelló;065;Gaibiel;205;109;96
12;Castellón/Castelló;067;Geldo;651;335;316
12;Castellón/Castelló;068;Herbés;49;26;23
12;Castellón/Castelló;069;Higueras;91;49;42
12;Castellón/Castelló;070;Jana, la;714;358;356
12;Castellón/Castelló;071;Jérica;1599;820;779
12;Castellón/Castelló;074;Llosa, la;988;488;500
12;Castellón/Castelló;072;Lucena del Cid;1385;701;684
12;Castellón/Castelló;073;Ludiente;181;99;82
12;Castellón/Castelló;075;Mata de Morella, la;176;89;87
12;Castellón/Castelló;076;Matet;95;47;48
12;Castellón/Castelló;077;Moncofa;6256;3259;2997
12;Castellón/Castelló;078;Montán;393;186;207
12;Castellón/Castelló;079;Montanejos;549;268;281
12;Castellón/Castelló;080;Morella;2575;1274;1301
12;Castellón/Castelló;081;Navajas;765;398;367
12;Castellón/Castelló;082;Nules;13442;6664;6778
12;Castellón/Castelló;083;Olocau del Rey;123;67;56
12;Castellón/Castelló;084;Onda;24963;12566;12397
12;Castellón/Castelló;085;Oropesa del Mar/Orpesa;9493;4992;4501
12;Castellón/Castelló;087;Palanques;31;15;16
12;Castellón/Castelló;088;Pavías;74;43;31
12;Castellón/Castelló;089;Peníscola/Peñíscola;7444;3772;3672
12;Castellón/Castelló;090;Pina de Montalgrao;129;65;64
12;Castellón/Castelló;093;Pobla de Benifassà, la;228;121;107
12;Castellón/Castelló;094;Pobla Tornesa, la;1191;626;565
12;Castellón/Castelló;091;Portell de Morella;218;113;105
12;Castellón/Castelló;092;Puebla de Arenoso;141;76;65
12;Castellón/Castelló;095;Ribesalbes;1233;623;610
12;Castellón/Castelló;096;Rossell;1020;533;487
12;Castellón/Castelló;097;Sacañet;80;48;32
12;Castellón/Castelló;098;Salzadella, la;762;384;378
12;Castellón/Castelló;101;San Rafael del Río;502;254;248
12;Castellón/Castelló;902;Sant Joan de Moró;3051;1593;1458
12;Castellón/Castelló;099;Sant Jordi/San Jorge;1020;520;500
12;Castellón/Castelló;100;Sant Mateu;1995;986;1009
12;Castellón/Castelló;102;Santa Magdalena de Pulpis;810;438;372
12;Castellón/Castelló;104;Segorbe;9073;4486;4587
12;Castellón/Castelló;103;Serratella, la;101;54;47
12;Castellón/Castelló;105;Sierra Engarcerán;1018;540;478
12;Castellón/Castelló;106;Soneja;1476;722;754
12;Castellón/Castelló;107;Sot de Ferrer;428;219;209
12;Castellón/Castelló;108;Sueras/Suera;564;289;275
12;Castellón/Castelló;109;Tales;836;419;417
12;Castellón/Castelló;110;Teresa;277;143;134
12;Castellón/Castelló;111;Tírig;489;251;238
12;Castellón/Castelló;112;Todolella;140;80;60
12;Castellón/Castelló;113;Toga;106;53;53
12;Castellón/Castelló;114;Torás;231;117;114
12;Castellón/Castelló;115;Toro, El;251;139;112
12;Castellón/Castelló;116;Torralba del Pinar;71;34;37
12;Castellón/Castelló;119;Torre d'En Besora, la;163;94;69
12;Castellón/Castelló;120;Torre d'en Doménec, la;217;109;108
12;Castellón/Castelló;117;Torreblanca;5413;2744;2669
12;Castellón/Castelló;118;Torrechiva;81;48;33
12;Castellón/Castelló;121;Traiguera;1534;775;759
12;Castellón/Castelló;122;Useras/Useres, les;1014;532;482
12;Castellón/Castelló;124;Vall d'Alba;2844;1478;1366
12;Castellón/Castelló;125;Vall de Almonacid;262;140;122
12;Castellón/Castelló;126;Vall d'Uixó, la;31671;15703;15968
12;Castellón/Castelló;123;Vallat;52;21;31
12;Castellón/Castelló;127;Vallibona;85;47;38
12;Castellón/Castelló;128;Vilafamés;1867;992;875
12;Castellón/Castelló;132;Vilanova d'Alcolea;603;318;285
12;Castellón/Castelló;134;Vilar de Canes;175;95;80
12;Castellón/Castelló;135;Vila-real;50580;25142;25438
12;Castellón/Castelló;136;Vilavella, la;3253;1629;1624
12;Castellón/Castelló;129;Villafranca del Cid/Vilafranca;2295;1137;1158
12;Castellón/Castelló;130;Villahermosa del Río;484;260;224
12;Castellón/Castelló;131;Villamalur;70;40;30
12;Castellón/Castelló;133;Villanueva de Viver;61;33;28
12;Castellón/Castelló;137;Villores;37;19;18
12;Castellón/Castelló;138;Vinaròs;28190;13940;14250
12;Castellón/Castelló;139;Vistabella del Maestrat;370;199;171
12;Castellón/Castelló;140;Viver;1558;809;749
12;Castellón/Castelló;052;Xert;779;384;395
12;Castellón/Castelló;141;Zorita del Maestrazgo;129;65;64
12;Castellón/Castelló;142;Zucaina;183;99;84
51;Ceuta;001;Ceuta;84263;42757;41506
13;Ciudad Real;001;Abenójar;1471;760;711
13;Ciudad Real;002;Agudo;1750;891;859
13;Ciudad Real;003;Alamillo;531;275;256
13;Ciudad Real;004;Albaladejo;1323;681;642
13;Ciudad Real;005;Alcázar de San Juan;31269;15234;16035
13;Ciudad Real;006;Alcoba;637;320;317
13;Ciudad Real;007;Alcolea de Calatrava;1475;746;729
13;Ciudad Real;008;Alcubillas;518;264;254
13;Ciudad Real;009;Aldea del Rey;1823;937;886
13;Ciudad Real;010;Alhambra;1042;529;513
13;Ciudad Real;011;Almadén;5794;2778;3016
13;Ciudad Real;012;Almadenejos;456;233;223
13;Ciudad Real;013;Almagro;9074;4472;4602
13;Ciudad Real;014;Almedina;572;294;278
13;Ciudad Real;015;Almodóvar del Campo;6477;3265;3212
13;Ciudad Real;016;Almuradiel;843;417;426
13;Ciudad Real;017;Anchuras;343;181;162
13;Ciudad Real;903;Arenales de San Gregorio;672;351;321
13;Ciudad Real;018;Arenas de San Juan;1067;545;522
13;Ciudad Real;019;Argamasilla de Alba;7110;3589;3521
13;Ciudad Real;020;Argamasilla de Calatrava;5992;3030;2962
13;Ciudad Real;021;Arroba de los Montes;471;251;220
13;Ciudad Real;022;Ballesteros de Calatrava;416;209;207
13;Ciudad Real;023;Bolaños de Calatrava;12001;6129;5872
13;Ciudad Real;024;Brazatortas;1038;537;501
13;Ciudad Real;025;Cabezarados;328;171;157
13;Ciudad Real;026;Cabezarrubias del Puerto;521;273;248
13;Ciudad Real;027;Calzada de Calatrava;4122;2064;2058
13;Ciudad Real;028;Campo de Criptana;14126;7100;7026
13;Ciudad Real;029;Cañada de Calatrava;106;60;46
13;Ciudad Real;030;Caracuel de Calatrava;165;96;69
13;Ciudad Real;031;Carrión de Calatrava;3090;1567;1523
13;Ciudad Real;032;Carrizosa;1331;670;661
13;Ciudad Real;033;Castellar de Santiago;2055;1027;1028
13;Ciudad Real;038;Chillón;1937;951;986
13;Ciudad Real;034;Ciudad Real;74427;35200;39227
13;Ciudad Real;035;Corral de Calatrava;1135;564;571
13;Ciudad Real;036;Cortijos, Los;961;497;464
13;Ciudad Real;037;Cózar;1092;536;556
13;Ciudad Real;039;Daimiel;18577;9273;9304
13;Ciudad Real;040;Fernán Caballero;1069;537;532
13;Ciudad Real;041;Fontanarejo;281;153;128
13;Ciudad Real;042;Fuencaliente;1082;563;519
13;Ciudad Real;043;Fuenllana;261;132;129
13;Ciudad Real;044;Fuente el Fresno;3365;1747;1618
13;Ciudad Real;045;Granátula de Calatrava;819;398;421
13;Ciudad Real;046;Guadalmez;813;405;408
13;Ciudad Real;047;Herencia;8758;4448;4310
13;Ciudad Real;048;Hinojosas de Calatrava;499;256;243
13;Ciudad Real;049;Horcajo de los Montes;959;479;480
13;Ciudad Real;050;Labores, Las;617;311;306
13;Ciudad Real;904;Llanos del Caudillo;739;375;364
13;Ciudad Real;051;Luciana;398;212;186
13;Ciudad Real;052;Malagón;8280;4112;4168
13;Ciudad Real;053;Manzanares;18642;9258;9384
13;Ciudad Real;054;Membrilla;6168;3104;3064
13;Ciudad Real;055;Mestanza;724;354;370
13;Ciudad Real;056;Miguelturra;15032;7587;7445
13;Ciudad Real;057;Montiel;1450;758;692
13;Ciudad Real;058;Moral de Calatrava;5429;2730;2699
13;Ciudad Real;059;Navalpino;235;119;116
13;Ciudad Real;060;Navas de Estena;265;144;121
13;Ciudad Real;061;Pedro Muñoz;7714;3932;3782
13;Ciudad Real;062;Picón;698;366;332
13;Ciudad Real;063;Piedrabuena;4624;2349;2275
13;Ciudad Real;064;Poblete;2334;1204;1130
13;Ciudad Real;065;Porzuna;3742;1918;1824
13;Ciudad Real;066;Pozuelo de Calatrava;3371;1728;1643
13;Ciudad Real;067;Pozuelos de Calatrava, Los;430;225;205
13;Ciudad Real;068;Puebla de Don Rodrigo;1220;660;560
13;Ciudad Real;069;Puebla del Príncipe;756;377;379
13;Ciudad Real;070;Puerto Lápice;955;479;476
13;Ciudad Real;071;Puertollano;50035;24327;25708
13;Ciudad Real;072;Retuerta del Bullaque;1019;565;454
13;Ciudad Real;901;Robledo, El;1228;659;569
13;Ciudad Real;902;Ruidera;608;306;302
13;Ciudad Real;073;Saceruela;617;332;285
13;Ciudad Real;074;San Carlos del Valle;1184;614;570
13;Ciudad Real;075;San Lorenzo de Calatrava;231;124;107
13;Ciudad Real;076;Santa Cruz de los Cáñamos;546;270;276
13;Ciudad Real;077;Santa Cruz de Mudela;4330;2149;2181
13;Ciudad Real;078;Socuéllamos;12721;6470;6251
13;Ciudad Real;080;Solana del Pino;353;187;166
13;Ciudad Real;079;Solana, La;15979;8054;7925
13;Ciudad Real;081;Terrinches;782;400;382
13;Ciudad Real;082;Tomelloso;37645;18845;18800
13;Ciudad Real;083;Torralba de Calatrava;3107;1538;1569
13;Ciudad Real;084;Torre de Juan Abad;1108;544;564
13;Ciudad Real;085;Torrenueva;2911;1460;1451
13;Ciudad Real;086;Valdemanco del Esteras;210;108;102
13;Ciudad Real;087;Valdepeñas;30514;14947;15567
13;Ciudad Real;088;Valenzuela de Calatrava;706;327;379
13;Ciudad Real;089;Villahermosa;2014;964;1050
13;Ciudad Real;090;Villamanrique;1286;642;644
13;Ciudad Real;091;Villamayor de Calatrava;673;329;344
13;Ciudad Real;092;Villanueva de la Fuente;2288;1174;1114
13;Ciudad Real;093;Villanueva de los Infantes;5373;2657;2716
13;Ciudad Real;094;Villanueva de San Carlos;308;163;145
13;Ciudad Real;095;Villar del Pozo;99;53;46
13;Ciudad Real;096;Villarrubia de los Ojos;10494;5257;5237
13;Ciudad Real;097;Villarta de San Juan;2953;1488;1465
13;Ciudad Real;098;Viso del Marqués;2524;1231;1293
14;Córdoba;001;Adamuz;4317;2214;2103
14;Córdoba;002;Aguilar de la Frontera;13551;6832;6719
14;Córdoba;003;Alcaracejos;1523;731;792
14;Córdoba;004;Almedinilla;2455;1230;1225
14;Córdoba;005;Almodóvar del Río;7961;3988;3973
14;Córdoba;006;Añora;1563;768;795
14;Córdoba;007;Baena;19802;10143;9659
14;Córdoba;008;Belalcázar;3437;1647;1790
14;Córdoba;009;Belmez;3119;1516;1603
14;Córdoba;010;Benamejí;5060;2515;2545
14;Córdoba;011;Blázquez, Los;703;367;336
14;Córdoba;012;Bujalance;7693;3839;3854
14;Córdoba;013;Cabra;20837;10196;10641
14;Córdoba;014;Cañete de las Torres;3010;1540;1470
14;Córdoba;015;Carcabuey;2595;1323;1272
14;Córdoba;016;Cardeña;1604;810;794
14;Córdoba;017;Carlota, La;13929;7023;6906
14;Córdoba;018;Carpio, El;4496;2240;2256
14;Córdoba;019;Castro del Río;7972;3943;4029
14;Córdoba;020;Conquista;438;219;219
14;Córdoba;021;Córdoba;327362;157311;170051
14;Córdoba;022;Doña Mencía;4882;2372;2510
14;Córdoba;023;Dos Torres;2457;1219;1238
14;Córdoba;024;Encinas Reales;2343;1159;1184
14;Córdoba;025;Espejo;3443;1742;1701
14;Córdoba;026;Espiel;2508;1253;1255
14;Córdoba;027;Fernán-Núñez;9713;4865;4848
14;Córdoba;028;Fuente la Lancha;377;192;185
14;Córdoba;029;Fuente Obejuna;4894;2506;2388
14;Córdoba;030;Fuente Palmera;10895;5473;5422
14;Córdoba;031;Fuente-Tójar;721;345;376
14;Córdoba;032;Granjuela, La;482;247;235
14;Córdoba;033;Guadalcázar;1566;777;789
14;Córdoba;034;Guijo, El;372;195;177
14;Córdoba;035;Hinojosa del Duque;7054;3442;3612
14;Córdoba;036;Hornachuelos;4642;2340;2302
14;Córdoba;037;Iznájar;4556;2285;2271
14;Córdoba;038;Lucena;42697;21298;21399
14;Córdoba;039;Luque;3127;1568;1559
14;Córdoba;040;Montalbán de Córdoba;4519;2266;2253
14;Córdoba;041;Montemayor;3950;1978;1972
14;Córdoba;042;Montilla;23519;11639;11880
14;Córdoba;043;Montoro;9640;4733;4907
14;Córdoba;044;Monturque;2007;997;1010
14;Córdoba;045;Moriles;3848;1923;1925
14;Córdoba;046;Nueva Carteya;5470;2769;2701
14;Córdoba;047;Obejo;2027;1041;986
14;Córdoba;048;Palenciana;1545;778;767
14;Córdoba;049;Palma del Río;21522;10742;10780
14;Córdoba;050;Pedro Abad;2927;1474;1453
14;Córdoba;051;Pedroche;1624;785;839
14;Córdoba;052;Peñarroya-Pueblonuevo;11300;5467;5833
14;Córdoba;053;Posadas;7544;3769;3775
14;Córdoba;054;Pozoblanco;17380;8496;8884
14;Córdoba;055;Priego de Córdoba;22936;11222;11714
14;Córdoba;056;Puente Genil;30167;15022;15145
14;Córdoba;057;Rambla, La;7547;3785;3762
14;Córdoba;058;Rute;10269;5116;5153
14;Córdoba;059;San Sebastián de los Ballesteros;816;412;404
14;Córdoba;061;Santa Eufemia;859;433;426
14;Córdoba;060;Santaella;6062;3061;3001
14;Córdoba;062;Torrecampo;1177;581;596
14;Córdoba;063;Valenzuela;1241;607;634
14;Córdoba;064;Valsequillo;379;186;193
14;Córdoba;065;Victoria, La;2375;1184;1191
14;Córdoba;066;Villa del Río;7403;3702;3701
14;Córdoba;067;Villafranca de Córdoba;4889;2507;2382
14;Córdoba;068;Villaharta;703;344;359
14;Córdoba;069;Villanueva de Córdoba;9141;4523;4618
14;Córdoba;070;Villanueva del Duque;1553;777;776
14;Córdoba;071;Villanueva del Rey;1096;550;546
14;Córdoba;072;Villaralto;1238;608;630
14;Córdoba;073;Villaviciosa de Córdoba;3443;1755;1688
14;Córdoba;074;Viso, El;2651;1307;1344
14;Córdoba;075;Zuheros;688;347;341
15;Coruña, A;001;Abegondo;5586;2773;2813
15;Coruña, A;002;Ames;30267;14608;15659
15;Coruña, A;003;Aranga;1997;1006;991
15;Coruña, A;004;Ares;5743;2839;2904
15;Coruña, A;005;Arteixo;30950;15471;15479
15;Coruña, A;006;Arzúa;6219;3084;3135
15;Coruña, A;007;Baña, A;3698;1769;1929
15;Coruña, A;008;Bergondo;6700;3249;3451
15;Coruña, A;009;Betanzos;13202;6305;6897
15;Coruña, A;010;Boimorto;2125;1089;1036
15;Coruña, A;011;Boiro;18950;9248;9702
15;Coruña, A;012;Boqueixón;4321;2136;2185
15;Coruña, A;013;Brión;7564;3646;3918
15;Coruña, A;014;Cabana de Bergantiños;4552;2228;2324
15;Coruña, A;015;Cabanas;3299;1611;1688
15;Coruña, A;016;Camariñas;5577;2707;2870
15;Coruña, A;017;Cambre;24076;11821;12255
15;Coruña, A;018;Capela, A;1334;663;671
15;Coruña, A;019;Carballo;31283;15323;15960
15;Coruña, A;901;Cariño;4167;2065;2102
15;Coruña, A;020;Carnota;4284;2055;2229
15;Coruña, A;021;Carral;6180;3040;3140
15;Coruña, A;022;Cedeira;7062;3548;3514
15;Coruña, A;023;Cee;7723;3702;4021
15;Coruña, A;024;Cerceda;5076;2476;2600
15;Coruña, A;025;Cerdido;1233;599;634
15;Coruña, A;027;Coirós;1757;872;885
15;Coruña, A;028;Corcubión;1655;814;841
15;Coruña, A;029;Coristanco;6551;3151;3400
15;Coruña, A;030;Coruña, A;243870;113191;130679
15;Coruña, A;031;Culleredo;29593;14409;15184
15;Coruña, A;032;Curtis;4015;2016;1999
15;Coruña, A;033;Dodro;2882;1396;1486
15;Coruña, A;034;Dumbría;3077;1470;1607
15;Coruña, A;035;Fene;13385;6408;6977
15;Coruña, A;036;Ferrol;69452;32627;36825
15;Coruña, A;037;Fisterra;4775;2405;2370
15;Coruña, A;038;Frades;2460;1225;1235
15;Coruña, A;039;Irixoa;1389;694;695
15;Coruña, A;041;Laracha, A;11402;5608;5794
15;Coruña, A;040;Laxe;3185;1588;1597
15;Coruña, A;042;Lousame;3463;1684;1779
15;Coruña, A;043;Malpica de Bergantiños;5666;2762;2904
15;Coruña, A;044;Mañón;1454;702;752
15;Coruña, A;045;Mazaricos;4173;1998;2175
15;Coruña, A;046;Melide;7538;3714;3824
15;Coruña, A;047;Mesía;2734;1364;1370
15;Coruña, A;048;Miño;5859;2927;2932
15;Coruña, A;049;Moeche;1246;583;663
15;Coruña, A;050;Monfero;2037;1036;1001
15;Coruña, A;051;Mugardos;5362;2601;2761
15;Coruña, A;053;Muros;8960;4331;4629
15;Coruña, A;052;Muxía;5025;2440;2585
15;Coruña, A;054;Narón;39565;19194;20371
15;Coruña, A;055;Neda;5261;2565;2696
15;Coruña, A;056;Negreira;6936;3349;3587
15;Coruña, A;057;Noia;14472;6926;7546
15;Coruña, A;058;Oleiros;34693;16859;17834
15;Coruña, A;059;Ordes;12776;6201;6575
15;Coruña, A;060;Oroso;7413;3664;3749
15;Coruña, A;061;Ortigueira;6136;2952;3184
15;Coruña, A;062;Outes;6691;3203;3488
15;Coruña, A;902;Oza-Cesuras;5253;2654;2599
15;Coruña, A;064;Paderne;2467;1202;1265
15;Coruña, A;065;Padrón;8643;4168;4475
15;Coruña, A;066;Pino, O;4706;2351;2355
15;Coruña, A;067;Pobra do Caramiñal, A;9623;4699;4924
15;Coruña, A;068;Ponteceso;5789;2894;2895
15;Coruña, A;069;Pontedeume;8011;3843;4168
15;Coruña, A;070;Pontes de García Rodríguez, As;10503;5166;5337
15;Coruña, A;071;Porto do Son;9436;4698;4738
15;Coruña, A;072;Rianxo;11386;5557;5829
15;Coruña, A;073;Ribeira;27372;13504;13868
15;Coruña, A;074;Rois;4710;2244;2466
15;Coruña, A;075;Sada;15080;7419;7661
15;Coruña, A;076;San Sadurniño;3009;1494;1515
15;Coruña, A;077;Santa Comba;9635;4648;4987
15;Coruña, A;078;Santiago de Compostela;95612;44388;51224
15;Coruña, A;079;Santiso;1709;889;820
15;Coruña, A;080;Sobrado;1911;987;924
15;Coruña, A;081;Somozas, As;1191;608;583
15;Coruña, A;082;Teo;18505;9096;9409
15;Coruña, A;083;Toques;1213;632;581
15;Coruña, A;084;Tordoia;3591;1684;1907
15;Coruña, A;085;Touro;3778;1883;1895
15;Coruña, A;086;Trazo;3263;1605;1658
15;Coruña, A;088;Val do Dubra;4033;1942;2091
15;Coruña, A;087;Valdoviño;6753;3304;3449
15;Coruña, A;089;Vedra;5059;2478;2581
15;Coruña, A;091;Vilarmaior;1233;633;600
15;Coruña, A;090;Vilasantar;1280;669;611
15;Coruña, A;092;Vimianzo;7520;3626;3894
15;Coruña, A;093;Zas;4846;2337;2509
16;Cuenca;001;Abia de la Obispalía;77;49;28
16;Cuenca;002;Acebrón, El;241;121;120
16;Cuenca;003;Alarcón;148;66;82
16;Cuenca;004;Albaladejo del Cuende;292;150;142
16;Cuenca;005;Albalate de las Nogueras;272;146;126
16;Cuenca;006;Albendea;134;64;70
16;Cuenca;007;Alberca de Záncara, La;1723;881;842
16;Cuenca;008;Alcalá de la Vega;105;57;48
16;Cuenca;009;Alcantud;72;39;33
16;Cuenca;010;Alcázar del Rey;172;82;90
16;Cuenca;011;Alcohujate;32;18;14
16;Cuenca;012;Alconchel de la Estrella;111;63;48
16;Cuenca;013;Algarra;32;21;11
16;Cuenca;014;Aliaguilla;698;364;334
16;Cuenca;015;Almarcha, La;415;230;185
16;Cuenca;016;Almendros;272;152;120
16;Cuenca;017;Almodóvar del Pinar;447;245;202
16;Cuenca;018;Almonacid del Marquesado;458;238;220
16;Cuenca;019;Altarejos;229;119;110
16;Cuenca;020;Arandilla del Arroyo;16;9;7
16;Cuenca;905;Arcas;1605;812;793
16;Cuenca;022;Arcos de la Sierra;88;51;37
16;Cuenca;024;Arguisuelas;146;80;66
16;Cuenca;025;Arrancacepas;26;13;13
16;Cuenca;026;Atalaya del Cañavate;116;54;62
16;Cuenca;027;Barajas de Melo;935;498;437
16;Cuenca;029;Barchín del Hoyo;90;52;38
16;Cuenca;030;Bascuñana de San Pedro;20;12;8
16;Cuenca;031;Beamud;49;23;26
16;Cuenca;032;Belinchón;356;185;171
16;Cuenca;033;Belmonte;2019;996;1023
16;Cuenca;034;Belmontejo;196;107;89
16;Cuenca;035;Beteta;293;140;153
16;Cuenca;036;Boniches;151;70;81
16;Cuenca;038;Buciegas;46;27;19
16;Cuenca;039;Buenache de Alarcón;499;262;237
16;Cuenca;040;Buenache de la Sierra;106;62;44
16;Cuenca;041;Buendía;425;224;201
16;Cuenca;042;Campillo de Altobuey;1481;725;756
16;Cuenca;043;Campillos-Paravientos;117;62;55
16;Cuenca;044;Campillos-Sierra;36;16;20
16;Cuenca;901;Campos del Paraíso;845;431;414
16;Cuenca;045;Canalejas del Arroyo;289;157;132
16;Cuenca;046;Cañada del Hoyo;280;143;137
16;Cuenca;047;Cañada Juncosa;272;153;119
16;Cuenca;048;Cañamares;500;267;233
16;Cuenca;049;Cañavate, El;165;87;78
16;Cuenca;050;Cañaveras;325;159;166
16;Cuenca;051;Cañaveruelas;151;77;74
16;Cuenca;052;Cañete;802;413;389
16;Cuenca;053;Cañizares;505;270;235
16;Cuenca;055;Carboneras de Guadazaón;810;415;395
16;Cuenca;056;Cardenete;533;283;250
16;Cuenca;057;Carrascosa;89;57;32
16;Cuenca;058;Carrascosa de Haro;122;63;59
16;Cuenca;060;Casas de Benítez;918;449;469
16;Cuenca;061;Casas de Fernando Alonso;1311;704;607
16;Cuenca;062;Casas de Garcimolina;28;17;11
16;Cuenca;063;Casas de Guijarro;116;63;53
16;Cuenca;064;Casas de Haro;873;462;411
16;Cuenca;065;Casas de los Pinos;464;225;239
16;Cuenca;066;Casasimarro;3144;1624;1520
16;Cuenca;067;Castejón;158;85;73
16;Cuenca;068;Castillejo de Iniesta;189;107;82
16;Cuenca;070;Castillejo-Sierra;33;18;15
16;Cuenca;072;Castillo de Garcimuñoz;157;90;67
16;Cuenca;071;Castillo-Albaráñez;21;10;11
16;Cuenca;073;Cervera del Llano;231;120;111
16;Cuenca;023;Chillarón de Cuenca;567;309;258
16;Cuenca;081;Chumillas;54;29;25
16;Cuenca;074;Cierva, La;44;26;18
16;Cuenca;078;Cuenca;55428;26506;28922
16;Cuenca;079;Cueva del Hierro;35;24;11
16;Cuenca;082;Enguídanos;345;182;163
16;Cuenca;083;Fresneda de Altarejos;54;28;26
16;Cuenca;084;Fresneda de la Sierra;54;29;25
16;Cuenca;085;Frontera, La;170;89;81
16;Cuenca;086;Fuente de Pedro Naharro;1248;642;606
16;Cuenca;087;Fuentelespino de Haro;280;145;135
16;Cuenca;088;Fuentelespino de Moya;125;69;56
16;Cuenca;904;Fuentenava de Jábaga;568;306;262
16;Cuenca;089;Fuentes;465;249;216
16;Cuenca;091;Fuertescusa;75;40;35
16;Cuenca;092;Gabaldón;188;109;79
16;Cuenca;093;Garaballa;72;38;34
16;Cuenca;094;Gascueña;176;94;82
16;Cuenca;095;Graja de Campalbo;101;51;50
16;Cuenca;096;Graja de Iniesta;370;192;178
16;Cuenca;097;Henarejos;169;85;84
16;Cuenca;098;Herrumblar, El;717;371;346
16;Cuenca;099;Hinojosa, La;214;107;107
16;Cuenca;100;Hinojosos, Los;884;429;455
16;Cuenca;101;Hito, El;173;94;79
16;Cuenca;102;Honrubia;1650;821;829
16;Cuenca;103;Hontanaya;319;172;147
16;Cuenca;104;Hontecillas;58;31;27
16;Cuenca;106;Horcajo de Santiago;3689;1896;1793
16;Cuenca;107;Huélamo;106;64;42
16;Cuenca;108;Huelves;53;26;27
16;Cuenca;109;Huérguina;56;29;27
16;Cuenca;110;Huerta de la Obispalía;133;78;55
16;Cuenca;111;Huerta del Marquesado;210;123;87
16;Cuenca;112;Huete;1862;954;908
16;Cuenca;113;Iniesta;4382;2151;2231
16;Cuenca;115;Laguna del Marquesado;48;27;21
16;Cuenca;116;Lagunaseca;94;52;42
16;Cuenca;117;Landete;1310;678;632
16;Cuenca;118;Ledaña;1662;816;846
16;Cuenca;119;Leganiel;189;97;92
16;Cuenca;121;Majadas, Las;284;146;138
16;Cuenca;122;Mariana;320;164;156
16;Cuenca;123;Masegosa;79;44;35
16;Cuenca;124;Mesas, Las;2388;1217;1171
16;Cuenca;125;Minglanilla;2367;1233;1134
16;Cuenca;126;Mira;987;493;494
16;Cuenca;128;Monreal del Llano;73;39;34
16;Cuenca;129;Montalbanejo;118;64;54
16;Cuenca;130;Montalbo;687;371;316
16;Cuenca;131;Monteagudo de las Salinas;144;84;60
16;Cuenca;132;Mota de Altarejos;31;22;9
16;Cuenca;133;Mota del Cuervo;6172;3065;3107
16;Cuenca;134;Motilla del Palancar;5896;2958;2938
16;Cuenca;135;Moya;171;98;73
16;Cuenca;137;Narboneta;56;30;26
16;Cuenca;139;Olivares de Júcar;345;179;166
16;Cuenca;140;Olmeda de la Cuesta;28;15;13
16;Cuenca;141;Olmeda del Rey;135;65;70
16;Cuenca;142;Olmedilla de Alarcón;158;91;67
16;Cuenca;143;Olmedilla de Eliz;19;13;6
16;Cuenca;145;Osa de la Vega;544;284;260
16;Cuenca;146;Pajarón;84;41;43
16;Cuenca;147;Pajaroncillo;76;48;28
16;Cuenca;148;Palomares del Campo;680;337;343
16;Cuenca;149;Palomera;186;100;86
16;Cuenca;150;Paracuellos;102;52;50
16;Cuenca;151;Paredes;65;35;30
16;Cuenca;152;Parra de las Vegas, La;44;26;18
16;Cuenca;153;Pedernoso, El;1189;606;583
16;Cuenca;154;Pedroñeras, Las;6816;3519;3297
16;Cuenca;155;Peral, El;693;381;312
16;Cuenca;156;Peraleja, La;109;58;51
16;Cuenca;157;Pesquera, La;248;133;115
16;Cuenca;158;Picazo, El;710;361;349
16;Cuenca;159;Pinarejo;238;118;120
16;Cuenca;160;Pineda de Gigüela;69;36;33
16;Cuenca;161;Piqueras del Castillo;57;31;26
16;Cuenca;162;Portalrubio de Guadamejud;30;15;15
16;Cuenca;163;Portilla;74;39;35
16;Cuenca;165;Poyatos;67;36;31
16;Cuenca;166;Pozoamargo;311;163;148
16;Cuenca;908;Pozorrubielos de la Mancha;211;104;107
16;Cuenca;167;Pozorrubio de Santiago;345;163;182
16;Cuenca;169;Pozuelo, El;62;35;27
16;Cuenca;170;Priego;1014;516;498
16;Cuenca;171;Provencio, El;2526;1249;1277
16;Cuenca;172;Puebla de Almenara;416;212;204
16;Cuenca;174;Puebla del Salvador;211;118;93
16;Cuenca;175;Quintanar del Rey;7576;3909;3667
16;Cuenca;176;Rada de Haro;53;27;26
16;Cuenca;177;Reíllo;89;47;42
16;Cuenca;181;Rozalén del Monte;75;35;40
16;Cuenca;185;Saceda-Trasierra;51;32;19
16;Cuenca;186;Saelices;553;284;269
16;Cuenca;187;Salinas del Manzano;94;53;41
16;Cuenca;188;Salmeroncillos;115;65;50
16;Cuenca;189;Salvacañete;316;165;151
16;Cuenca;190;San Clemente;6754;3427;3327
16;Cuenca;191;San Lorenzo de la Parrilla;1153;571;582
16;Cuenca;192;San Martín de Boniches;48;25;23
16;Cuenca;193;San Pedro Palmiches;70;40;30
16;Cuenca;194;Santa Cruz de Moya;259;138;121
16;Cuenca;196;Santa María de los Llanos;721;374;347
16;Cuenca;195;Santa María del Campo Rus;626;311;315
16;Cuenca;197;Santa María del Val;68;38;30
16;Cuenca;198;Sisante;1758;884;874
16;Cuenca;199;Solera de Gabaldón;29;13;16
16;Cuenca;909;Sotorribas;802;409;393
16;Cuenca;202;Talayuelas;944;498;446
16;Cuenca;203;Tarancón;14922;7447;7475
16;Cuenca;204;Tébar;303;159;144
16;Cuenca;205;Tejadillos;129;62;67
16;Cuenca;206;Tinajas;221;111;110
16;Cuenca;209;Torralba;127;75;52
16;Cuenca;211;Torrejoncillo del Rey;433;222;211
16;Cuenca;212;Torrubia del Campo;285;140;145
16;Cuenca;213;Torrubia del Castillo;40;25;15
16;Cuenca;215;Tragacete;288;159;129
16;Cuenca;216;Tresjuncos;343;185;158
16;Cuenca;217;Tribaldos;95;48;47
16;Cuenca;218;Uclés;234;124;110
16;Cuenca;219;Uña;103;51;52
16;Cuenca;906;Valdecolmenas, Los;84;50;34
16;Cuenca;224;Valdemeca;91;48;43
16;Cuenca;225;Valdemorillo de la Sierra;83;48;35
16;Cuenca;227;Valdemoro-Sierra;119;68;51
16;Cuenca;228;Valdeolivas;208;126;82
16;Cuenca;902;Valdetórtola;154;82;72
16;Cuenca;903;Valeras, Las;1632;858;774
16;Cuenca;231;Valhermoso de la Fuente;55;28;27
16;Cuenca;173;Valle de Altomira, El;246;135;111
16;Cuenca;234;Valsalobre;32;19;13
16;Cuenca;236;Valverde de Júcar;1172;590;582
16;Cuenca;237;Valverdejo;101;54;47
16;Cuenca;238;Vara de Rey;561;294;267
16;Cuenca;239;Vega del Codorno;153;92;61
16;Cuenca;240;Vellisca;112;61;51
16;Cuenca;242;Villaconejos de Trabaque;372;190;182
16;Cuenca;243;Villaescusa de Haro;529;264;265
16;Cuenca;244;Villagarcía del Llano;762;388;374
16;Cuenca;245;Villalba de la Sierra;509;250;259
16;Cuenca;246;Villalba del Rey;566;312;254
16;Cuenca;247;Villalgordo del Marquesado;99;54;45
16;Cuenca;248;Villalpardo;970;476;494
16;Cuenca;249;Villamayor de Santiago;2617;1342;1275
16;Cuenca;250;Villanueva de Guadamejud;80;48;32
16;Cuenca;251;Villanueva de la Jara;2304;1161;1143
16;Cuenca;253;Villar de Cañas;447;238;209
16;Cuenca;254;Villar de Domingo García;218;114;104
16;Cuenca;255;Villar de la Encina;164;85;79
16;Cuenca;263;Villar de Olalla;1236;673;563
16;Cuenca;258;Villar del Humo;235;133;102
16;Cuenca;259;Villar del Infantado;42;26;16
16;Cuenca;910;Villar y Velasco;104;57;47
16;Cuenca;264;Villarejo de Fuentes;488;246;242
16;Cuenca;265;Villarejo de la Peñuela;21;7;14
16;Cuenca;266;Villarejo-Periesteban;324;165;159
16;Cuenca;269;Villares del Saz;517;257;260
16;Cuenca;270;Villarrubio;211;115;96
16;Cuenca;271;Villarta;917;468;449
16;Cuenca;272;Villas de la Ventosa;280;152;128
16;Cuenca;273;Villaverde y Pasaconsol;352;185;167
16;Cuenca;274;Víllora;141;75;66
16;Cuenca;275;Vindel;12;7;5
16;Cuenca;276;Yémeda;23;17;6
16;Cuenca;277;Zafra de Záncara;137;73;64
16;Cuenca;278;Zafrilla;75;38;37
16;Cuenca;279;Zarza de Tajo;296;153;143
16;Cuenca;280;Zarzuela;204;109;95
20;Gipuzkoa;001;Abaltzisketa;329;182;147
20;Gipuzkoa;002;Aduna;470;255;215
20;Gipuzkoa;016;Aia;2051;1094;957
20;Gipuzkoa;003;Aizarnazabal;775;391;384
20;Gipuzkoa;004;Albiztur;320;167;153
20;Gipuzkoa;005;Alegia;1741;889;852
20;Gipuzkoa;006;Alkiza;362;187;175
20;Gipuzkoa;906;Altzaga;176;87;89
20;Gipuzkoa;007;Altzo;405;208;197
20;Gipuzkoa;008;Amezketa;942;510;432
20;Gipuzkoa;009;Andoain;14668;7263;7405
20;Gipuzkoa;010;Anoeta;1959;1015;944
20;Gipuzkoa;011;Antzuola;2193;1106;1087
20;Gipuzkoa;012;Arama;210;107;103
20;Gipuzkoa;013;Aretxabaleta;6974;3531;3443
20;Gipuzkoa;055;Arrasate/Mondragón;22055;10934;11121
20;Gipuzkoa;014;Asteasu;1525;806;719
20;Gipuzkoa;903;Astigarraga;5688;2916;2772
20;Gipuzkoa;015;Ataun;1674;874;800
20;Gipuzkoa;017;Azkoitia;11566;5800;5766
20;Gipuzkoa;018;Azpeitia;14675;7385;7290
20;Gipuzkoa;904;Baliarrain;147;81;66
20;Gipuzkoa;019;Beasain;13980;7067;6913
20;Gipuzkoa;020;Beizama;165;102;63
20;Gipuzkoa;021;Belauntza;248;131;117
20;Gipuzkoa;022;Berastegi;1061;552;509
20;Gipuzkoa;074;Bergara;14780;7354;7426
20;Gipuzkoa;023;Berrobi;583;304;279
20;Gipuzkoa;024;Bidania-Goiatz;526;281;245
20;Gipuzkoa;029;Deba;5463;2744;2719
20;Gipuzkoa;069;Donostia/San Sebastián;186095;87532;98563
20;Gipuzkoa;030;Eibar;27414;13300;14114
20;Gipuzkoa;031;Elduain;244;127;117
20;Gipuzkoa;033;Elgeta;1116;561;555
20;Gipuzkoa;032;Elgoibar;11589;5766;5823
20;Gipuzkoa;067;Errenteria;39276;19123;20153
20;Gipuzkoa;066;Errezil;593;305;288
20;Gipuzkoa;034;Eskoriatza;4085;2069;2016
20;Gipuzkoa;035;Ezkio-Itsaso;619;319;300
20;Gipuzkoa;038;Gabiria;491;260;231
20;Gipuzkoa;037;Gaintza;122;72;50
20;Gipuzkoa;907;Gaztelu;164;94;70
20;Gipuzkoa;039;Getaria;2783;1413;1370
20;Gipuzkoa;040;Hernani;19600;9582;10018
20;Gipuzkoa;041;Hernialde;331;168;163
20;Gipuzkoa;036;Hondarribia;16945;8421;8524
20;Gipuzkoa;042;Ibarra;4278;2154;2124
20;Gipuzkoa;043;Idiazabal;2308;1158;1150
20;Gipuzkoa;044;Ikaztegieta;486;252;234
20;Gipuzkoa;045;Irun;61481;30089;31392
20;Gipuzkoa;046;Irura;1690;887;803
20;Gipuzkoa;047;Itsasondo;675;336;339
20;Gipuzkoa;048;Larraul;249;138;111
20;Gipuzkoa;902;Lasarte-Oria;18093;8835;9258
20;Gipuzkoa;049;Lazkao;5456;2761;2695
20;Gipuzkoa;050;Leaburu;368;196;172
20;Gipuzkoa;051;Legazpi;8521;4335;4186
20;Gipuzkoa;052;Legorreta;1441;722;719
20;Gipuzkoa;068;Leintz-Gatzaga;241;128;113
20;Gipuzkoa;053;Lezo;5990;2976;3014
20;Gipuzkoa;054;Lizartza;624;335;289
20;Gipuzkoa;901;Mendaro;2026;1026;1000
20;Gipuzkoa;057;Mutiloa;266;143;123
20;Gipuzkoa;056;Mutriku;5313;2680;2633
20;Gipuzkoa;063;Oiartzun;10148;5040;5108
20;Gipuzkoa;058;Olaberria;932;475;457
20;Gipuzkoa;059;Oñati;11276;5595;5681
20;Gipuzkoa;076;Ordizia;9846;4928;4918
20;Gipuzkoa;905;Orendain;193;101;92
20;Gipuzkoa;060;Orexa;126;66;60
20;Gipuzkoa;061;Orio;5805;2929;2876
20;Gipuzkoa;062;Ormaiztegi;1304;662;642
20;Gipuzkoa;064;Pasaia;16012;7701;8311
20;Gipuzkoa;070;Segura;1476;749;727
20;Gipuzkoa;065;Soraluze-Placencia de las Armas;3947;1991;1956
20;Gipuzkoa;071;Tolosa;19113;9194;9919
20;Gipuzkoa;072;Urnieta;6239;3123;3116
20;Gipuzkoa;077;Urretxu;6908;3450;3458
20;Gipuzkoa;073;Usurbil;6183;3126;3057
20;Gipuzkoa;075;Villabona;5862;2942;2920
20;Gipuzkoa;078;Zaldibia;1577;829;748
20;Gipuzkoa;079;Zarautz;22988;11209;11779
20;Gipuzkoa;025;Zegama;1517;777;740
20;Gipuzkoa;026;Zerain;255;118;137
20;Gipuzkoa;027;Zestoa;3714;1956;1758
20;Gipuzkoa;028;Zizurkil;3010;1515;1495
20;Gipuzkoa;081;Zumaia;9798;4866;4932
20;Gipuzkoa;080;Zumarraga;9921;4871;5050
17;Girona;001;Agullana;828;418;410
17;Girona;002;Aiguaviva;775;391;384
17;Girona;003;Albanyà;149;85;64
17;Girona;004;Albons;745;382;363
17;Girona;006;Alp;1595;835;760
17;Girona;007;Amer;2250;1095;1155
17;Girona;008;Anglès;5540;2748;2792
17;Girona;009;Arbúcies;6297;3259;3038
17;Girona;010;Argelaguer;412;221;191
17;Girona;011;Armentera, L';907;451;456
17;Girona;012;Avinyonet de Puigventós;1565;795;770
17;Girona;015;Banyoles;19299;9652;9647
17;Girona;016;Bàscara;943;479;464
17;Girona;013;Begur;3985;2019;1966
17;Girona;018;Bellcaire d'Empordà;652;316;336
17;Girona;019;Besalú;2437;1154;1283
17;Girona;020;Bescanó;4807;2411;2396
17;Girona;021;Beuda;193;100;93
17;Girona;022;Bisbal d'Empordà, La;10759;5370;5389
17;Girona;234;Biure;242;129;113
17;Girona;023;Blanes;39132;19561;19571
17;Girona;029;Boadella i les Escaules;261;134;127
17;Girona;024;Bolvir;380;195;185
17;Girona;025;Bordils;1710;844;866
17;Girona;026;Borrassà;711;368;343
17;Girona;027;Breda;3728;1862;1866
17;Girona;028;Brunyola;394;199;195
17;Girona;031;Cabanelles;237;130;107
17;Girona;030;Cabanes;931;499;432
17;Girona;032;Cadaqués;2840;1371;1469
17;Girona;033;Caldes de Malavella;7166;3559;3607
17;Girona;034;Calonge;10520;5272;5248
17;Girona;035;Camós;683;346;337
17;Girona;036;Campdevànol;3352;1653;1699
17;Girona;037;Campelles;127;64;63
17;Girona;038;Campllong;499;247;252
17;Girona;039;Camprodon;2299;1126;1173
17;Girona;040;Canet d'Adri;671;340;331
17;Girona;041;Cantallops;328;166;162
17;Girona;042;Capmany;590;307;283
17;Girona;044;Cassà de la Selva;10030;5132;4898
17;Girona;046;Castellfollit de la Roca;992;498;494
17;Girona;047;Castelló d'Empúries;10870;5502;5368
17;Girona;048;Castell-Platja d'Aro;10589;5251;5338
17;Girona;189;Cellera de Ter, La;2071;1028;1043
17;Girona;049;Celrà;5155;2591;2564
17;Girona;050;Cervià de Ter;926;468;458
17;Girona;051;Cistella;303;146;157
17;Girona;054;Colera;533;270;263
17;Girona;055;Colomers;189;91;98
17;Girona;057;Corçà;1244;628;616
17;Girona;056;Cornellà del Terri;2236;1147;1089
17;Girona;058;Crespià;256;133;123
17;Girona;901;Cruïlles, Monells i Sant Sadurní de l'Heura;1304;664;640
17;Girona;060;Darnius;554;282;272
17;Girona;061;Das;222;122;100
17;Girona;062;Escala, L';10276;5210;5066
17;Girona;063;Espinelves;196;95;101
17;Girona;064;Espolla;415;205;210
17;Girona;065;Esponellà;444;221;223
17;Girona;005;Far d'Empordà, El;552;279;273
17;Girona;066;Figueres;45346;22471;22875
17;Girona;067;Flaçà;1060;506;554
17;Girona;068;Foixà;306;157;149
17;Girona;069;Fontanals de Cerdanya;450;237;213
17;Girona;070;Fontanilles;144;86;58
17;Girona;071;Fontcoberta;1448;709;739
17;Girona;902;Forallac;1705;832;873
17;Girona;073;Fornells de la Selva;2528;1244;1284
17;Girona;074;Fortià;723;347;376
17;Girona;075;Garrigàs;423;220;203
17;Girona;076;Garrigoles;160;88;72
17;Girona;077;Garriguella;842;419;423
17;Girona;078;Ger;430;230;200
17;Girona;079;Girona;97586;46761;50825
17;Girona;080;Gombrèn;185;92;93
17;Girona;081;Gualta;368;203;165
17;Girona;082;Guils de Cerdanya;523;275;248
17;Girona;083;Hostalric;4005;2017;1988
17;Girona;084;Isòvol;281;156;125
17;Girona;085;Jafre;387;208;179
17;Girona;086;Jonquera, La;3220;1615;1605
17;Girona;087;Juià;338;177;161
17;Girona;088;Lladó;767;380;387
17;Girona;089;Llagostera;8224;4214;4010
17;Girona;090;Llambilles;733;374;359
17;Girona;091;Llanars;512;267;245
17;Girona;092;Llançà;4985;2466;2519
17;Girona;093;Llers;1209;605;604
17;Girona;094;Llívia;1456;787;669
17;Girona;095;Lloret de Mar;37618;19338;18280
17;Girona;096;Llosses, Les;226;129;97
17;Girona;102;Maçanet de Cabrenys;755;379;376
17;Girona;103;Maçanet de la Selva;6887;3527;3360
17;Girona;097;Madremanya;276;138;138
17;Girona;098;Maià de Montcal;446;229;217
17;Girona;100;Masarac;294;154;140
17;Girona;101;Massanes;722;381;341
17;Girona;099;Meranges;100;58;42
17;Girona;105;Mieres;330;169;161
17;Girona;106;Mollet de Peralada;180;95;85
17;Girona;107;Molló;330;160;170
17;Girona;109;Montagut i Oix;949;498;451
17;Girona;110;Mont-ras;1710;859;851
17;Girona;111;Navata;1323;652;671
17;Girona;112;Ogassa;232;136;96
17;Girona;114;Olot;33944;16845;17099
17;Girona;115;Ordis;389;208;181
17;Girona;116;Osor;421;217;204
17;Girona;117;Palafrugell;22733;11313;11420
17;Girona;118;Palamós;17911;8751;9160
17;Girona;119;Palau de Santa Eulàlia;88;54;34
17;Girona;121;Palau-sator;298;157;141
17;Girona;120;Palau-saverdera;1485;742;743
17;Girona;123;Palol de Revardit;466;240;226
17;Girona;124;Pals;2501;1265;1236
17;Girona;125;Pardines;155;87;68
17;Girona;126;Parlavà;398;208;190
17;Girona;128;Pau;557;276;281
17;Girona;129;Pedret i Marzà;193;106;87
17;Girona;130;Pera, La;441;210;231
17;Girona;132;Peralada;1841;920;921
17;Girona;133;Planes d'Hostoles, Les;1674;848;826
17;Girona;134;Planoles;298;161;137
17;Girona;135;Pont de Molins;512;251;261
17;Girona;136;Pontós;231;131;100
17;Girona;137;Porqueres;4521;2253;2268
17;Girona;140;Port de la Selva, El;1002;533;469
17;Girona;138;Portbou;1167;579;588
17;Girona;139;Preses, Les;1764;873;891
17;Girona;141;Puigcerdà;8825;4412;4413
17;Girona;142;Quart;3448;1734;1714
17;Girona;043;Queralbs;173;100;73
17;Girona;143;Rabós;182;90;92
17;Girona;144;Regencós;285;148;137
17;Girona;145;Ribes de Freser;1818;896;922
17;Girona;146;Riells i Viabrea;3945;2042;1903
17;Girona;147;Ripoll;10632;5217;5415
17;Girona;148;Riudarenes;2120;1091;1029
17;Girona;149;Riudaura;461;225;236
17;Girona;150;Riudellots de la Selva;2022;1030;992
17;Girona;151;Riumors;245;122;123
17;Girona;152;Roses;19575;9806;9769
17;Girona;153;Rupià;248;125;123
17;Girona;154;Sales de Llierca;139;68;71
17;Girona;155;Salt;29342;15461;13881
17;Girona;157;Sant Andreu Salou;149;79;70
17;Girona;183;Sant Aniol de Finestres;373;196;177
17;Girona;158;Sant Climent Sescebes;601;346;255
17;Girona;159;Sant Feliu de Buixalleu;787;411;376
17;Girona;160;Sant Feliu de Guíxols;21586;10668;10918
17;Girona;161;Sant Feliu de Pallerols;1332;654;678
17;Girona;162;Sant Ferriol;239;135;104
17;Girona;163;Sant Gregori;3498;1762;1736
17;Girona;164;Sant Hilari Sacalm;5608;2843;2765
17;Girona;165;Sant Jaume de Llierca;841;412;429
17;Girona;167;Sant Joan de les Abadesses;3383;1676;1707
17;Girona;168;Sant Joan de Mollet;497;240;257
17;Girona;185;Sant Joan les Fonts;2937;1451;1486
17;Girona;166;Sant Jordi Desvalls;720;349;371
17;Girona;169;Sant Julià de Ramis;3415;1724;1691
17;Girona;903;Sant Julià del Llor i Bonmatí;1272;654;618
17;Girona;171;Sant Llorenç de la Muga;255;129;126
17;Girona;172;Sant Martí de Llémena;605;319;286
17;Girona;173;Sant Martí Vell;248;131;117
17;Girona;174;Sant Miquel de Campmajor;219;115;104
17;Girona;175;Sant Miquel de Fluvià;756;395;361
17;Girona;176;Sant Mori;176;96;80
17;Girona;177;Sant Pau de Segúries;682;336;346
17;Girona;178;Sant Pere Pescador;2143;1159;984
17;Girona;180;Santa Coloma de Farners;12681;6447;6234
17;Girona;181;Santa Cristina d'Aro;5089;2570;2519
17;Girona;182;Santa Llogaia d'Àlguema;339;178;161
17;Girona;184;Santa Pau;1562;796;766
17;Girona;186;Sarrià de Ter;4973;2474;2499
17;Girona;187;Saus, Camallera i Llampaies;830;413;417
17;Girona;188;Selva de Mar, La;184;103;81
17;Girona;190;Serinyà;1130;585;545
17;Girona;191;Serra de Daró;209;114;95
17;Girona;192;Setcases;180;100;80
17;Girona;193;Sils;5797;2932;2865
17;Girona;052;Siurana;152;73;79
17;Girona;194;Susqueda;92;55;37
17;Girona;195;Tallada d'Empordà, La;458;237;221
17;Girona;196;Terrades;294;145;149
17;Girona;197;Torrent;169;91;78
17;Girona;198;Torroella de Fluvià;732;387;345
17;Girona;199;Torroella de Montgrí;11388;5778;5610
17;Girona;200;Tortellà;775;377;398
17;Girona;201;Toses;155;92;63
17;Girona;202;Tossa de Mar;5623;2857;2766
17;Girona;204;Ullà;1068;593;475
17;Girona;205;Ullastret;295;144;151
17;Girona;203;Ultramort;200;111;89
17;Girona;206;Urús;176;83;93
17;Girona;014;Vajol, La;88;50;38
17;Girona;208;Vall de Bianya, La;1297;661;636
17;Girona;207;Vall d'en Bas, La;2966;1480;1486
17;Girona;170;Vallfogona de Ripollès;205;111;94
17;Girona;209;Vall-llobrega;915;458;457
17;Girona;210;Ventalló;830;429;401
17;Girona;211;Verges;1197;578;619
17;Girona;212;Vidrà;173;89;84
17;Girona;213;Vidreres;7741;4006;3735
17;Girona;214;Vilabertran;902;460;442
17;Girona;215;Vilablareix;2559;1256;1303
17;Girona;217;Viladamat;441;229;212
17;Girona;216;Viladasens;221;114;107
17;Girona;218;Vilademuls;834;436;398
17;Girona;220;Viladrau;1035;527;508
17;Girona;221;Vilafant;5543;2720;2823
17;Girona;223;Vilajuïga;1169;577;592
17;Girona;224;Vilallonga de Ter;398;205;193
17;Girona;225;Vilamacolum;294;150;144
17;Girona;226;Vilamalla;1133;581;552
17;Girona;227;Vilamaniscle;179;97;82
17;Girona;228;Vilanant;399;198;201
17;Girona;230;Vila-sacra;670;319;351
17;Girona;222;Vilaür;159;80;79
17;Girona;233;Vilobí d'Onyar;3166;1647;1519
17;Girona;232;Vilopriu;199;107;92
18;Granada;001;Agrón;310;157;153
18;Granada;002;Alamedilla;637;331;306
18;Granada;003;Albolote;18464;9210;9254
18;Granada;004;Albondón;782;437;345
18;Granada;005;Albuñán;420;218;202
18;Granada;006;Albuñol;6948;3677;3271
18;Granada;007;Albuñuelas;893;451;442
18;Granada;010;Aldeire;631;334;297
18;Granada;011;Alfacar;5445;2763;2682
18;Granada;012;Algarinejo;2813;1445;1368
18;Granada;013;Alhama de Granada;6126;3289;2837
18;Granada;014;Alhendín;8503;4333;4170
18;Granada;015;Alicún de Ortega;523;273;250
18;Granada;016;Almegíjar;376;207;169
18;Granada;017;Almuñécar;27391;13558;13833
18;Granada;904;Alpujarra de la Sierra;1041;559;482
18;Granada;018;Alquife;718;358;360
18;Granada;020;Arenas del Rey;1865;963;902
18;Granada;021;Armilla;23623;11828;11795
18;Granada;022;Atarfe;17792;8852;8940
18;Granada;023;Baza;20668;10280;10388
18;Granada;024;Beas de Granada;1012;549;463
18;Granada;025;Beas de Guadix;363;184;179
18;Granada;027;Benalúa;3298;1644;1654
18;Granada;028;Benalúa de las Villas;1148;602;546
18;Granada;029;Benamaurel;2378;1210;1168
18;Granada;030;Bérchules;739;394;345
18;Granada;032;Bubión;309;159;150
18;Granada;033;Busquístar;289;155;134
18;Granada;034;Cacín;589;298;291
18;Granada;035;Cádiar;1554;808;746
18;Granada;036;Cájar;4909;2383;2526
18;Granada;114;Calahorra, La;719;359;360
18;Granada;037;Calicasas;606;295;311
18;Granada;038;Campotéjar;1301;676;625
18;Granada;039;Caniles;4351;2206;2145
18;Granada;040;Cáñar;405;209;196
18;Granada;042;Capileira;508;249;259
18;Granada;043;Carataunas;210;113;97
18;Granada;044;Cástaras;250;153;97
18;Granada;045;Castilléjar;1400;735;665
18;Granada;046;Castril;2276;1159;1117
18;Granada;047;Cenes de la Vega;7942;4007;3935
18;Granada;059;Chauchina;5428;2696;2732
18;Granada;061;Chimeneas;1360;719;641
18;Granada;062;Churriana de la Vega;13907;6919;6988
18;Granada;048;Cijuela;3221;1640;1581
18;Granada;049;Cogollos de Guadix;718;390;328
18;Granada;050;Cogollos de la Vega;2099;1045;1054
18;Granada;051;Colomera;1416;746;670
18;Granada;053;Cortes de Baza;2058;1039;1019
18;Granada;054;Cortes y Graena;1043;538;505
18;Granada;912;Cuevas del Campo;1882;942;940
18;Granada;056;Cúllar;4351;2183;2168
18;Granada;057;Cúllar Vega;7128;3608;3520
18;Granada;063;Darro;1545;772;773
18;Granada;064;Dehesas de Guadix;454;229;225
18;Granada;065;Dehesas Viejas;783;399;384
18;Granada;066;Deifontes;2624;1321;1303
18;Granada;067;Diezma;780;395;385
18;Granada;068;Dílar;1838;920;918
18;Granada;069;Dólar;621;323;298
18;Granada;070;Dúdar;348;188;160
18;Granada;071;Dúrcal;7123;3527;3596
18;Granada;072;Escúzar;791;399;392
18;Granada;074;Ferreira;314;159;155
18;Granada;076;Fonelas;1054;548;506
18;Granada;078;Freila;950;482;468
18;Granada;079;Fuente Vaqueros;4457;2228;2229
18;Granada;905;Gabias, Las;19603;10017;9586
18;Granada;082;Galera;1150;569;581
18;Granada;083;Gobernador;298;140;158
18;Granada;084;Gójar;5410;2771;2639
18;Granada;085;Gor;777;396;381
18;Granada;086;Gorafe;420;216;204
18;Granada;087;Granada;235800;109370;126430
18;Granada;088;Guadahortuna;1989;1015;974
18;Granada;089;Guadix;18928;9354;9574
18;Granada;906;Guajares, Los;1087;572;515
18;Granada;093;Gualchos;4849;2477;2372
18;Granada;094;Güejar Sierra;2953;1553;1400
18;Granada;095;Güevéjar;2540;1341;1199
18;Granada;096;Huélago;430;221;209
18;Granada;097;Huéneja;1168;618;550
18;Granada;098;Huéscar;7677;3790;3887
18;Granada;099;Huétor de Santillán;1872;960;912
18;Granada;100;Huétor Tájar;10147;5103;5044
18;Granada;101;Huétor Vega;11849;5950;5899
18;Granada;102;Illora;10423;5203;5220
18;Granada;103;Itrabo;1018;511;507
18;Granada;105;Iznalloz;6016;3086;2930
18;Granada;107;Jayena;1178;595;583
18;Granada;108;Jerez del Marquesado;1021;525;496
18;Granada;109;Jete;908;466;442
18;Granada;111;Jun;3620;1842;1778
18;Granada;112;Juviles;153;72;81
18;Granada;115;Láchar;3263;1666;1597
18;Granada;116;Lanjarón;3715;1838;1877
18;Granada;117;Lanteira;546;286;260
18;Granada;119;Lecrín;2138;1083;1055
18;Granada;120;Lentegí;346;183;163
18;Granada;121;Lobras;166;84;82
18;Granada;122;Loja;20893;10475;10418
18;Granada;123;Lugros;320;176;144
18;Granada;124;Lújar;517;274;243
18;Granada;126;Malahá, La;1834;918;916
18;Granada;127;Maracena;21816;10743;11073
18;Granada;128;Marchal;427;198;229
18;Granada;132;Moclín;3976;1971;2005
18;Granada;133;Molvízar;2895;1473;1422
18;Granada;134;Monachil;7538;3900;3638
18;Granada;135;Montefrío;5720;2872;2848
18;Granada;136;Montejícar;2230;1139;1091
18;Granada;137;Montillana;1330;703;627
18;Granada;138;Moraleda de Zafayona;3200;1629;1571
18;Granada;909;Morelábor;693;373;320
18;Granada;140;Motril;60777;29914;30863
18;Granada;141;Murtas;524;301;223
18;Granada;903;Nevada;1123;574;549
18;Granada;143;Nigüelas;1214;616;598
18;Granada;144;Nívar;922;476;446
18;Granada;145;Ogíjares;13719;6775;6944
18;Granada;146;Orce;1226;633;593
18;Granada;147;Órgiva;5483;2752;2731
18;Granada;148;Otívar;1093;549;544
18;Granada;150;Padul;8407;4236;4171
18;Granada;151;Pampaneira;315;157;158
18;Granada;152;Pedro Martínez;1150;564;586
18;Granada;153;Peligros;11154;5544;5610
18;Granada;154;Peza, La;1250;645;605
18;Granada;910;Pinar, El;996;516;480
18;Granada;157;Pinos Genil;1438;745;693
18;Granada;158;Pinos Puente;10605;5315;5290
18;Granada;159;Píñar;1209;670;539
18;Granada;161;Polícar;235;122;113
18;Granada;162;Polopos;1680;885;795
18;Granada;163;Pórtugos;409;213;196
18;Granada;164;Puebla de Don Fadrique;2329;1211;1118
18;Granada;165;Pulianas;5366;2666;2700
18;Granada;167;Purullena;2399;1202;1197
18;Granada;168;Quéntar;974;495;479
18;Granada;170;Rubite;392;221;171
18;Granada;171;Salar;2712;1366;1346
18;Granada;173;Salobreña;12429;6171;6258
18;Granada;174;Santa Cruz del Comercio;549;288;261
18;Granada;175;Santa Fe;15067;7428;7639
18;Granada;176;Soportújar;296;167;129
18;Granada;177;Sorvilán;552;281;271
18;Granada;901;Taha, La;643;334;309
18;Granada;178;Torre-Cardela;847;437;410
18;Granada;179;Torvizcón;708;372;336
18;Granada;180;Trevélez;786;411;375
18;Granada;181;Turón;265;159;106
18;Granada;182;Ugíjar;2560;1259;1301
18;Granada;914;Valderrubio;2111;1040;1071
18;Granada;907;Valle del Zalabí;2229;1134;1095
18;Granada;902;Valle, El;1013;496;517
18;Granada;183;Válor;654;337;317
18;Granada;911;Vegas del Genil;10423;5327;5096
18;Granada;184;Vélez de Benaudalla;2903;1461;1442
18;Granada;185;Ventas de Huelma;661;352;309
18;Granada;149;Villa de Otura;6783;3442;3341
18;Granada;908;Villamena;1016;510;506
18;Granada;187;Villanueva de las Torres;661;350;311
18;Granada;188;Villanueva Mesía;2013;1008;1005
18;Granada;189;Víznar;971;499;472
18;Granada;192;Zafarraya;2040;1087;953
18;Granada;913;Zagra;899;460;439
18;Granada;193;Zubia, La;18675;9160;9515
18;Granada;194;Zújar;2777;1432;1345
19;Guadalajara;001;Abánades;63;37;26
19;Guadalajara;002;Ablanque;74;41;33
19;Guadalajara;003;Adobes;43;23;20
19;Guadalajara;004;Alaminos;73;34;39
19;Guadalajara;005;Alarilla;90;59;31
19;Guadalajara;006;Albalate de Zorita;997;550;447
19;Guadalajara;007;Albares;589;314;275
19;Guadalajara;008;Albendiego;43;28;15
19;Guadalajara;009;Alcocer;360;188;172
19;Guadalajara;010;Alcolea de las Peñas;13;8;5
19;Guadalajara;011;Alcolea del Pinar;343;190;153
19;Guadalajara;013;Alcoroches;141;83;58
19;Guadalajara;015;Aldeanueva de Guadalajara;79;43;36
19;Guadalajara;016;Algar de Mesa;67;44;23
19;Guadalajara;017;Algora;77;50;27
19;Guadalajara;018;Alhóndiga;184;104;80
19;Guadalajara;019;Alique;18;7;11
19;Guadalajara;020;Almadrones;59;37;22
19;Guadalajara;021;Almoguera;1401;733;668
19;Guadalajara;022;Almonacid de Zorita;760;362;398
19;Guadalajara;023;Alocén;168;91;77
19;Guadalajara;024;Alovera;12247;6272;5975
19;Guadalajara;027;Alustante;172;101;71
19;Guadalajara;031;Angón;15;12;3
19;Guadalajara;032;Anguita;205;107;98
19;Guadalajara;033;Anquela del Ducado;69;41;28
19;Guadalajara;034;Anquela del Pedregal;19;14;5
19;Guadalajara;036;Aranzueque;436;221;215
19;Guadalajara;037;Arbancón;157;91;66
19;Guadalajara;038;Arbeteta;29;19;10
19;Guadalajara;039;Argecilla;70;48;22
19;Guadalajara;040;Armallones;54;33;21
19;Guadalajara;041;Armuña de Tajuña;240;124;116
19;Guadalajara;042;Arroyo de las Fraguas;28;16;12
19;Guadalajara;043;Atanzón;81;50;31
19;Guadalajara;044;Atienza;458;253;205
19;Guadalajara;045;Auñón;163;87;76
19;Guadalajara;046;Azuqueca de Henares;34896;17780;17116
19;Guadalajara;047;Baides;73;36;37
19;Guadalajara;048;Baños de Tajo;17;13;4
19;Guadalajara;049;Bañuelos;17;15;2
19;Guadalajara;050;Barriopedro;19;11;8
19;Guadalajara;051;Berninches;65;38;27
19;Guadalajara;052;Bodera, La;31;19;12
19;Guadalajara;053;Brihuega;2538;1327;1211
19;Guadalajara;054;Budia;231;129;102
19;Guadalajara;055;Bujalaro;67;36;31
19;Guadalajara;057;Bustares;80;50;30
19;Guadalajara;058;Cabanillas del Campo;9707;4907;4800
19;Guadalajara;059;Campillo de Dueñas;85;47;38
19;Guadalajara;060;Campillo de Ranas;186;116;70
19;Guadalajara;061;Campisábalos;66;45;21
19;Guadalajara;064;Canredondo;88;49;39
19;Guadalajara;065;Cantalojas;166;104;62
19;Guadalajara;066;Cañizar;71;37;34
19;Guadalajara;067;Cardoso de la Sierra, El;66;44;22
19;Guadalajara;070;Casa de Uceda;111;60;51
19;Guadalajara;071;Casar, El;11606;5949;5657
19;Guadalajara;073;Casas de San Galindo;24;15;9
19;Guadalajara;074;Caspueñas;97;56;41
19;Guadalajara;075;Castejón de Henares;69;42;27
19;Guadalajara;076;Castellar de la Muela;41;18;23
19;Guadalajara;078;Castilforte;57;36;21
19;Guadalajara;079;Castilnuevo;8;5;3
19;Guadalajara;080;Cendejas de Enmedio;86;44;42
19;Guadalajara;081;Cendejas de la Torre;30;18;12
19;Guadalajara;082;Centenera;106;57;49
19;Guadalajara;103;Checa;289;175;114
19;Guadalajara;104;Chequilla;21;11;10
19;Guadalajara;106;Chillarón del Rey;111;64;47
19;Guadalajara;105;Chiloeches;3291;1715;1576
19;Guadalajara;086;Cifuentes;1920;989;931
19;Guadalajara;087;Cincovillas;22;12;10
19;Guadalajara;088;Ciruelas;101;57;44
19;Guadalajara;089;Ciruelos del Pinar;28;16;12
19;Guadalajara;090;Cobeta;121;57;64
19;Guadalajara;091;Cogollor;29;17;12
19;Guadalajara;092;Cogolludo;600;344;256
19;Guadalajara;095;Condemios de Abajo;20;11;9
19;Guadalajara;096;Condemios de Arriba;128;69;59
19;Guadalajara;097;Congostrina;21;14;7
19;Guadalajara;098;Copernal;28;18;10
19;Guadalajara;099;Corduente;365;203;162
19;Guadalajara;102;Cubillo de Uceda, El;145;76;69
19;Guadalajara;107;Driebes;375;195;180
19;Guadalajara;108;Durón;129;64;65
19;Guadalajara;109;Embid;44;25;19
19;Guadalajara;110;Escamilla;71;35;36
19;Guadalajara;111;Escariche;187;108;79
19;Guadalajara;112;Escopete;62;30;32
19;Guadalajara;113;Espinosa de Henares;696;360;336
19;Guadalajara;114;Esplegares;40;26;14
19;Guadalajara;115;Establés;29;19;10
19;Guadalajara;116;Estriégana;21;13;8
19;Guadalajara;117;Fontanar;2338;1228;1110
19;Guadalajara;118;Fuembellida;13;8;5
19;Guadalajara;119;Fuencemillán;99;57;42
19;Guadalajara;120;Fuentelahiguera de Albatages;136;77;59
19;Guadalajara;121;Fuentelencina;332;188;144
19;Guadalajara;122;Fuentelsaz;104;56;48
19;Guadalajara;123;Fuentelviejo;70;33;37
19;Guadalajara;124;Fuentenovilla;543;297;246
19;Guadalajara;125;Gajanejos;50;31;19
19;Guadalajara;126;Galápagos;2368;1264;1104
19;Guadalajara;127;Galve de Sorbe;109;61;48
19;Guadalajara;129;Gascueña de Bornova;39;23;16
19;Guadalajara;130;Guadalajara;83391;40278;43113
19;Guadalajara;132;Henche;100;56;44
19;Guadalajara;133;Heras de Ayuso;252;151;101
19;Guadalajara;134;Herrería;26;17;9
19;Guadalajara;135;Hiendelaencina;133;73;60
19;Guadalajara;136;Hijes;25;16;9
19;Guadalajara;138;Hita;358;196;162
19;Guadalajara;139;Hombrados;38;21;17
19;Guadalajara;142;Hontoba;314;178;136
19;Guadalajara;143;Horche;2544;1306;1238
19;Guadalajara;145;Hortezuela de Océn;52;31;21
19;Guadalajara;146;Huerce, La;39;22;17
19;Guadalajara;147;Huérmeces del Cerro;43;28;15
19;Guadalajara;148;Huertahernando;60;39;21
19;Guadalajara;150;Hueva;140;84;56
19;Guadalajara;151;Humanes;1485;725;760
19;Guadalajara;152;Illana;775;439;336
19;Guadalajara;153;Iniéstola;24;15;9
19;Guadalajara;154;Inviernas, Las;66;44;22
19;Guadalajara;155;Irueste;65;42;23
19;Guadalajara;156;Jadraque;1504;772;732
19;Guadalajara;157;Jirueque;68;41;27
19;Guadalajara;159;Ledanca;102;53;49
19;Guadalajara;160;Loranca de Tajuña;1275;699;576
19;Guadalajara;161;Lupiana;256;135;121
19;Guadalajara;162;Luzaga;65;35;30
19;Guadalajara;163;Luzón;72;37;35
19;Guadalajara;165;Majaelrayo;52;27;25
19;Guadalajara;166;Málaga del Fresno;194;111;83
19;Guadalajara;167;Malaguilla;154;84;70
19;Guadalajara;168;Mandayona;339;174;165
19;Guadalajara;169;Mantiel;49;31;18
19;Guadalajara;170;Maranchón;247;136;111
19;Guadalajara;171;Marchamalo;6750;3418;3332
19;Guadalajara;172;Masegoso de Tajuña;59;33;26
19;Guadalajara;173;Matarrubia;46;33;13
19;Guadalajara;174;Matillas;149;71;78
19;Guadalajara;175;Mazarete;46;22;24
19;Guadalajara;176;Mazuecos;307;156;151
19;Guadalajara;177;Medranda;84;43;41
19;Guadalajara;178;Megina;47;31;16
19;Guadalajara;179;Membrillera;96;49;47
19;Guadalajara;181;Miedes de Atienza;67;37;30
19;Guadalajara;182;Mierla, La;41;28;13
19;Guadalajara;184;Millana;126;72;54
19;Guadalajara;183;Milmarcos;98;56;42
19;Guadalajara;185;Miñosa, La;34;24;10
19;Guadalajara;186;Mirabueno;93;55;38
19;Guadalajara;187;Miralrío;64;38;26
19;Guadalajara;188;Mochales;52;29;23
19;Guadalajara;189;Mohernando;180;96;84
19;Guadalajara;190;Molina de Aragón;3468;1732;1736
19;Guadalajara;191;Monasterio;13;4;9
19;Guadalajara;192;Mondéjar;2579;1325;1254
19;Guadalajara;193;Montarrón;28;15;13
19;Guadalajara;194;Moratilla de los Meleros;111;61;50
19;Guadalajara;195;Morenilla;45;26;19
19;Guadalajara;196;Muduex;116;61;55
19;Guadalajara;197;Navas de Jadraque, Las;27;19;8
19;Guadalajara;198;Negredo;21;12;9
19;Guadalajara;199;Ocentejo;20;14;6
19;Guadalajara;200;Olivar, El;89;54;35
19;Guadalajara;201;Olmeda de Cobeta;73;40;33
19;Guadalajara;202;Olmeda de Jadraque, La;16;9;7
19;Guadalajara;203;Ordial, El;31;17;14
19;Guadalajara;204;Orea;203;123;80
19;Guadalajara;208;Pálmaces de Jadraque;47;25;22
19;Guadalajara;209;Pardos;43;26;17
19;Guadalajara;210;Paredes de Sigüenza;22;12;10
19;Guadalajara;211;Pareja;468;267;201
19;Guadalajara;212;Pastrana;978;506;472
19;Guadalajara;213;Pedregal, El;83;52;31
19;Guadalajara;214;Peñalén;82;48;34
19;Guadalajara;215;Peñalver;187;116;71
19;Guadalajara;216;Peralejos de las Truchas;153;84;69
19;Guadalajara;217;Peralveche;70;45;25
19;Guadalajara;218;Pinilla de Jadraque;55;30;25
19;Guadalajara;219;Pinilla de Molina;17;12;5
19;Guadalajara;220;Pioz;3544;1893;1651
19;Guadalajara;221;Piqueras;56;37;19
19;Guadalajara;222;Pobo de Dueñas, El;134;69;65
19;Guadalajara;223;Poveda de la Sierra;131;67;64
19;Guadalajara;224;Pozo de Almoguera;109;61;48
19;Guadalajara;225;Pozo de Guadalajara;1249;666;583
19;Guadalajara;226;Prádena de Atienza;51;35;16
19;Guadalajara;227;Prados Redondos;74;47;27
19;Guadalajara;228;Puebla de Beleña;46;24;22
19;Guadalajara;229;Puebla de Valles;74;40;34
19;Guadalajara;230;Quer;747;399;348
19;Guadalajara;231;Rebollosa de Jadraque;14;10;4
19;Guadalajara;232;Recuenco, El;74;44;30
19;Guadalajara;233;Renera;111;62;49
19;Guadalajara;234;Retiendas;53;27;26
19;Guadalajara;235;Riba de Saelices;111;62;49
19;Guadalajara;237;Rillo de Gallo;56;32;24
19;Guadalajara;238;Riofrío del Llano;46;27;19
19;Guadalajara;239;Robledillo de Mohernando;109;56;53
19;Guadalajara;240;Robledo de Corpes;55;30;25
19;Guadalajara;241;Romanillos de Atienza;54;33;21
19;Guadalajara;242;Romanones;117;61;56
19;Guadalajara;243;Rueda de la Sierra;50;32;18
19;Guadalajara;244;Sacecorbo;93;52;41
19;Guadalajara;245;Sacedón;1605;841;764
19;Guadalajara;246;Saelices de la Sal;54;31;23
19;Guadalajara;247;Salmerón;177;97;80
19;Guadalajara;248;San Andrés del Congosto;91;51;40
19;Guadalajara;249;San Andrés del Rey;34;15;19
19;Guadalajara;250;Santiuste;19;12;7
19;Guadalajara;251;Saúca;58;32;26
19;Guadalajara;252;Sayatón;89;51;38
19;Guadalajara;254;Selas;63;27;36
19;Guadalajara;901;Semillas;41;25;16
19;Guadalajara;255;Setiles;84;49;35
19;Guadalajara;256;Sienes;55;33;22
19;Guadalajara;257;Sigüenza;4648;2307;2341
19;Guadalajara;258;Solanillos del Extremo;104;60;44
19;Guadalajara;259;Somolinos;33;16;17
19;Guadalajara;260;Sotillo, El;48;26;22
19;Guadalajara;261;Sotodosos;41;17;24
19;Guadalajara;262;Tamajón;148;75;73
19;Guadalajara;263;Taragudo;51;23;28
19;Guadalajara;264;Taravilla;41;26;15
19;Guadalajara;265;Tartanedo;150;87;63
19;Guadalajara;266;Tendilla;339;186;153
19;Guadalajara;267;Terzaga;20;13;7
19;Guadalajara;268;Tierzo;38;24;14
19;Guadalajara;269;Toba, La;105;57;48
19;Guadalajara;271;Tordellego;56;31;25
19;Guadalajara;270;Tordelrábano;21;12;9
19;Guadalajara;272;Tordesilos;108;64;44
19;Guadalajara;274;Torija;1453;763;690
19;Guadalajara;279;Torre del Burgo;228;120;108
19;Guadalajara;277;Torrecuadrada de Molina;23;13;10
19;Guadalajara;278;Torrecuadradilla;31;18;13
19;Guadalajara;280;Torrejón del Rey;5064;2624;2440
19;Guadalajara;281;Torremocha de Jadraque;27;18;9
19;Guadalajara;282;Torremocha del Campo;200;114;86
19;Guadalajara;283;Torremocha del Pinar;40;15;25
19;Guadalajara;284;Torremochuela;11;6;5
19;Guadalajara;285;Torrubia;25;15;10
19;Guadalajara;286;Tórtola de Henares;990;536;454
19;Guadalajara;287;Tortuera;207;108;99
19;Guadalajara;288;Tortuero;20;12;8
19;Guadalajara;289;Traíd;29;18;11
19;Guadalajara;290;Trijueque;1256;659;597
19;Guadalajara;291;Trillo;1436;754;682
19;Guadalajara;293;Uceda;2602;1358;1244
19;Guadalajara;294;Ujados;28;16;12
19;Guadalajara;296;Utande;35;25;10
19;Guadalajara;297;Valdarachas;36;18;18
19;Guadalajara;298;Valdearenas;94;60;34
19;Guadalajara;299;Valdeavellano;102;55;47
19;Guadalajara;300;Valdeaveruelo;1048;533;515
19;Guadalajara;301;Valdeconcha;41;24;17
19;Guadalajara;302;Valdegrudas;66;42;24
19;Guadalajara;303;Valdelcubo;58;36;22
19;Guadalajara;304;Valdenuño Fernández;270;156;114
19;Guadalajara;305;Valdepeñas de la Sierra;192;114;78
19;Guadalajara;306;Valderrebollo;31;15;16
19;Guadalajara;307;Valdesotos;25;14;11
19;Guadalajara;308;Valfermoso de Tajuña;65;41;24
19;Guadalajara;309;Valhermoso;44;27;17
19;Guadalajara;310;Valtablado del Río;12;9;3
19;Guadalajara;311;Valverde de los Arroyos;90;48;42
19;Guadalajara;314;Viana de Jadraque;54;37;17
19;Guadalajara;317;Villanueva de Alcorón;193;100;93
19;Guadalajara;318;Villanueva de Argecilla;31;21;10
19;Guadalajara;319;Villanueva de la Torre;6443;3253;3190
19;Guadalajara;321;Villares de Jadraque;54;35;19
19;Guadalajara;322;Villaseca de Henares;33;17;16
19;Guadalajara;323;Villaseca de Uceda;48;25;23
19;Guadalajara;324;Villel de Mesa;207;111;96
19;Guadalajara;325;Viñuelas;151;83;68
19;Guadalajara;326;Yebes;2741;1440;1301
19;Guadalajara;327;Yebra;539;283;256
19;Guadalajara;329;Yélamos de Abajo;64;34;30
19;Guadalajara;330;Yélamos de Arriba;94;55;39
19;Guadalajara;331;Yunquera de Henares;3755;1932;1823
19;Guadalajara;332;Yunta, La;100;57;43
19;Guadalajara;333;Zaorejas;139;88;51
19;Guadalajara;334;Zarzuela de Jadraque;35;22;13
19;Guadalajara;335;Zorita de los Canes;72;35;37
21;Huelva;001;Alájar;813;413;400
21;Huelva;002;Aljaraque;20357;10150;10207
21;Huelva;003;Almendro, El;829;436;393
21;Huelva;004;Almonaster la Real;1861;978;883
21;Huelva;005;Almonte;23254;11648;11606
21;Huelva;006;Alosno;4038;1966;2072
21;Huelva;007;Aracena;7972;3935;4037
21;Huelva;008;Aroche;3183;1599;1584
21;Huelva;009;Arroyomolinos de León;1018;525;493
21;Huelva;010;Ayamonte;20357;10173;10184
21;Huelva;011;Beas;4304;2181;2123
21;Huelva;012;Berrocal;345;165;180
21;Huelva;013;Bollullos Par del Condado;14324;7142;7182
21;Huelva;014;Bonares;6090;3032;3058
21;Huelva;015;Cabezas Rubias;744;387;357
21;Huelva;016;Cala;1252;633;619
21;Huelva;017;Calañas;4238;2166;2072
21;Huelva;018;Campillo, El;2122;1051;1071
21;Huelva;019;Campofrío;643;320;323
21;Huelva;020;Cañaveral de León;409;199;210
21;Huelva;021;Cartaya;19164;9853;9311
21;Huelva;022;Castaño del Robledo;211;122;89
21;Huelva;023;Cerro de Andévalo, El;2495;1253;1242
21;Huelva;030;Chucena;2122;1076;1046
21;Huelva;024;Corteconcepción;552;275;277
21;Huelva;025;Cortegana;4931;2514;2417
21;Huelva;026;Cortelazor;283;143;140
21;Huelva;027;Cumbres de Enmedio;54;33;21
21;Huelva;028;Cumbres de San Bartolomé;421;210;211
21;Huelva;029;Cumbres Mayores;1848;924;924
21;Huelva;031;Encinasola;1326;684;642
21;Huelva;032;Escacena del Campo;2095;1030;1065
21;Huelva;033;Fuenteheridos;641;332;309
21;Huelva;034;Galaroza;1486;733;753
21;Huelva;035;Gibraleón;12508;6202;6306
21;Huelva;036;Granada de Río-Tinto, La;202;102;100
21;Huelva;037;Granado, El;540;291;249
21;Huelva;038;Higuera de la Sierra;1327;681;646
21;Huelva;039;Hinojales;273;132;141
21;Huelva;040;Hinojos;3862;1942;1920
21;Huelva;041;Huelva;146318;70283;76035
21;Huelva;042;Isla Cristina;21193;10515;10678
21;Huelva;043;Jabugo;2267;1146;1121
21;Huelva;044;Lepe;27675;14051;13624
21;Huelva;045;Linares de la Sierra;272;140;132
21;Huelva;046;Lucena del Puerto;3046;1599;1447
21;Huelva;047;Manzanilla;2108;1065;1043
21;Huelva;048;Marines, Los;273;136;137
21;Huelva;049;Minas de Riotinto;4063;1967;2096
21;Huelva;050;Moguer;21383;10636;10747
21;Huelva;051;Nava, La;289;145;144
21;Huelva;052;Nerva;5514;2656;2858
21;Huelva;053;Niebla;3999;2015;1984
21;Huelva;054;Palma del Condado, La;10662;5327;5335
21;Huelva;055;Palos de la Frontera;10365;5178;5187
21;Huelva;056;Paterna del Campo;3554;1802;1752
21;Huelva;057;Paymogo;1238;623;615
21;Huelva;058;Puebla de Guzmán;3143;1619;1524
21;Huelva;059;Puerto Moral;288;142;146
21;Huelva;060;Punta Umbría;14996;7619;7377
21;Huelva;061;Rociana del Condado;7643;3844;3799
21;Huelva;062;Rosal de la Frontera;1750;881;869
21;Huelva;063;San Bartolomé de la Torre;3608;1813;1795
21;Huelva;064;San Juan del Puerto;8832;4448;4384
21;Huelva;066;San Silvestre de Guzmán;634;347;287
21;Huelva;065;Sanlúcar de Guadiana;443;224;219
21;Huelva;067;Santa Ana la Real;523;240;283
21;Huelva;068;Santa Bárbara de Casa;1113;552;561
21;Huelva;069;Santa Olalla del Cala;2010;1033;977
21;Huelva;070;Trigueros;7746;3830;3916
21;Huelva;071;Valdelarco;225;109;116
21;Huelva;072;Valverde del Camino;12766;6275;6491
21;Huelva;073;Villablanca;2880;1440;1440
21;Huelva;074;Villalba del Alcor;3320;1637;1683
21;Huelva;075;Villanueva de las Cruces;379;184;195
21;Huelva;076;Villanueva de los Castillejos;2747;1380;1367
21;Huelva;077;Villarrasa;2162;1097;1065
21;Huelva;078;Zalamea la Real;3210;1618;1592
21;Huelva;079;Zufre;886;452;434
22;Huesca;001;Abiego;253;136;117
22;Huesca;002;Abizanda;142;73;69
22;Huesca;003;Adahuesca;173;87;86
22;Huesca;004;Agüero;145;85;60
22;Huesca;907;Aínsa-Sobrarbe;2220;1141;1079
22;Huesca;006;Aisa;358;194;164
22;Huesca;007;Albalate de Cinca;1151;609;542
22;Huesca;008;Albalatillo;205;114;91
22;Huesca;009;Albelda;750;391;359
22;Huesca;011;Albero Alto;124;75;49
22;Huesca;012;Albero Bajo;138;74;64
22;Huesca;013;Alberuela de Tubo;314;165;149
22;Huesca;014;Alcalá de Gurrea;273;142;131
22;Huesca;015;Alcalá del Obispo;342;187;155
22;Huesca;016;Alcampell;697;356;341
22;Huesca;017;Alcolea de Cinca;1125;591;534
22;Huesca;018;Alcubierre;399;217;182
22;Huesca;019;Alerre;209;109;100
22;Huesca;020;Alfántega;128;63;65
22;Huesca;021;Almudévar;2501;1288;1213
22;Huesca;022;Almunia de San Juan;679;350;329
22;Huesca;023;Almuniente;522;261;261
22;Huesca;024;Alquézar;297;163;134
22;Huesca;025;Altorricón;1469;785;684
22;Huesca;027;Angüés;391;213;178
22;Huesca;028;Ansó;426;219;207
22;Huesca;029;Antillón;159;85;74
22;Huesca;032;Aragüés del Puerto;119;63;56
22;Huesca;035;Arén;328;173;155
22;Huesca;036;Argavieso;105;61;44
22;Huesca;037;Arguis;126;72;54
22;Huesca;039;Ayerbe;1116;557;559
22;Huesca;040;Azanuy-Alins;173;87;86
22;Huesca;041;Azara;189;95;94
22;Huesca;042;Azlor;141;67;74
22;Huesca;043;Baélls;106;60;46
22;Huesca;044;Bailo;288;171;117
22;Huesca;045;Baldellou;102;58;44
22;Huesca;046;Ballobar;838;425;413
22;Huesca;047;Banastás;305;162;143
22;Huesca;048;Barbastro;17020;8269;8751
22;Huesca;049;Barbués;87;49;38
22;Huesca;050;Barbuñales;99;49;50
22;Huesca;051;Bárcabo;117;68;49
22;Huesca;052;Belver de Cinca;1312;735;577
22;Huesca;053;Benabarre;1127;584;543
22;Huesca;054;Benasque;2090;1109;981
22;Huesca;246;Beranuy;92;53;39
22;Huesca;055;Berbegal;378;193;185
22;Huesca;057;Bielsa;488;249;239
22;Huesca;058;Bierge;244;139;105
22;Huesca;059;Biescas;1487;781;706
22;Huesca;060;Binaced;1507;785;722
22;Huesca;061;Binéfar;9439;4904;4535
22;Huesca;062;Bisaurri;176;95;81
22;Huesca;063;Biscarrués;202;111;91
22;Huesca;064;Blecua y Torres;200;113;87
22;Huesca;066;Boltaña;981;518;463
22;Huesca;067;Bonansa;81;44;37
22;Huesca;068;Borau;95;59;36
22;Huesca;069;Broto;532;287;245
22;Huesca;072;Caldearenas;210;119;91
22;Huesca;074;Campo;437;239;198
22;Huesca;075;Camporrélls;138;78;60
22;Huesca;076;Canal de Berdún;367;197;170
22;Huesca;077;Candasnos;330;171;159
22;Huesca;078;Canfranc;560;313;247
22;Huesca;079;Capdesaso;172;75;97
22;Huesca;080;Capella;361;192;169
22;Huesca;081;Casbas de Huesca;291;156;135
22;Huesca;083;Castejón de Monegros;568;300;268
22;Huesca;084;Castejón de Sos;740;379;361
22;Huesca;082;Castejón del Puente;340;179;161
22;Huesca;085;Castelflorite;120;65;55
22;Huesca;086;Castiello de Jaca;251;139;112
22;Huesca;087;Castigaleu;94;55;39
22;Huesca;088;Castillazuelo;181;89;92
22;Huesca;089;Castillonroy;343;176;167
22;Huesca;094;Chalamera;111;58;53
22;Huesca;095;Chía;90;57;33
22;Huesca;096;Chimillas;358;182;176
22;Huesca;090;Colungo;126;70;56
22;Huesca;099;Esplús;619;316;303
22;Huesca;102;Estada;210;114;96
22;Huesca;103;Estadilla;819;392;427
22;Huesca;105;Estopiñán del Castillo;147;78;69
22;Huesca;106;Fago;25;16;9
22;Huesca;107;Fanlo;112;69;43
22;Huesca;109;Fiscal;361;192;169
22;Huesca;110;Fonz;944;483;461
22;Huesca;111;Foradada del Toscar;187;101;86
22;Huesca;112;Fraga;14921;7614;7307
22;Huesca;113;Fueva, La;622;324;298
22;Huesca;114;Gistaín;138;76;62
22;Huesca;115;Grado, El;433;227;206
22;Huesca;116;Grañén;1859;973;886
22;Huesca;117;Graus;3371;1687;1684
22;Huesca;119;Gurrea de Gállego;1545;798;747
22;Huesca;122;Hoz de Jaca;68;35;33
22;Huesca;908;Hoz y Costean;230;131;99
22;Huesca;124;Huerto;238;132;106
22;Huesca;125;Huesca;52239;24983;27256
22;Huesca;126;Ibieca;110;60;50
22;Huesca;127;Igriés;692;365;327
22;Huesca;128;Ilche;208;107;101
22;Huesca;129;Isábena;276;148;128
22;Huesca;130;Jaca;13088;6504;6584
22;Huesca;131;Jasa;104;59;45
22;Huesca;133;Labuerda;167;89;78
22;Huesca;135;Laluenga;213;116;97
22;Huesca;136;Lalueza;997;520;477
22;Huesca;137;Lanaja;1268;678;590
22;Huesca;139;Laperdiguera;96;51;45
22;Huesca;141;Lascellas-Ponzano;138;83;55
22;Huesca;142;Lascuarre;137;69;68
22;Huesca;143;Laspaúles;281;163;118
22;Huesca;144;Laspuña;290;155;135
22;Huesca;149;Loarre;335;190;145
22;Huesca;150;Loporzano;532;298;234
22;Huesca;151;Loscorrales;106;51;55
22;Huesca;905;Lupiñén-Ortilla;364;181;183
22;Huesca;155;Monesma y Cajigar;87;46;41
22;Huesca;156;Monflorite-Lascasas;313;165;148
22;Huesca;157;Montanuy;221;124;97
22;Huesca;158;Monzón;17260;8779;8481
22;Huesca;160;Naval;259;135;124
22;Huesca;162;Novales;183;93;90
22;Huesca;163;Nueno;552;303;249
22;Huesca;164;Olvena;45;23;22
22;Huesca;165;Ontiñena;569;284;285
22;Huesca;167;Osso de Cinca;746;391;355
22;Huesca;168;Palo;24;12;12
22;Huesca;170;Panticosa;762;390;372
22;Huesca;172;Peñalba;695;348;347
22;Huesca;173;Peñas de Riglos, Las;264;164;100
22;Huesca;174;Peralta de Alcofea;602;318;284
22;Huesca;175;Peralta de Calasanz;233;132;101
22;Huesca;176;Peraltilla;201;104;97
22;Huesca;177;Perarrúa;111;58;53
22;Huesca;178;Pertusa;124;74;50
22;Huesca;181;Piracés;107;59;48
22;Huesca;182;Plan;303;156;147
22;Huesca;184;Poleñino;217;116;101
22;Huesca;186;Pozán de Vero;221;108;113
22;Huesca;187;Puebla de Castro, La;383;195;188
22;Huesca;188;Puente de Montañana;107;46;61
22;Huesca;902;Puente la Reina de Jaca;261;134;127
22;Huesca;189;Puértolas;207;120;87
22;Huesca;190;Pueyo de Araguás, El;149;88;61
22;Huesca;193;Pueyo de Santa Cruz;328;169;159
22;Huesca;195;Quicena;286;145;141
22;Huesca;197;Robres;586;294;292
22;Huesca;199;Sabiñánigo;9598;4814;4784
22;Huesca;200;Sahún;308;163;145
22;Huesca;201;Salas Altas;313;159;154
22;Huesca;202;Salas Bajas;168;80;88
22;Huesca;203;Salillas;101;53;48
22;Huesca;204;Sallent de Gállego;1441;720;721
22;Huesca;205;San Esteban de Litera;498;258;240
22;Huesca;207;San Juan de Plan;148;83;65
22;Huesca;903;San Miguel del Cinca;857;424;433
22;Huesca;206;Sangarrén;235;121;114
22;Huesca;208;Santa Cilia;207;108;99
22;Huesca;209;Santa Cruz de la Serós;186;106;80
22;Huesca;906;Santa María de Dulcis;221;117;104
22;Huesca;212;Santaliestra y San Quílez;104;53;51
22;Huesca;213;Sariñena;4223;2179;2044
22;Huesca;214;Secastilla;144;65;79
22;Huesca;215;Seira;147;81;66
22;Huesca;217;Sena;515;281;234
22;Huesca;218;Senés de Alcubierre;49;23;26
22;Huesca;220;Sesa;190;106;84
22;Huesca;221;Sesué;119;64;55
22;Huesca;222;Siétamo;672;368;304
22;Huesca;223;Sopeira;99;54;45
22;Huesca;904;Sotonera, La;990;514;476
22;Huesca;225;Tamarite de Litera;3538;1809;1729
22;Huesca;226;Tardienta;985;501;484
22;Huesca;227;Tella-Sin;249;141;108
22;Huesca;228;Tierz;742;362;380
22;Huesca;229;Tolva;137;82;55
22;Huesca;230;Torla-Ordesa;306;158;148
22;Huesca;232;Torralba de Aragón;114;59;55
22;Huesca;233;Torre la Ribera;104;55;49
22;Huesca;234;Torrente de Cinca;1187;598;589
22;Huesca;235;Torres de Alcanadre;107;62;45
22;Huesca;236;Torres de Barbués;283;139;144
22;Huesca;239;Tramaced;110;66;44
22;Huesca;242;Valfarta;72;42;30
22;Huesca;243;Valle de Bardají;37;22;15
22;Huesca;901;Valle de Hecho;880;458;422
22;Huesca;244;Valle de Lierp;54;29;25
22;Huesca;245;Velilla de Cinca;442;226;216
22;Huesca;909;Vencillón;411;213;198
22;Huesca;247;Viacamp y Litera;42;24;18
22;Huesca;248;Vicién;126;73;53
22;Huesca;249;Villanova;157;80;77
22;Huesca;250;Villanúa;435;238;197
22;Huesca;251;Villanueva de Sigena;442;218;224
22;Huesca;252;Yebra de Basa;142;83;59
22;Huesca;253;Yésero;58;35;23
22;Huesca;254;Zaidín;1852;951;901
23;Jaén;001;Albanchez de Mágina;1186;613;573
23;Jaén;002;Alcalá la Real;22036;10824;11212
23;Jaén;003;Alcaudete;10779;5300;5479
23;Jaén;004;Aldeaquemada;531;280;251
23;Jaén;005;Andújar;38246;18832;19414
23;Jaén;006;Arjona;5692;2825;2867
23;Jaén;007;Arjonilla;3729;1867;1862
23;Jaén;008;Arquillos;1872;929;943
23;Jaén;905;Arroyo del Ojanco;2373;1203;1170
23;Jaén;009;Baeza;16163;8012;8151
23;Jaén;010;Bailén;18243;9087;9156
23;Jaén;011;Baños de la Encina;2672;1364;1308
23;Jaén;012;Beas de Segura;5439;2820;2619
23;Jaén;902;Bedmar y Garcíez;2871;1421;1450
23;Jaén;014;Begíjar;3133;1575;1558
23;Jaén;015;Bélmez de la Moraleda;1693;836;857
23;Jaén;016;Benatae;487;255;232
23;Jaén;017;Cabra del Santo Cristo;1937;1021;916
23;Jaén;018;Cambil;2857;1480;1377
23;Jaén;019;Campillo de Arenas;1941;1016;925
23;Jaén;020;Canena;1959;996;963
23;Jaén;021;Carboneros;641;331;310
23;Jaén;901;Cárcheles;1425;740;685
23;Jaén;024;Carolina, La;15673;7738;7935
23;Jaén;025;Castellar;3440;1724;1716
23;Jaén;026;Castillo de Locubín;4293;2114;2179
23;Jaén;027;Cazalilla;872;426;446
23;Jaén;028;Cazorla;7692;3730;3962
23;Jaén;029;Chiclana de Segura;1023;506;517
23;Jaén;030;Chilluévar;1509;739;770
23;Jaén;031;Escañuela;953;485;468
23;Jaén;032;Espelúy;699;346;353
23;Jaén;033;Frailes;1651;824;827
23;Jaén;034;Fuensanta de Martos;3160;1558;1602
23;Jaén;035;Fuerte del Rey;1409;723;686
23;Jaén;037;Génave;618;335;283
23;Jaén;038;Guardia de Jaén, La;4832;2449;2383
23;Jaén;039;Guarromán;2876;1470;1406
23;Jaén;041;Higuera de Calatrava;649;341;308
23;Jaén;042;Hinojares;355;186;169
23;Jaén;043;Hornos;657;322;335
23;Jaén;044;Huelma;6089;3021;3068
23;Jaén;045;Huesa;2584;1301;1283
23;Jaén;046;Ibros;2973;1475;1498
23;Jaén;047;Iruela, La;1999;988;1011
23;Jaén;048;Iznatoraf;1016;537;479
23;Jaén;049;Jabalquinto;2201;1111;1090
23;Jaén;050;Jaén;115395;55553;59842
23;Jaén;051;Jamilena;3404;1727;1677
23;Jaén;052;Jimena;1344;652;692
23;Jaén;053;Jódar;12022;5959;6063
23;Jaén;040;Lahiguera;1783;877;906
23;Jaén;054;Larva;487;251;236
23;Jaén;055;Linares;59737;29316;30421
23;Jaén;056;Lopera;3779;1892;1887
23;Jaén;057;Lupión;910;450;460
23;Jaén;058;Mancha Real;11212;5590;5622
23;Jaén;059;Marmolejo;7089;3534;3555
23;Jaén;060;Martos;24398;12099;12299
23;Jaén;061;Mengíbar;9935;4956;4979
23;Jaén;062;Montizón;1815;938;877
23;Jaén;063;Navas de San Juan;4712;2359;2353
23;Jaén;064;Noalejo;2000;1008;992
23;Jaén;065;Orcera;1919;967;952
23;Jaén;066;Peal de Becerro;5410;2696;2714
23;Jaén;067;Pegalajar;3032;1522;1510
23;Jaén;069;Porcuna;6567;3311;3256
23;Jaén;070;Pozo Alcón;4892;2492;2400
23;Jaén;071;Puente de Génave;2221;1123;1098
23;Jaén;072;Puerta de Segura, La;2503;1250;1253
23;Jaén;073;Quesada;5585;2821;2764
23;Jaén;074;Rus;3728;1904;1824
23;Jaén;075;Sabiote;4073;2026;2047
23;Jaén;076;Santa Elena;986;526;460
23;Jaén;077;Santiago de Calatrava;797;410;387
23;Jaén;904;Santiago-Pontones;3338;1717;1621
23;Jaén;079;Santisteban del Puerto;4666;2401;2265
23;Jaén;080;Santo Tomé;2303;1167;1136
23;Jaén;081;Segura de la Sierra;1916;939;977
23;Jaén;082;Siles;2345;1199;1146
23;Jaén;084;Sorihuela del Guadalimar;1248;661;587
23;Jaén;085;Torreblascopedro;2742;1374;1368
23;Jaén;086;Torredelcampo;14605;7347;7258
23;Jaén;087;Torredonjimeno;14011;6873;7138
23;Jaén;088;Torreperogil;7548;3676;3872
23;Jaén;090;Torres;1516;766;750
23;Jaén;091;Torres de Albánchez;877;455;422
23;Jaén;092;Úbeda;34930;17124;17806
23;Jaén;093;Valdepeñas de Jaén;3926;1943;1983
23;Jaén;094;Vilches;4689;2357;2332
23;Jaén;095;Villacarrillo;11040;5578;5462
23;Jaén;096;Villanueva de la Reina;3245;1642;1603
23;Jaén;097;Villanueva del Arzobispo;8484;4378;4106
23;Jaén;098;Villardompardo;1029;514;515
23;Jaén;099;Villares, Los;5999;3000;2999
23;Jaén;101;Villarrodrigo;438;225;213
23;Jaén;903;Villatorres;4412;2240;2172
24;León;001;Acebedo;225;132;93
24;León;002;Algadefe;284;144;140
24;León;003;Alija del Infantado;715;363;352
24;León;004;Almanza;596;349;247
24;León;005;Antigua, La;418;239;179
24;León;006;Ardón;596;314;282
24;León;007;Arganza;822;417;405
24;León;008;Astorga;11387;5414;5973
24;León;009;Balboa;321;173;148
24;León;010;Bañeza, La;10443;5045;5398
24;León;011;Barjas;201;108;93
24;León;012;Barrios de Luna, Los;331;185;146
24;León;014;Bembibre;9568;4718;4850
24;León;015;Benavides;2616;1293;1323
24;León;016;Benuza;507;289;218
24;León;017;Bercianos del Páramo;618;314;304
24;León;018;Bercianos del Real Camino;196;101;95
24;León;019;Berlanga del Bierzo;392;179;213
24;León;020;Boca de Huérgano;487;283;204
24;León;021;Boñar;1947;976;971
24;León;022;Borrenes;368;187;181
24;León;023;Brazuelo;307;167;140
24;León;024;Burgo Ranero, El;767;409;358
24;León;025;Burón;325;190;135
24;León;026;Bustillo del Páramo;1311;675;636
24;León;027;Cabañas Raras;1337;677;660
24;León;028;Cabreros del Río;431;235;196
24;León;029;Cabrillanes;828;426;402
24;León;030;Cacabelos;5318;2654;2664
24;León;031;Calzada del Coto;253;142;111
24;León;032;Campazas;139;67;72
24;León;033;Campo de Villavidel;212;116;96
24;León;034;Camponaraya;4086;2039;2047
24;León;036;Candín;297;151;146
24;León;037;Cármenes;396;214;182
24;León;038;Carracedelo;3575;1777;1798
24;León;039;Carrizo;2357;1186;1171
24;León;040;Carrocera;514;268;246
24;León;041;Carucedo;583;294;289
24;León;042;Castilfalé;71;41;30
24;León;043;Castrillo de Cabrera;134;72;62
24;León;044;Castrillo de la Valduerna;183;82;101
24;León;046;Castrocalbón;1051;554;497
24;León;047;Castrocontrigo;839;447;392
24;León;049;Castropodame;1728;888;840
24;León;050;Castrotierra de Valmadrigal;115;60;55
24;León;051;Cea;460;241;219
24;León;052;Cebanico;174;100;74
24;León;053;Cebrones del Río;512;268;244
24;León;065;Chozas de Abajo;2496;1299;1197
24;León;054;Cimanes de la Vega;500;256;244
24;León;055;Cimanes del Tejar;763;411;352
24;León;056;Cistierna;3351;1672;1679
24;León;057;Congosto;1591;787;804
24;León;058;Corbillos de los Oteros;208;115;93
24;León;059;Corullón;990;503;487
24;León;060;Crémenes;589;318;271
24;León;061;Cuadros;1999;1015;984
24;León;062;Cubillas de los Oteros;147;80;67
24;León;063;Cubillas de Rueda;466;238;228
24;León;064;Cubillos del Sil;1821;965;856
24;León;066;Destriana;549;265;284
24;León;067;Encinedo;797;419;378
24;León;068;Ercina, La;490;251;239
24;León;069;Escobar de Campos;46;29;17
24;León;070;Fabero;4818;2360;2458
24;León;071;Folgoso de la Ribera;1153;566;587
24;León;073;Fresno de la Vega;560;277;283
24;León;074;Fuentes de Carbajal;103;56;47
24;León;076;Garrafe de Torío;1457;792;665
24;León;077;Gordaliza del Pino;272;136;136
24;León;078;Gordoncillo;473;237;236
24;León;079;Gradefes;997;528;469
24;León;080;Grajal de Campos;242;123;119
24;León;081;Gusendos de los Oteros;148;83;65
24;León;082;Hospital de Órbigo;995;491;504
24;León;083;Igüeña;1262;672;590
24;León;084;Izagre;184;98;86
24;León;086;Joarilla de las Matas;318;166;152
24;León;087;Laguna Dalga;703;377;326
24;León;088;Laguna de Negrillos;1098;567;531
24;León;089;León;127817;58100;69717
24;León;092;Llamas de la Ribera;885;465;420
24;León;090;Lucillo;413;219;194
24;León;091;Luyego;717;367;350
24;León;093;Magaz de Cepeda;396;197;199
24;León;094;Mansilla de las Mulas;1805;919;886
24;León;095;Mansilla Mayor;344;183;161
24;León;096;Maraña;138;82;56
24;León;097;Matadeón de los Oteros;254;134;120
24;León;098;Matallana de Torío;1345;706;639
24;León;099;Matanza;197;110;87
24;León;100;Molinaseca;892;487;405
24;León;101;Murias de Paredes;426;210;216
24;León;102;Noceda del Bierzo;727;362;365
24;León;103;Oencia;310;176;134
24;León;104;Omañas, Las;291;157;134
24;León;105;Onzonilla;1758;907;851
24;León;106;Oseja de Sajambre;279;168;111
24;León;107;Pajares de los Oteros;308;192;116
24;León;108;Palacios de la Valduerna;425;208;217
24;León;109;Palacios del Sil;1090;595;495
24;León;110;Páramo del Sil;1403;713;690
24;León;112;Peranzanes;327;187;140
24;León;113;Pobladura de Pelayo García;396;202;194
24;León;114;Pola de Gordón, La;3522;1749;1773
24;León;115;Ponferrada;66884;31935;34949
24;León;116;Posada de Valdeón;477;279;198
24;León;117;Pozuelo del Páramo;478;244;234
24;León;118;Prado de la Guzpeña;140;79;61
24;León;119;Priaranza del Bierzo;802;405;397
24;León;120;Prioro;376;215;161
24;León;121;Puebla de Lillo;715;398;317
24;León;122;Puente de Domingo Flórez;1574;814;760
24;León;123;Quintana del Castillo;810;440;370
24;León;124;Quintana del Marco;407;221;186
24;León;125;Quintana y Congosto;372;185;187
24;León;127;Regueras de Arriba;326;177;149
24;León;129;Reyero;125;64;61
24;León;130;Riaño;490;284;206
24;León;131;Riego de la Vega;835;435;400
24;León;132;Riello;676;378;298
24;León;133;Rioseco de Tapia;372;201;171
24;León;134;Robla, La;4302;2178;2124
24;León;136;Roperuelos del Páramo;592;300;292
24;León;137;Sabero;1246;615;631
24;León;139;Sahagún;2709;1341;1368
24;León;141;San Adrián del Valle;112;58;54
24;León;142;San Andrés del Rabanedo;31745;15270;16475
24;León;144;San Cristóbal de la Polantera;800;392;408
24;León;145;San Emiliano;694;374;320
24;León;146;San Esteban de Nogales;281;149;132
24;León;148;San Justo de la Vega;1949;1002;947
24;León;149;San Millán de los Caballeros;190;99;91
24;León;150;San Pedro Bercianos;263;137;126
24;León;143;Sancedo;569;283;286
24;León;151;Santa Colomba de Curueño;547;288;259
24;León;152;Santa Colomba de Somoza;567;298;269
24;León;153;Santa Cristina de Valmadrigal;271;140;131
24;León;154;Santa Elena de Jamuz;1135;587;548
24;León;155;Santa María de la Isla;522;271;251
24;León;158;Santa María de Ordás;340;174;166
24;León;156;Santa María del Monte de Cea;256;133;123
24;León;157;Santa María del Páramo;3128;1536;1592
24;León;159;Santa Marina del Rey;2029;1007;1022
24;León;160;Santas Martas;809;422;387
24;León;161;Santiago Millas;330;183;147
24;León;162;Santovenia de la Valdoncina;2006;1035;971
24;León;163;Sariegos;4826;2435;2391
24;León;164;Sena de Luna;402;201;201
24;León;165;Sobrado;363;179;184
24;León;166;Soto de la Vega;1641;847;794
24;León;167;Soto y Amío;853;435;418
24;León;168;Toral de los Guzmanes;533;280;253
24;León;206;Toral de los Vados;2024;993;1031
24;León;169;Toreno;3380;1691;1689
24;León;170;Torre del Bierzo;2265;1153;1112
24;León;171;Trabadelo;394;219;175
24;León;172;Truchas;454;232;222
24;León;173;Turcia;1057;540;517
24;León;174;Urdiales del Páramo;515;271;244
24;León;185;Val de San Lorenzo;542;271;271
24;León;175;Valdefresno;2149;1111;1038
24;León;176;Valdefuentes del Páramo;347;184;163
24;León;177;Valdelugueros;533;301;232
24;León;178;Valdemora;79;36;43
24;León;179;Valdepiélago;338;187;151
24;León;180;Valdepolo;1274;665;609
24;León;181;Valderas;1819;921;898
24;León;182;Valderrey;461;217;244
24;León;183;Valderrueda;923;471;452
24;León;184;Valdesamario;215;119;96
24;León;187;Valdevimbre;997;521;476
24;León;188;Valencia de Don Juan;5181;2539;2642
24;León;191;Vallecillo;124;68;56
24;León;189;Valverde de la Virgen;7435;3858;3577
24;León;190;Valverde-Enrique;175;94;81
24;León;193;Vecilla, La;408;213;195
24;León;196;Vega de Espinareda;2281;1144;1137
24;León;197;Vega de Infanzones;905;456;449
24;León;198;Vega de Valcarce;669;341;328
24;León;194;Vegacervera;314;169;145
24;León;199;Vegaquemada;465;244;221
24;León;201;Vegas del Condado;1163;655;508
24;León;202;Villablino;9509;4672;4837
24;León;203;Villabraz;113;62;51
24;León;205;Villadangos del Páramo;1103;571;532
24;León;207;Villademor de la Vega;349;186;163
24;León;209;Villafranca del Bierzo;3160;1521;1639
24;León;210;Villagatón;617;325;292
24;León;211;Villamandos;310;172;138
24;León;901;Villamanín;1029;534;495
24;León;212;Villamañán;1194;575;619
24;León;213;Villamartín de Don Sancho;164;86;78
24;León;214;Villamejil;746;392;354
24;León;215;Villamol;173;87;86
24;León;216;Villamontán de la Valduerna;804;418;386
24;León;217;Villamoratiel de las Matas;155;87;68
24;León;218;Villanueva de las Manzanas;507;264;243
24;León;219;Villaobispo de Otero;604;325;279
24;León;902;Villaornate y Castro;377;187;190
24;León;221;Villaquejida;912;458;454
24;León;222;Villaquilambre;18615;9263;9352
24;León;223;Villarejo de Órbigo;3112;1536;1576
24;León;224;Villares de Órbigo;685;360;325
24;León;225;Villasabariego;1175;622;553
24;León;226;Villaselán;210;120;90
24;León;227;Villaturiel;1947;1019;928
24;León;228;Villazala;749;399;350
24;León;229;Villazanzo de Valderaduey;475;269;206
24;León;230;Zotes del Páramo;454;257;197
25;Lleida;001;Abella de la Conca;170;93;77
25;Lleida;002;Àger;613;325;288
25;Lleida;003;Agramunt;5491;2775;2716
25;Lleida;038;Aitona;2456;1249;1207
25;Lleida;004;Alamús, Els;778;404;374
25;Lleida;005;Alàs i Cerc;356;182;174
25;Lleida;006;Albagés, L';419;222;197
25;Lleida;007;Albatàrrec;2214;1156;1058
25;Lleida;008;Albesa;1624;874;750
25;Lleida;009;Albi, L';819;426;393
25;Lleida;010;Alcanó;246;123;123
25;Lleida;011;Alcarràs;9372;4863;4509
25;Lleida;012;Alcoletge;3285;1716;1569
25;Lleida;013;Alfarràs;2976;1558;1418
25;Lleida;014;Alfés;326;164;162
25;Lleida;015;Algerri;422;229;193
25;Lleida;016;Alguaire;3002;1571;1431
25;Lleida;017;Alins;288;153;135
25;Lleida;019;Almacelles;6766;3534;3232
25;Lleida;020;Almatret;326;172;154
25;Lleida;021;Almenar;3525;1879;1646
25;Lleida;022;Alòs de Balaguer;123;69;54
25;Lleida;023;Alpicat;6275;3146;3129
25;Lleida;024;Alt Àneu;407;232;175
25;Lleida;027;Anglesola;1378;688;690
25;Lleida;029;Arbeca;2278;1156;1122
25;Lleida;031;Arres;67;42;25
25;Lleida;032;Arsèguel;79;46;33
25;Lleida;033;Artesa de Lleida;1517;793;724
25;Lleida;034;Artesa de Segre;3614;1840;1774
25;Lleida;036;Aspa;218;110;108
25;Lleida;037;Avellanes i Santa Linya, Les;473;269;204
25;Lleida;039;Baix Pallars;350;187;163
25;Lleida;040;Balaguer;16479;8323;8156
25;Lleida;041;Barbens;900;477;423
25;Lleida;042;Baronia de Rialb, La;245;128;117
25;Lleida;044;Bassella;234;117;117
25;Lleida;045;Bausen;58;32;26
25;Lleida;046;Belianes;555;274;281
25;Lleida;170;Bellaguarda;308;161;147
25;Lleida;047;Bellcaire d'Urgell;1296;659;637
25;Lleida;048;Bell-lloc d'Urgell;2329;1156;1173
25;Lleida;049;Bellmunt d'Urgell;188;93;95
25;Lleida;050;Bellpuig;4989;2590;2399
25;Lleida;051;Bellver de Cerdanya;2028;1051;977
25;Lleida;052;Bellvís;2270;1141;1129
25;Lleida;053;Benavent de Segrià;1506;780;726
25;Lleida;055;Biosca;199;104;95
25;Lleida;057;Bòrdes, Es;237;136;101
25;Lleida;058;Borges Blanques, Les;6019;3051;2968
25;Lleida;059;Bossòst;1137;555;582
25;Lleida;056;Bovera;275;152;123
25;Lleida;060;Cabanabona;82;38;44
25;Lleida;061;Cabó;94;48;46
25;Lleida;062;Camarasa;903;461;442
25;Lleida;063;Canejan;100;56;44
25;Lleida;904;Castell de Mur;188;101;87
25;Lleida;064;Castellar de la Ribera;150;76;74
25;Lleida;067;Castelldans;981;534;447
25;Lleida;068;Castellnou de Seana;736;391;345
25;Lleida;069;Castelló de Farfanya;547;294;253
25;Lleida;070;Castellserà;1044;530;514
25;Lleida;071;Cava;60;35;25
25;Lleida;072;Cervera;8956;4483;4473
25;Lleida;073;Cervià de les Garrigues;695;364;331
25;Lleida;074;Ciutadilla;217;117;100
25;Lleida;075;Clariana de Cardener;140;71;69
25;Lleida;076;Cogul, El;181;97;84
25;Lleida;077;Coll de Nargó;575;293;282
25;Lleida;163;Coma i la Pedra, La;270;165;105
25;Lleida;161;Conca de Dalt;446;233;213
25;Lleida;078;Corbins;1394;744;650
25;Lleida;079;Cubells;378;200;178
25;Lleida;081;Espluga Calba, L';387;192;195
25;Lleida;082;Espot;362;196;166
25;Lleida;088;Estamariu;124;71;53
25;Lleida;085;Estaràs;176;95;81
25;Lleida;086;Esterri d'Àneu;804;386;418
25;Lleida;087;Esterri de Cardós;73;35;38
25;Lleida;089;Farrera;118;69;49
25;Lleida;908;Fígols i Alinyà;261;147;114
25;Lleida;092;Floresta, La;160;89;71
25;Lleida;093;Fondarella;831;413;418
25;Lleida;094;Foradada;174;99;75
25;Lleida;096;Fuliola, La;1291;653;638
25;Lleida;097;Fulleda;94;47;47
25;Lleida;098;Gavet de la Conca;287;142;145
25;Lleida;912;Gimenells i el Pla de la Font;1151;589;562
25;Lleida;099;Golmés;1770;882;888
25;Lleida;100;Gósol;226;131;95
25;Lleida;101;Granadella, La;712;369;343
25;Lleida;102;Granja d'Escarp, La;1001;528;473
25;Lleida;103;Granyanella;146;81;65
25;Lleida;105;Granyena de les Garrigues;161;96;65
25;Lleida;104;Granyena de Segarra;139;70;69
25;Lleida;109;Guimerà;277;152;125
25;Lleida;903;Guingueta d'Àneu, La;315;169;146
25;Lleida;110;Guissona;6862;3637;3225
25;Lleida;111;Guixers;142;89;53
25;Lleida;115;Isona i Conca Dellà;1064;558;506
25;Lleida;112;Ivars de Noguera;346;177;169
25;Lleida;113;Ivars d'Urgell;1591;831;760
25;Lleida;114;Ivorra;106;55;51
25;Lleida;910;Josa i Tuixén;129;74;55
25;Lleida;118;Juncosa;421;230;191
25;Lleida;119;Juneda;3384;1757;1627
25;Lleida;121;Les;953;476;477
25;Lleida;122;Linyola;2652;1339;1313
25;Lleida;123;Lladorre;229;111;118
25;Lleida;124;Lladurs;193;103;90
25;Lleida;125;Llardecans;491;253;238
25;Lleida;126;Llavorsí;354;179;175
25;Lleida;120;Lleida;138542;68412;70130
25;Lleida;127;Lles de Cerdanya;257;148;109
25;Lleida;128;Llimiana;158;91;67
25;Lleida;129;Llobera;202;109;93
25;Lleida;133;Maials;941;500;441
25;Lleida;130;Maldà;228;117;111
25;Lleida;131;Massalcoreig;564;301;263
25;Lleida;132;Massoteres;189;105;84
25;Lleida;134;Menàrguens;849;471;378
25;Lleida;135;Miralcamp;1390;695;695
25;Lleida;137;Mollerussa;14900;7612;7288
25;Lleida;136;Molsosa, La;113;56;57
25;Lleida;139;Montellà i Martinet;586;320;266
25;Lleida;140;Montferrer i Castellbò;1010;546;464
25;Lleida;138;Montgai;663;347;316
25;Lleida;142;Montoliu de Lleida;514;260;254
25;Lleida;141;Montoliu de Segarra;194;107;87
25;Lleida;143;Montornès de Segarra;101;50;51
25;Lleida;145;Nalec;95;49;46
25;Lleida;025;Naut Aran;1760;890;870
25;Lleida;146;Navès;281;136;145
25;Lleida;148;Odèn;253;145;108
25;Lleida;149;Oliana;1842;923;919
25;Lleida;150;Oliola;233;128;105
25;Lleida;151;Olius;910;475;435
25;Lleida;152;Oluges, Les;161;85;76
25;Lleida;153;Omellons, Els;226;118;108
25;Lleida;154;Omells de na Gaia, Els;136;73;63
25;Lleida;155;Organyà;845;418;427
25;Lleida;156;Os de Balaguer;995;501;494
25;Lleida;157;Ossó de Sió;213;109;104
25;Lleida;158;Palau d'Anglesola, El;2136;1051;1085
25;Lleida;164;Penelles;482;277;205
25;Lleida;165;Peramola;343;175;168
25;Lleida;166;Pinell de Solsonès;207;119;88
25;Lleida;167;Pinós;305;167;138
25;Lleida;911;Plans de Sió, Els;528;281;247
25;Lleida;168;Poal, El;668;348;320
25;Lleida;169;Pobla de Cérvoles, La;222;124;98
25;Lleida;171;Pobla de Segur, La;3016;1499;1517
25;Lleida;030;Pont de Bar, El;159;88;71
25;Lleida;173;Pont de Suert, El;2314;1167;1147
25;Lleida;172;Ponts;2632;1305;1327
25;Lleida;174;Portella, La;731;398;333
25;Lleida;175;Prats i Sansor;251;131;120
25;Lleida;176;Preixana;407;204;203
25;Lleida;177;Preixens;458;234;224
25;Lleida;179;Prullans;206;105;101
25;Lleida;180;Puiggròs;295;153;142
25;Lleida;181;Puigverd d'Agramunt;244;140;104
25;Lleida;182;Puigverd de Lleida;1405;725;680
25;Lleida;183;Rialp;655;340;315
25;Lleida;905;Ribera d'Ondara;429;225;204
25;Lleida;185;Ribera d'Urgellet;978;514;464
25;Lleida;186;Riner;267;131;136
25;Lleida;913;Riu de Cerdanya;104;60;44
25;Lleida;189;Rosselló;3043;1538;1505
25;Lleida;190;Salàs de Pallars;359;193;166
25;Lleida;191;Sanaüja;427;219;208
25;Lleida;196;Sant Esteve de la Sarga;144;89;55
25;Lleida;192;Sant Guim de Freixenet;1078;557;521
25;Lleida;197;Sant Guim de la Plana;174;94;80
25;Lleida;193;Sant Llorenç de Morunys;977;478;499
25;Lleida;902;Sant Martí de Riucorb;689;368;321
25;Lleida;194;Sant Ramon;506;273;233
25;Lleida;201;Sarroca de Bellera;125;79;46
25;Lleida;200;Sarroca de Lleida;387;213;174
25;Lleida;202;Senterada;133;80;53
25;Lleida;035;Sentiu de Sió, La;459;234;225
25;Lleida;204;Seròs;1886;1025;861
25;Lleida;203;Seu d'Urgell, La;12249;5896;6353
25;Lleida;205;Sidamon;732;379;353
25;Lleida;206;Soleràs, El;342;176;166
25;Lleida;207;Solsona;9004;4505;4499
25;Lleida;208;Soriguera;385;206;179
25;Lleida;209;Sort;2199;1089;1110
25;Lleida;210;Soses;1728;899;829
25;Lleida;211;Sudanell;847;473;374
25;Lleida;212;Sunyer;325;180;145
25;Lleida;215;Talarn;582;363;219
25;Lleida;216;Talavera;262;146;116
25;Lleida;217;Tàrrega;16444;8152;8292
25;Lleida;218;Tarrés;103;57;46
25;Lleida;219;Tarroja de Segarra;178;91;87
25;Lleida;220;Térmens;1531;767;764
25;Lleida;221;Tírvia;153;76;77
25;Lleida;222;Tiurana;72;35;37
25;Lleida;223;Torà;1232;613;619
25;Lleida;224;Torms, Els;147;82;65
25;Lleida;225;Tornabous;885;467;418
25;Lleida;227;Torre de Cabdella, La;762;390;372
25;Lleida;226;Torrebesses;286;151;135
25;Lleida;228;Torrefarrera;4611;2333;2278
25;Lleida;907;Torrefeta i Florejacs;604;319;285
25;Lleida;230;Torregrossa;2255;1143;1112
25;Lleida;231;Torrelameu;706;400;306
25;Lleida;232;Torres de Segre;2271;1172;1099
25;Lleida;233;Torre-serona;379;190;189
25;Lleida;234;Tremp;6175;3062;3113
25;Lleida;043;Vall de Boí, La;1004;532;472
25;Lleida;901;Vall de Cardós;368;196;172
25;Lleida;238;Vallbona de les Monges;256;136;120
25;Lleida;240;Vallfogona de Balaguer;1880;925;955
25;Lleida;906;Valls d'Aguilar, Les;302;164;138
25;Lleida;239;Valls de Valira, Les;845;428;417
25;Lleida;909;Vansa i Fórnols, La;210;111;99
25;Lleida;242;Verdú;947;452;495
25;Lleida;243;Vielha e Mijaran;5450;2767;2683
25;Lleida;244;Vilagrassa;522;270;252
25;Lleida;245;Vilaller;566;303;263
25;Lleida;247;Vilamòs;164;92;72
25;Lleida;248;Vilanova de Bellpuig;1175;604;571
25;Lleida;254;Vilanova de la Barca;1099;546;553
25;Lleida;249;Vilanova de l'Aguda;218;108;110
25;Lleida;250;Vilanova de Meià;424;233;191
25;Lleida;251;Vilanova de Segrià;940;497;443
25;Lleida;252;Vila-sana;718;359;359
25;Lleida;253;Vilosell, El;187;91;96
25;Lleida;255;Vinaixa;526;268;258
27;Lugo;001;Abadín;2612;1280;1332
27;Lugo;002;Alfoz;1846;894;952
27;Lugo;003;Antas de Ulla;2109;1041;1068
27;Lugo;004;Baleira;1380;729;651
27;Lugo;901;Baralla;2724;1408;1316
27;Lugo;005;Barreiros;3021;1442;1579
27;Lugo;006;Becerreá;2987;1494;1493
27;Lugo;007;Begonte;3160;1580;1580
27;Lugo;008;Bóveda;1545;777;768
27;Lugo;902;Burela;9580;4752;4828
27;Lugo;009;Carballedo;2351;1177;1174
27;Lugo;010;Castro de Rei;5153;2521;2632
27;Lugo;011;Castroverde;2802;1444;1358
27;Lugo;012;Cervantes;1487;845;642
27;Lugo;013;Cervo;4336;2134;2202
27;Lugo;016;Chantada;8493;4120;4373
27;Lugo;014;Corgo, O;3646;1853;1793
27;Lugo;015;Cospeito;4827;2344;2483
27;Lugo;017;Folgoso do Courel;1089;569;520
27;Lugo;018;Fonsagrada, A;3838;2000;1838
27;Lugo;019;Foz;9891;4818;5073
27;Lugo;020;Friol;3942;1981;1961
27;Lugo;022;Guitiriz;5520;2755;2765
27;Lugo;023;Guntín;2881;1470;1411
27;Lugo;024;Incio, O;1777;885;892
27;Lugo;026;Láncara;2764;1398;1366
27;Lugo;027;Lourenzá;2301;1109;1192
27;Lugo;028;Lugo;98134;45630;52504
27;Lugo;029;Meira;1749;885;864
27;Lugo;030;Mondoñedo;3876;1813;2063
27;Lugo;031;Monforte de Lemos;19061;9021;10040
27;Lugo;032;Monterroso;3778;1880;1898
27;Lugo;033;Muras;684;350;334
27;Lugo;034;Navia de Suarna;1211;678;533
27;Lugo;035;Negueira de Muñiz;214;112;102
27;Lugo;037;Nogais, As;1191;629;562
27;Lugo;038;Ourol;1055;522;533
27;Lugo;039;Outeiro de Rei;5068;2600;2468
27;Lugo;040;Palas de Rei;3588;1783;1805
27;Lugo;041;Pantón;2674;1278;1396
27;Lugo;042;Paradela;1934;962;972
27;Lugo;043;Páramo, O;1474;741;733
27;Lugo;044;Pastoriza, A;3274;1636;1638
27;Lugo;045;Pedrafita do Cebreiro;1119;599;520
27;Lugo;047;Pobra do Brollón, A;1794;887;907
27;Lugo;046;Pol;1732;844;888
27;Lugo;048;Pontenova, A;2470;1196;1274
27;Lugo;049;Portomarín;1557;797;760
27;Lugo;050;Quiroga;3424;1650;1774
27;Lugo;056;Rábade;1549;780;769
27;Lugo;051;Ribadeo;9929;4751;5178
27;Lugo;052;Ribas de Sil;1001;512;489
27;Lugo;053;Ribeira de Piquín;580;291;289
27;Lugo;054;Riotorto;1364;672;692
27;Lugo;055;Samos;1425;756;669
27;Lugo;057;Sarria;13393;6555;6838
27;Lugo;058;Saviñao, O;4056;2041;2015
27;Lugo;059;Sober;2400;1180;1220
27;Lugo;060;Taboada;3032;1454;1578
27;Lugo;061;Trabada;1178;567;611
27;Lugo;062;Triacastela;699;351;348
27;Lugo;063;Valadouro, O;2048;995;1053
27;Lugo;064;Vicedo, O;1820;898;922
27;Lugo;065;Vilalba;14645;7131;7514
27;Lugo;066;Viveiro;15735;7696;8039
27;Lugo;021;Xermade;1985;966;1019
27;Lugo;025;Xove;3424;1696;1728
28;Madrid;001;Acebeda, La;65;36;29
28;Madrid;002;Ajalvir;4343;2276;2067
28;Madrid;003;Alameda del Valle;217;126;91
28;Madrid;004;Álamo, El;8965;4451;4514
28;Madrid;005;Alcalá de Henares;198750;97913;100837
28;Madrid;006;Alcobendas;113055;54547;58508
28;Madrid;007;Alcorcón;167136;81069;86067
28;Madrid;008;Aldea del Fresno;2535;1352;1183
28;Madrid;009;Algete;20148;9946;10202
28;Madrid;010;Alpedrete;14248;7048;7200
28;Madrid;011;Ambite;618;315;303
28;Madrid;012;Anchuelo;1200;625;575
28;Madrid;013;Aranjuez;58168;28340;29828
28;Madrid;014;Arganda del Rey;54533;27575;26958
28;Madrid;015;Arroyomolinos;26846;13525;13321
28;Madrid;016;Atazar, El;96;52;44
28;Madrid;017;Batres;1568;798;770
28;Madrid;018;Becerril de la Sierra;5396;2668;2728
28;Madrid;019;Belmonte de Tajo;1625;848;777
28;Madrid;021;Berrueco, El;618;319;299
28;Madrid;020;Berzosa del Lozoya;202;118;84
28;Madrid;022;Boadilla del Monte;48775;23859;24916
28;Madrid;023;Boalo, El;7157;3658;3499
28;Madrid;024;Braojos;203;115;88
28;Madrid;025;Brea de Tajo;560;326;234
28;Madrid;026;Brunete;10398;5138;5260
28;Madrid;027;Buitrago del Lozoya;1865;908;957
28;Madrid;028;Bustarviejo;2367;1199;1168
28;Madrid;029;Cabanillas de la Sierra;733;387;346
28;Madrid;030;Cabrera, La;2574;1270;1304
28;Madrid;031;Cadalso de los Vidrios;2767;1435;1332
28;Madrid;032;Camarma de Esteruelas;7134;3629;3505
28;Madrid;033;Campo Real;5854;2994;2860
28;Madrid;034;Canencia;464;248;216
28;Madrid;035;Carabaña;2017;1002;1015
28;Madrid;036;Casarrubuelos;3548;1806;1742
28;Madrid;037;Cenicientos;2035;1003;1032
28;Madrid;038;Cercedilla;6781;3332;3449
28;Madrid;039;Cervera de Buitrago;164;97;67
28;Madrid;051;Chapinería;2158;1111;1047
28;Madrid;052;Chinchón;5436;2768;2668
28;Madrid;040;Ciempozuelos;23696;11953;11743
28;Madrid;041;Cobeña;6983;3450;3533
28;Madrid;046;Collado Mediano;6599;3301;3298
28;Madrid;047;Collado Villalba;62056;30325;31731
28;Madrid;043;Colmenar de Oreja;8071;4097;3974
28;Madrid;042;Colmenar del Arroyo;1611;829;782
28;Madrid;045;Colmenar Viejo;47601;23546;24055
28;Madrid;044;Colmenarejo;8934;4420;4514
28;Madrid;048;Corpa;669;348;321
28;Madrid;049;Coslada;86919;42947;43972
28;Madrid;050;Cubas de la Sagra;5875;2904;2971
28;Madrid;053;Daganzo de Arriba;9919;4970;4949
28;Madrid;054;Escorial, El;15342;7577;7765
28;Madrid;055;Estremera;1350;703;647
28;Madrid;056;Fresnedillas de la Oliva;1554;803;751
28;Madrid;057;Fresno de Torote;2041;1080;961
28;Madrid;058;Fuenlabrada;195180;96951;98229
28;Madrid;059;Fuente el Saz de Jarama;6440;3273;3167
28;Madrid;060;Fuentidueña de Tajo;1954;971;983
28;Madrid;061;Galapagar;32294;15953;16341
28;Madrid;062;Garganta de los Montes;367;193;174
28;Madrid;063;Gargantilla del Lozoya y Pinilla de Buitrago;351;186;165
28;Madrid;064;Gascones;176;104;72
28;Madrid;065;Getafe;174921;85919;89002
28;Madrid;066;Griñón;9918;4936;4982
28;Madrid;067;Guadalix de la Sierra;6039;3034;3005
28;Madrid;068;Guadarrama;15538;7688;7850
28;Madrid;069;Hiruela, La;54;37;17
28;Madrid;070;Horcajo de la Sierra-Aoslos;159;90;69
28;Madrid;071;Horcajuelo de la Sierra;88;44;44
28;Madrid;072;Hoyo de Manzanares;7880;3979;3901
28;Madrid;073;Humanes de Madrid;19413;9809;9604
28;Madrid;074;Leganés;186907;91179;95728
28;Madrid;075;Loeches;8212;4123;4089
28;Madrid;076;Lozoya;594;311;283
28;Madrid;901;Lozoyuela-Navas-Sieteiglesias;1203;623;580
28;Madrid;078;Madarcos;45;28;17
28;Madrid;079;Madrid;3141991;1460597;1681394
28;Madrid;080;Majadahonda;70800;33702;37098
28;Madrid;082;Manzanares el Real;8309;4214;4095
28;Madrid;083;Meco;13269;6674;6595
28;Madrid;084;Mejorada del Campo;22902;11454;11448
28;Madrid;085;Miraflores de la Sierra;5807;2990;2817
28;Madrid;086;Molar, El;8036;4063;3973
28;Madrid;087;Molinos, Los;4349;2160;2189
28;Madrid;088;Montejo de la Sierra;374;191;183
28;Madrid;089;Moraleja de Enmedio;5046;2524;2522
28;Madrid;090;Moralzarzal;12213;6128;6085
28;Madrid;091;Morata de Tajuña;7453;3707;3746
28;Madrid;092;Móstoles;206263;101155;105108
28;Madrid;093;Navacerrada;2855;1423;1432
28;Madrid;094;Navalafuente;1201;620;581
28;Madrid;095;Navalagamella;2462;1272;1190
28;Madrid;096;Navalcarnero;26672;13307;13365
28;Madrid;097;Navarredonda y San Mamés;136;84;52
28;Madrid;099;Navas del Rey;2628;1394;1234
28;Madrid;100;Nuevo Baztán;6098;3100;2998
28;Madrid;101;Olmeda de las Fuentes;338;176;162
28;Madrid;102;Orusco de Tajuña;1260;632;628
28;Madrid;104;Paracuellos de Jarama;22293;11353;10940
28;Madrid;106;Parla;125056;62686;62370
28;Madrid;107;Patones;524;259;265
28;Madrid;108;Pedrezuela;5271;2652;2619
28;Madrid;109;Pelayos de la Presa;2455;1229;1226
28;Madrid;110;Perales de Tajuña;2871;1441;1430
28;Madrid;111;Pezuela de las Torres;783;407;376
28;Madrid;112;Pinilla del Valle;200;113;87
28;Madrid;113;Pinto;48660;24224;24436
28;Madrid;114;Piñuécar-Gandullas;175;97;78
28;Madrid;115;Pozuelo de Alarcón;84558;40498;44060
28;Madrid;116;Pozuelo del Rey;1071;562;509
28;Madrid;117;Prádena del Rincón;122;74;48
28;Madrid;118;Puebla de la Sierra;73;48;25
28;Madrid;902;Puentes Viejas;644;361;283
28;Madrid;119;Quijorna;3196;1620;1576
28;Madrid;120;Rascafría;1739;948;791
28;Madrid;121;Redueña;259;137;122
28;Madrid;122;Ribatejada;707;344;363
28;Madrid;123;Rivas-Vaciamadrid;81473;40686;40787
28;Madrid;124;Robledillo de la Jara;100;51;49
28;Madrid;125;Robledo de Chavela;3955;2075;1880
28;Madrid;126;Robregordo;48;28;20
28;Madrid;127;Rozas de Madrid, Las;93520;45322;48198
28;Madrid;128;Rozas de Puerto Real;523;304;219
28;Madrid;129;San Agustín del Guadalix;12982;6393;6589
28;Madrid;130;San Fernando de Henares;40188;19758;20430
28;Madrid;131;San Lorenzo de El Escorial;18191;8691;9500
28;Madrid;132;San Martín de la Vega;18835;9710;9125
28;Madrid;133;San Martín de Valdeiglesias;8463;4233;4230
28;Madrid;134;San Sebastián de los Reyes;84944;41593;43351
28;Madrid;135;Santa María de la Alameda;1199;632;567
28;Madrid;136;Santorcaz;849;438;411
28;Madrid;137;Santos de la Humosa, Los;2389;1216;1173
28;Madrid;138;Serna del Monte, La;86;44;42
28;Madrid;140;Serranillos del Valle;3994;1970;2024
28;Madrid;141;Sevilla la Nueva;8902;4406;4496
28;Madrid;143;Somosierra;73;41;32
28;Madrid;144;Soto del Real;8456;4147;4309
28;Madrid;145;Talamanca de Jarama;3371;1700;1671
28;Madrid;146;Tielmes;2585;1328;1257
28;Madrid;147;Titulcia;1234;637;597
28;Madrid;148;Torrejón de Ardoz;126934;62982;63952
28;Madrid;149;Torrejón de la Calzada;7901;3923;3978
28;Madrid;150;Torrejón de Velasco;4224;2125;2099
28;Madrid;151;Torrelaguna;4788;2458;2330
28;Madrid;152;Torrelodones;23117;11154;11963
28;Madrid;153;Torremocha de Jarama;948;464;484
28;Madrid;154;Torres de la Alameda;7877;4028;3849
28;Madrid;903;Tres Cantos;43309;20957;22352
28;Madrid;155;Valdaracete;639;323;316
28;Madrid;156;Valdeavero;1451;754;697
28;Madrid;157;Valdelaguna;837;424;413
28;Madrid;158;Valdemanco;922;495;427
28;Madrid;159;Valdemaqueda;786;387;399
28;Madrid;160;Valdemorillo;12173;6241;5932
28;Madrid;161;Valdemoro;72854;36268;36586
28;Madrid;162;Valdeolmos-Alalpardo;3785;1932;1853
28;Madrid;163;Valdepiélagos;566;294;272
28;Madrid;164;Valdetorres de Jarama;4234;2138;2096
28;Madrid;165;Valdilecha;2838;1469;1369
28;Madrid;166;Valverde de Alcalá;441;235;206
28;Madrid;167;Velilla de San Antonio;12382;6271;6111
28;Madrid;168;Vellón, El;1803;932;871
28;Madrid;169;Venturada;1991;1058;933
28;Madrid;171;Villa del Prado;6414;3283;3131
28;Madrid;170;Villaconejos;3405;1723;1682
28;Madrid;172;Villalbilla;12351;6259;6092
28;Madrid;173;Villamanrique de Tajo;720;370;350
28;Madrid;174;Villamanta;2525;1276;1249
28;Madrid;175;Villamantilla;1292;636;656
28;Madrid;176;Villanueva de la Cañada;19250;9373;9877
28;Madrid;178;Villanueva de Perales;1441;737;704
28;Madrid;177;Villanueva del Pardillo;16797;8260;8537
28;Madrid;179;Villar del Olmo;2058;1063;995
28;Madrid;180;Villarejo de Salvanés;7288;3668;3620
28;Madrid;181;Villaviciosa de Odón;27075;13163;13912
28;Madrid;182;Villavieja del Lozoya;280;150;130
28;Madrid;183;Zarzalejo;1546;810;736
29;Málaga;001;Alameda;5403;2731;2672
29;Málaga;002;Alcaucín;2375;1193;1182
29;Málaga;003;Alfarnate;1159;590;569
29;Málaga;004;Alfarnatejo;463;237;226
29;Málaga;005;Algarrobo;6013;3035;2978
29;Málaga;006;Algatocín;834;432;402
29;Málaga;007;Alhaurín de la Torre;38523;19162;19361
29;Málaga;008;Alhaurín el Grande;24338;12167;12171
29;Málaga;009;Almáchar;1867;962;905
29;Málaga;010;Almargen;2081;1070;1011
29;Málaga;011;Almogía;3826;1968;1858
29;Málaga;012;Álora;13003;6540;6463
29;Málaga;013;Alozaina;2082;1051;1031
29;Málaga;014;Alpandeire;257;132;125
29;Málaga;015;Antequera;41141;20224;20917
29;Málaga;016;Árchez;436;226;210
29;Málaga;017;Archidona;8490;4278;4212
29;Málaga;018;Ardales;2527;1276;1251
29;Málaga;019;Arenas;1219;640;579
29;Málaga;020;Arriate;4157;2049;2108
29;Málaga;021;Atajate;158;83;75
29;Málaga;022;Benadalid;253;124;129
29;Málaga;023;Benahavís;7105;3555;3550
29;Málaga;024;Benalauría;470;255;215
29;Málaga;025;Benalmádena;66598;32976;33622
29;Málaga;026;Benamargosa;1568;808;760
29;Málaga;027;Benamocarra;3047;1541;1506
29;Málaga;028;Benaoján;1513;787;726
29;Málaga;029;Benarrabá;521;258;263
29;Málaga;030;Borge, El;963;499;464
29;Málaga;031;Burgo, El;1929;973;956
29;Málaga;032;Campillos;8524;4265;4259
29;Málaga;033;Canillas de Aceituno;1737;911;826
29;Málaga;034;Canillas de Albaida;842;426;416
29;Málaga;035;Cañete la Real;1738;885;853
29;Málaga;036;Carratraca;775;395;380
29;Málaga;037;Cartajima;247;129;118
29;Málaga;038;Cártama;24592;12497;12095
29;Málaga;039;Casabermeja;3418;1815;1603
29;Málaga;040;Casarabonela;2599;1363;1236
29;Málaga;041;Casares;5954;3069;2885
29;Málaga;042;Coín;21561;10868;10693
29;Málaga;043;Colmenar;3444;1765;1679
29;Málaga;044;Comares;1385;751;634
29;Málaga;045;Cómpeta;3503;1759;1744
29;Málaga;046;Cortes de la Frontera;3304;1694;1610
29;Málaga;047;Cuevas Bajas;1431;699;732
29;Málaga;049;Cuevas de San Marcos;3884;1951;1933
29;Málaga;048;Cuevas del Becerro;1643;816;827
29;Málaga;050;Cútar;605;308;297
29;Málaga;051;Estepona;67080;33234;33846
29;Málaga;052;Faraján;265;130;135
29;Málaga;053;Frigiliana;3065;1557;1508
29;Málaga;054;Fuengirola;77525;37983;39542
29;Málaga;055;Fuente de Piedra;2613;1345;1268
29;Málaga;056;Gaucín;1670;884;786
29;Málaga;057;Genalguacil;456;233;223
29;Málaga;058;Guaro;2060;1044;1016
29;Málaga;059;Humilladero;3364;1697;1667
29;Málaga;060;Igualeja;816;415;401
29;Málaga;061;Istán;1388;696;692
29;Málaga;062;Iznate;899;461;438
29;Málaga;063;Jimera de Líbar;415;216;199
29;Málaga;064;Jubrique;638;319;319
29;Málaga;065;Júzcar;238;138;100
29;Málaga;066;Macharaviaya;477;257;220
29;Málaga;067;Málaga;569130;273817;295313
29;Málaga;068;Manilva;14587;7524;7063
29;Málaga;069;Marbella;139537;67535;72002
29;Málaga;070;Mijas;79483;39913;39570
29;Málaga;071;Moclinejo;1255;653;602
29;Málaga;072;Mollina;4901;2461;2440
29;Málaga;073;Monda;2382;1208;1174
29;Málaga;074;Montejaque;984;485;499
29;Málaga;075;Nerja;21185;10446;10739
29;Málaga;076;Ojén;3353;1712;1641
29;Málaga;077;Parauta;249;116;133
29;Málaga;079;Periana;3231;1690;1541
29;Málaga;080;Pizarra;9148;4626;4522
29;Málaga;081;Pujerra;294;155;139
29;Málaga;082;Rincón de la Victoria;43135;21192;21943
29;Málaga;083;Riogordo;2936;1539;1397
29;Málaga;084;Ronda;35676;17421;18255
29;Málaga;085;Salares;207;105;102
29;Málaga;086;Sayalonga;1505;770;735
29;Málaga;087;Sedella;692;389;303
29;Málaga;088;Sierra de Yeguas;3398;1713;1685
29;Málaga;089;Teba;3973;2002;1971
29;Málaga;090;Tolox;2186;1108;1078
29;Málaga;901;Torremolinos;67492;33717;33775
29;Málaga;091;Torrox;15117;7684;7433
29;Málaga;092;Totalán;710;373;337
29;Málaga;093;Valle de Abdalajís;2615;1323;1292
29;Málaga;094;Vélez-Málaga;78166;38769;39397
29;Málaga;095;Villanueva de Algaidas;4337;2219;2118
29;Málaga;902;Villanueva de la Concepción;3341;1631;1710
29;Málaga;098;Villanueva de Tapia;1544;779;765
29;Málaga;096;Villanueva del Rosario;3508;1715;1793
29;Málaga;097;Villanueva del Trabuco;5246;2615;2631
29;Málaga;099;Viñuela;2013;1046;967
29;Málaga;100;Yunquera;2983;1519;1464
52;Melilla;001;Melilla;85584;43593;41991
30;Murcia;001;Abanilla;6347;3209;3138
30;Murcia;002;Abarán;13179;6630;6549
30;Murcia;003;Águilas;34772;17376;17396
30;Murcia;004;Albudeite;1374;689;685
30;Murcia;005;Alcantarilla;41021;20239;20782
30;Murcia;902;Alcázares, Los;15605;7930;7675
30;Murcia;006;Aledo;984;491;493
30;Murcia;007;Alguazas;9544;4956;4588
30;Murcia;008;Alhama de Murcia;21351;10822;10529
30;Murcia;009;Archena;18559;9630;8929
30;Murcia;010;Beniel;11096;5670;5426
30;Murcia;011;Blanca;6521;3320;3201
30;Murcia;012;Bullas;11753;5922;5831
30;Murcia;013;Calasparra;10423;5279;5144
30;Murcia;014;Campos del Río;2083;996;1087
30;Murcia;015;Caravaca de la Cruz;25851;12937;12914
30;Murcia;016;Cartagena;216301;108358;107943
30;Murcia;017;Cehegín;15794;7954;7840
30;Murcia;018;Ceutí;11227;5655;5572
30;Murcia;019;Cieza;35115;17658;17457
30;Murcia;020;Fortuna;9814;5244;4570
30;Murcia;021;Fuente Álamo de Murcia;16284;8498;7786
30;Murcia;022;Jumilla;25484;13181;12303
30;Murcia;023;Librilla;5016;2571;2445
30;Murcia;024;Lorca;91714;46986;44728
30;Murcia;025;Lorquí;7020;3555;3465
30;Murcia;026;Mazarrón;32150;16627;15523
30;Murcia;027;Molina de Segura;69331;34617;34714
30;Murcia;028;Moratalla;8189;4165;4024
30;Murcia;029;Mula;16805;8599;8206
30;Murcia;030;Murcia;439889;215177;224712
30;Murcia;031;Ojós;504;270;234
30;Murcia;032;Pliego;3973;2050;1923
30;Murcia;033;Puerto Lumbreras;14694;7357;7337
30;Murcia;034;Ricote;1369;718;651
30;Murcia;035;San Javier;31915;16167;15748
30;Murcia;036;San Pedro del Pinatar;24339;12293;12046
30;Murcia;901;Santomera;16012;8157;7855
30;Murcia;037;Torre-Pacheco;34469;17975;16494
30;Murcia;038;Torres de Cotillas, Las;21399;10854;10545
30;Murcia;039;Totana;30916;15924;14992
30;Murcia;040;Ulea;906;471;435
30;Murcia;041;Unión, La;19572;9916;9656
30;Murcia;042;Villanueva del Río Segura;2524;1270;1254
30;Murcia;043;Yecla;34100;17071;17029
31;Navarra;001;Abáigar;97;49;48
31;Navarra;002;Abárzuza/Abartzuza;556;276;280
31;Navarra;003;Abaurregaina/Abaurrea Alta;127;79;48
31;Navarra;004;Abaurrepea/Abaurrea Baja;35;22;13
31;Navarra;005;Aberin;376;204;172
31;Navarra;006;Ablitas;2520;1288;1232
31;Navarra;007;Adiós;170;91;79
31;Navarra;008;Aguilar de Codés;83;44;39
31;Navarra;009;Aibar/Oibar;832;449;383
31;Navarra;011;Allín/Allin;848;455;393
31;Navarra;012;Allo;1012;511;501
31;Navarra;010;Altsasu/Alsasua;7490;3785;3705
31;Navarra;013;Améscoa Baja;774;410;364
31;Navarra;014;Ancín/Antzin;376;210;166
31;Navarra;015;Andosilla;2753;1402;1351
31;Navarra;016;Ansoáin/Antsoain;10830;5364;5466
31;Navarra;017;Anue;464;256;208
31;Navarra;018;Añorbe;539;295;244
31;Navarra;019;Aoiz/Agoitz;2601;1301;1300
31;Navarra;020;Araitz;522;294;228
31;Navarra;025;Arakil;955;494;461
31;Navarra;021;Aranarache/Aranaratxe;73;42;31
31;Navarra;023;Aranguren;9398;4729;4669
31;Navarra;024;Arano;108;60;48
31;Navarra;022;Arantza;638;343;295
31;Navarra;026;Aras;172;94;78
31;Navarra;027;Arbizu;1111;571;540
31;Navarra;028;Arce/Artzi;264;140;124
31;Navarra;029;Arcos, Los;1136;560;576
31;Navarra;030;Arellano;164;90;74
31;Navarra;031;Areso;260;136;124
31;Navarra;032;Arguedas;2295;1174;1121
31;Navarra;033;Aria;52;31;21
31;Navarra;034;Aribe;44;23;21
31;Navarra;035;Armañanzas;68;40;28
31;Navarra;036;Arróniz;1068;563;505
31;Navarra;037;Arruazu;108;56;52
31;Navarra;038;Artajona;1680;862;818
31;Navarra;039;Artazu;112;57;55
31;Navarra;040;Atez/Atetz;232;132;100
31;Navarra;058;Auritz/Burguete;262;131;131
31;Navarra;041;Ayegui/Aiegi;2217;1166;1051
31;Navarra;042;Azagra;3804;1951;1853
31;Navarra;043;Azuelo;37;15;22
31;Navarra;044;Bakaiku;339;178;161
31;Navarra;901;Barañain;20475;9938;10537
31;Navarra;045;Barásoain;665;351;314
31;Navarra;046;Barbarin;67;31;36
31;Navarra;047;Bargota;292;143;149
31;Navarra;048;Barillas;203;108;95
31;Navarra;049;Basaburua;859;488;371
31;Navarra;050;Baztan;7792;3925;3867
31;Navarra;137;Beintza-Labaien;231;132;99
31;Navarra;051;Beire;296;154;142
31;Navarra;052;Belascoáin;117;61;56
31;Navarra;250;Bera;3768;1885;1883
31;Navarra;053;Berbinzana;633;331;302
31;Navarra;905;Beriáin;3889;1903;1986
31;Navarra;902;Berrioplano/Berriobeiti;6527;3320;3207
31;Navarra;903;Berriozar;9625;4896;4729
31;Navarra;054;Bertizarana;590;294;296
31;Navarra;055;Betelu;347;184;163
31;Navarra;253;Bidaurreta;160;89;71
31;Navarra;056;Biurrun-Olcoz;219;127;92
31;Navarra;057;Buñuel;2271;1109;1162
31;Navarra;059;Burgui/Burgi;223;127;96
31;Navarra;060;Burlada/Burlata;18336;8896;9440
31;Navarra;061;Busto, El;71;36;35
31;Navarra;062;Cabanillas;1414;737;677
31;Navarra;063;Cabredo;104;58;46
31;Navarra;064;Cadreita;2082;1101;981
31;Navarra;065;Caparroso;2773;1426;1347
31;Navarra;066;Cárcar;1054;534;520
31;Navarra;067;Carcastillo;2466;1261;1205
31;Navarra;068;Cascante;3787;1868;1919
31;Navarra;069;Cáseda;989;484;505
31;Navarra;070;Castejón;4062;2011;2051
31;Navarra;071;Castillonuevo;16;12;4
31;Navarra;193;Cendea de Olza/Oltza Zendea;1822;913;909
31;Navarra;072;Cintruénigo;7779;3979;3800
31;Navarra;074;Cirauqui/Zirauki;483;263;220
31;Navarra;075;Ciriza/Ziritza;131;60;71
31;Navarra;076;Cizur;3751;1917;1834
31;Navarra;077;Corella;7740;3970;3770
31;Navarra;078;Cortes;3192;1616;1576
31;Navarra;079;Desojo;81;45;36
31;Navarra;080;Dicastillo;637;336;301
31;Navarra;081;Donamaria;443;222;221
31;Navarra;221;Doneztebe/Santesteban;1658;846;812
31;Navarra;083;Echarri;78;40;38
31;Navarra;087;Elgorriaga;219;104;115
31;Navarra;089;Enériz/Eneritz;322;160;162
31;Navarra;090;Eratsun;150;91;59
31;Navarra;091;Ergoiena;397;215;182
31;Navarra;092;Erro;792;449;343
31;Navarra;094;Eslava;123;64;59
31;Navarra;095;Esparza de Salazar/Espartza Zaraitzu;87;45;42
31;Navarra;096;Espronceda;114;66;48
31;Navarra;097;Estella-Lizarra;13702;6584;7118
31;Navarra;098;Esteribar;2598;1352;1246
31;Navarra;099;Etayo;72;37;35
31;Navarra;082;Etxalar;801;429;372
31;Navarra;084;Etxarri Aranatz;2466;1280;1186
31;Navarra;085;Etxauri;586;305;281
31;Navarra;100;Eulate;303;166;137
31;Navarra;101;Ezcabarte;1834;957;877
31;Navarra;093;Ezcároz/Ezkaroze;323;175;148
31;Navarra;102;Ezkurra;154;103;51
31;Navarra;103;Ezprogui;47;24;23
31;Navarra;104;Falces;2390;1204;1186
31;Navarra;105;Fitero;2022;1005;1017
31;Navarra;106;Fontellas;961;489;472
31;Navarra;107;Funes;2471;1328;1143
31;Navarra;108;Fustiñana;2511;1248;1263
31;Navarra;109;Galar;2074;1097;977
31;Navarra;110;Gallipienzo/Galipentzu;106;60;46
31;Navarra;111;Gallués/Galoze;103;64;39
31;Navarra;112;Garaioa;97;53;44
31;Navarra;113;Garde;157;96;61
31;Navarra;114;Garínoain;490;269;221
31;Navarra;115;Garralda;185;96;89
31;Navarra;116;Genevilla;75;43;32
31;Navarra;117;Goizueta;736;400;336
31;Navarra;118;Goñi;170;106;64
31;Navarra;119;Güesa/Gorza;43;25;18
31;Navarra;120;Guesálaz/Gesalatz;450;267;183
31;Navarra;121;Guirguillano;81;42;39
31;Navarra;256;Hiriberri/Villanueva de Aezkoa;119;66;53
31;Navarra;122;Huarte/Uharte;6776;3397;3379
31;Navarra;124;Ibargoiti;249;145;104
31;Navarra;259;Igantzi;618;324;294
31;Navarra;125;Igúzquiza;332;172;160
31;Navarra;126;Imotz;432;227;205
31;Navarra;127;Irañeta;172;96;76
31;Navarra;904;Irurtzun;2194;1133;1061
31;Navarra;128;Isaba/Izaba;473;229;244
31;Navarra;129;Ituren;515;265;250
31;Navarra;130;Iturmendi;388;200;188
31;Navarra;131;Iza/Itza;1171;632;539
31;Navarra;132;Izagaondoa;177;114;63
31;Navarra;133;Izalzu/Itzaltzu;51;31;20
31;Navarra;134;Jaurrieta;202;115;87
31;Navarra;135;Javier;103;37;66
31;Navarra;136;Juslapeña;553;293;260
31;Navarra;138;Lakuntza;1257;651;606
31;Navarra;139;Lana;176;100;76
31;Navarra;140;Lantz;151;87;64
31;Navarra;141;Lapoblación;127;70;57
31;Navarra;142;Larraga;2034;1086;948
31;Navarra;143;Larraona;112;51;61
31;Navarra;144;Larraun;985;533;452
31;Navarra;145;Lazagurría;206;105;101
31;Navarra;146;Leache/Leatxe;44;26;18
31;Navarra;147;Legarda;110;58;52
31;Navarra;148;Legaria;98;44;54
31;Navarra;149;Leitza;2888;1517;1371
31;Navarra;908;Lekunberri;1483;733;750
31;Navarra;150;Leoz/Leotz;241;157;84
31;Navarra;151;Lerga;73;43;30
31;Navarra;152;Lerín;1665;852;813
31;Navarra;153;Lesaka;2742;1417;1325
31;Navarra;154;Lezáun;261;157;104
31;Navarra;155;Liédena;303;159;144
31;Navarra;156;Lizoáin-Arriasgoiti;318;191;127
31;Navarra;157;Lodosa;4741;2385;2356
31;Navarra;158;Lónguida/Longida;306;165;141
31;Navarra;159;Lumbier;1349;724;625
31;Navarra;160;Luquin;135;72;63
31;Navarra;248;Luzaide/Valcarlos;377;216;161
31;Navarra;161;Mañeru;432;233;199
31;Navarra;162;Marañón;53;26;27
31;Navarra;163;Marcilla;2800;1399;1401
31;Navarra;164;Mélida;729;378;351
31;Navarra;165;Mendavia;3597;1842;1755
31;Navarra;166;Mendaza;311;158;153
31;Navarra;167;Mendigorría;1055;548;507
31;Navarra;168;Metauten;291;161;130
31;Navarra;169;Milagro;3290;1719;1571
31;Navarra;170;Mirafuentes;56;24;32
31;Navarra;171;Miranda de Arga;847;438;409
31;Navarra;172;Monreal/Elo;470;254;216
31;Navarra;173;Monteagudo;1097;550;547
31;Navarra;174;Morentin;129;66;63
31;Navarra;175;Mues;88;47;41
31;Navarra;176;Murchante;3842;1931;1911
31;Navarra;177;Murieta;353;189;164
31;Navarra;178;Murillo el Cuende;654;333;321
31;Navarra;179;Murillo el Fruto;634;329;305
31;Navarra;180;Muruzábal;266;117;149
31;Navarra;181;Navascués/Nabaskoze;151;89;62
31;Navarra;182;Nazar;45;26;19
31;Navarra;088;Noáin (Valle de Elorz)/Noain (Elortzibar);7892;3992;3900
31;Navarra;183;Obanos;904;445;459
31;Navarra;185;Ochagavía/Otsagabia;560;293;267
31;Navarra;184;Oco;64;32;32
31;Navarra;186;Odieta;370;206;164
31;Navarra;187;Oiz;141;81;60
31;Navarra;188;Olaibar;316;177;139
31;Navarra;189;Olazti/Olazagutía;1520;776;744
31;Navarra;190;Olejua;49;28;21
31;Navarra;191;Olite/Erriberri;3907;1973;1934
31;Navarra;194;Ollo;409;217;192
31;Navarra;192;Olóriz/Oloritz;195;113;82
31;Navarra;195;Orbaizeta;202;102;100
31;Navarra;196;Orbara;42;22;20
31;Navarra;197;Orísoain;92;49;43
31;Navarra;906;Orkoien;3770;1906;1864
31;Navarra;198;Oronz/Orontze;46;25;21
31;Navarra;199;Oroz-Betelu/Orotz-Betelu;153;87;66
31;Navarra;211;Orreaga/Roncesvalles;32;16;16
31;Navarra;200;Oteiza;928;490;438
31;Navarra;201;Pamplona/Iruña;195853;93134;102719
31;Navarra;202;Peralta/Azkoien;5863;2950;2913
31;Navarra;203;Petilla de Aragón;34;21;13
31;Navarra;204;Piedramillera;39;26;13
31;Navarra;205;Pitillas;511;248;263
31;Navarra;206;Puente la Reina/Gares;2818;1446;1372
31;Navarra;207;Pueyo;340;183;157
31;Navarra;208;Ribaforada;3692;1889;1803
31;Navarra;209;Romanzado;173;90;83
31;Navarra;210;Roncal/Erronkari;227;121;106
31;Navarra;212;Sada;163;87;76
31;Navarra;213;Saldías;116;68;48
31;Navarra;214;Salinas de Oro/Jaitz;117;66;51
31;Navarra;215;San Adrián;6196;3069;3127
31;Navarra;217;San Martín de Unx;372;195;177
31;Navarra;216;Sangüesa/Zangoza;5020;2545;2475
31;Navarra;219;Sansol;100;53;47
31;Navarra;220;Santacara;891;462;429
31;Navarra;222;Sarriés/Sartze;63;40;23
31;Navarra;223;Sartaguda;1372;717;655
31;Navarra;224;Sesma;1183;607;576
31;Navarra;225;Sorlada;61;35;26
31;Navarra;226;Sunbilla;648;343;305
31;Navarra;227;Tafalla;10809;5336;5473
31;Navarra;228;Tiebas-Muruarte de Reta;617;315;302
31;Navarra;229;Tirapu;51;32;19
31;Navarra;230;Torralba del Río;118;63;55
31;Navarra;231;Torres del Río;129;60;69
31;Navarra;232;Tudela;35388;17436;17952
31;Navarra;233;Tulebras;118;51;67
31;Navarra;234;Ucar;182;106;76
31;Navarra;123;Uharte Arakil;840;443;397
31;Navarra;235;Ujué;187;104;83
31;Navarra;236;Ultzama;1666;867;799
31;Navarra;237;Unciti;219;128;91
31;Navarra;238;Unzué/Untzue;124;71;53
31;Navarra;239;Urdazubi/Urdax;402;193;209
31;Navarra;240;Urdiain;681;354;327
31;Navarra;241;Urraul Alto;152;90;62
31;Navarra;242;Urraul Bajo;294;130;164
31;Navarra;244;Urroz;186;102;84
31;Navarra;243;Urroz-Villa;408;214;194
31;Navarra;245;Urzainqui/Urzainki;95;54;41
31;Navarra;246;Uterga;174;100;74
31;Navarra;247;Uztárroz/Uztarroze;154;76;78
31;Navarra;086;Valle de Egüés;19603;9880;9723
31;Navarra;260;Valle de Yerri/Deierri;1497;763;734
31;Navarra;249;Valtierra;2443;1205;1238
31;Navarra;251;Viana;4048;2076;1972
31;Navarra;252;Vidángoz/Bidankoze;94;51;43
31;Navarra;254;Villafranca;2805;1414;1391
31;Navarra;255;Villamayor de Monjardín;128;67;61
31;Navarra;257;Villatuerta;1137;573;564
31;Navarra;258;Villava/Atarrabia;10265;5031;5234
31;Navarra;261;Yesa;285;159;126
31;Navarra;262;Zabalza/Zabaltza;276;141;135
31;Navarra;073;Ziordia;389;190;199
31;Navarra;907;Zizur Mayor/Zizur Nagusia;14493;7145;7348
31;Navarra;263;Zubieta;323;173;150
31;Navarra;264;Zugarramurdi;227;113;114
31;Navarra;265;Zúñiga;116;74;42
32;Ourense;001;Allariz;6049;3001;3048
32;Ourense;002;Amoeiro;2245;1104;1141
32;Ourense;003;Arnoia, A;1040;508;532
32;Ourense;004;Avión;1962;900;1062
32;Ourense;005;Baltar;1002;533;469
32;Ourense;006;Bande;1735;841;894
32;Ourense;007;Baños de Molgas;1658;821;837
32;Ourense;008;Barbadás;10463;5109;5354
32;Ourense;009;Barco de Valdeorras, O;13785;6712;7073
32;Ourense;010;Beade;451;240;211
32;Ourense;011;Beariz;1016;450;566
32;Ourense;012;Blancos, Os;878;485;393
32;Ourense;013;Boborás;2510;1168;1342
32;Ourense;014;Bola, A;1339;637;702
32;Ourense;015;Bolo, O;988;501;487
32;Ourense;016;Calvos de Randín;922;453;469
32;Ourense;018;Carballeda de Avia;1400;679;721
32;Ourense;017;Carballeda de Valdeorras;1698;871;827
32;Ourense;019;Carballiño, O;13999;6574;7425
32;Ourense;020;Cartelle;2852;1398;1454
32;Ourense;022;Castrelo de Miño;1556;777;779
32;Ourense;021;Castrelo do Val;1079;555;524
32;Ourense;023;Castro Caldelas;1351;679;672
32;Ourense;024;Celanova;5536;2637;2899
32;Ourense;025;Cenlle;1189;566;623
32;Ourense;029;Chandrexa de Queixa;528;296;232
32;Ourense;026;Coles;3168;1594;1574
32;Ourense;027;Cortegada;1184;577;607
32;Ourense;028;Cualedro;1840;934;906
32;Ourense;030;Entrimo;1251;589;662
32;Ourense;031;Esgos;1220;614;606
32;Ourense;033;Gomesende;829;393;436
32;Ourense;034;Gudiña, A;1392;732;660
32;Ourense;035;Irixo, O;1600;770;830
32;Ourense;038;Larouco;526;249;277
32;Ourense;039;Laza;1424;740;684
32;Ourense;040;Leiro;1630;811;819
32;Ourense;041;Lobeira;813;389;424
32;Ourense;042;Lobios;1988;1006;982
32;Ourense;043;Maceda;2957;1438;1519
32;Ourense;044;Manzaneda;975;482;493
32;Ourense;045;Maside;2879;1391;1488
32;Ourense;046;Melón;1293;614;679
32;Ourense;047;Merca, A;2021;979;1042
32;Ourense;048;Mezquita, A;1109;570;539
32;Ourense;049;Montederramo;807;410;397
32;Ourense;050;Monterrei;2758;1402;1356
32;Ourense;051;Muíños;1622;816;806
32;Ourense;052;Nogueira de Ramuín;2124;1072;1052
32;Ourense;053;Oímbra;2020;1112;908
32;Ourense;054;Ourense;106231;48592;57639
32;Ourense;055;Paderne de Allariz;1486;715;771
32;Ourense;056;Padrenda;1912;916;996
32;Ourense;057;Parada de Sil;605;323;282
32;Ourense;058;Pereiro de Aguiar, O;6319;3236;3083
32;Ourense;059;Peroxa, A;2038;1005;1033
32;Ourense;060;Petín;953;463;490
32;Ourense;061;Piñor;1232;620;612
32;Ourense;063;Pobra de Trives, A;2245;1116;1129
32;Ourense;064;Pontedeva;600;295;305
32;Ourense;062;Porqueira;901;440;461
32;Ourense;065;Punxín;760;369;391
32;Ourense;066;Quintela de Leirado;629;277;352
32;Ourense;067;Rairiz de Veiga;1430;733;697
32;Ourense;068;Ramirás;1607;739;868
32;Ourense;069;Ribadavia;5112;2474;2638
32;Ourense;071;Riós;1683;851;832
32;Ourense;072;Rúa, A;4595;2269;2326
32;Ourense;073;Rubiá;1473;727;746
32;Ourense;074;San Amaro;1170;566;604
32;Ourense;075;San Cibrao das Viñas;5036;2556;2480
32;Ourense;076;San Cristovo de Cea;2346;1164;1182
32;Ourense;070;San Xoán de Río;600;292;308
32;Ourense;077;Sandiás;1307;595;712
32;Ourense;078;Sarreaus;1283;649;634
32;Ourense;079;Taboadela;1514;774;740
32;Ourense;080;Teixeira, A;378;189;189
32;Ourense;081;Toén;2426;1249;1177
32;Ourense;082;Trasmiras;1410;704;706
32;Ourense;083;Veiga, A;946;478;468
32;Ourense;084;Verea;1042;492;550
32;Ourense;085;Verín;14107;6815;7292
32;Ourense;086;Viana do Bolo;3037;1509;1528
32;Ourense;087;Vilamarín;2026;1024;1002
32;Ourense;088;Vilamartín de Valdeorras;1798;923;875
32;Ourense;089;Vilar de Barrio;1455;743;712
32;Ourense;090;Vilar de Santos;894;435;459
32;Ourense;091;Vilardevós;2170;1124;1046
32;Ourense;092;Vilariño de Conso;615;348;267
32;Ourense;032;Xinzo de Limia;10043;4911;5132
32;Ourense;036;Xunqueira de Ambía;1498;758;740
32;Ourense;037;Xunqueira de Espadanedo;818;406;412
34;Palencia;001;Abarca de Campos;43;26;17
34;Palencia;003;Abia de las Torres;184;101;83
34;Palencia;004;Aguilar de Campoo;7033;3421;3612
34;Palencia;005;Alar del Rey;987;484;503
34;Palencia;006;Alba de Cerrato;84;46;38
34;Palencia;009;Amayuelas de Arriba;40;26;14
34;Palencia;010;Ampudia;640;333;307
34;Palencia;011;Amusco;440;238;202
34;Palencia;012;Antigüedad;391;209;182
34;Palencia;015;Arconada;44;28;16
34;Palencia;017;Astudillo;1002;505;497
34;Palencia;018;Autilla del Pino;232;127;105
34;Palencia;019;Autillo de Campos;146;74;72
34;Palencia;020;Ayuela;58;34;24
34;Palencia;022;Baltanás;1273;671;602
34;Palencia;024;Baquerín de Campos;37;25;12
34;Palencia;025;Bárcena de Campos;63;30;33
34;Palencia;027;Barruelo de Santullán;1275;631;644
34;Palencia;028;Báscones de Ojeda;154;82;72
34;Palencia;029;Becerril de Campos;812;419;393
34;Palencia;031;Belmonte de Campos;33;18;15
34;Palencia;032;Berzosilla;47;25;22
34;Palencia;033;Boada de Campos;18;12;6
34;Palencia;035;Boadilla de Rioseco;126;73;53
34;Palencia;034;Boadilla del Camino;127;71;56
34;Palencia;036;Brañosera;247;144;103
34;Palencia;037;Buenavista de Valdavia;320;178;142
34;Palencia;038;Bustillo de la Vega;316;171;145
34;Palencia;039;Bustillo del Páramo de Carrión;64;38;26
34;Palencia;041;Calahorra de Boedo;94;51;43
34;Palencia;042;Calzada de los Molinos;347;189;158
34;Palencia;045;Capillas;79;40;39
34;Palencia;046;Cardeñosa de Volpejera;49;28;21
34;Palencia;047;Carrión de los Condes;2177;1048;1129
34;Palencia;048;Castil de Vela;71;37;34
34;Palencia;049;Castrejón de la Peña;398;217;181
34;Palencia;050;Castrillo de Don Juan;234;128;106
34;Palencia;051;Castrillo de Onielo;114;62;52
34;Palencia;052;Castrillo de Villavega;196;107;89
34;Palencia;053;Castromocho;234;125;109
34;Palencia;055;Cervatos de la Cueza;300;170;130
34;Palencia;056;Cervera de Pisuerga;2442;1223;1219
34;Palencia;057;Cevico de la Torre;511;251;260
34;Palencia;058;Cevico Navero;196;105;91
34;Palencia;059;Cisneros;474;240;234
34;Palencia;060;Cobos de Cerrato;146;80;66
34;Palencia;061;Collazos de Boedo;115;62;53
34;Palencia;062;Congosto de Valdavia;184;111;73
34;Palencia;063;Cordovilla la Real;106;63;43
34;Palencia;066;Cubillas de Cerrato;61;32;29
34;Palencia;067;Dehesa de Montejo;136;77;59
34;Palencia;068;Dehesa de Romanos;34;20;14
34;Palencia;069;Dueñas;2741;1399;1342
34;Palencia;070;Espinosa de Cerrato;177;88;89
34;Palencia;071;Espinosa de Villagonzalo;201;103;98
34;Palencia;072;Frechilla;176;88;88
34;Palencia;073;Fresno del Río;205;99;106
34;Palencia;074;Frómista;822;416;406
34;Palencia;076;Fuentes de Nava;682;349;333
34;Palencia;077;Fuentes de Valdepero;419;218;201
34;Palencia;079;Grijota;2114;1098;1016
34;Palencia;080;Guardo;6547;3249;3298
34;Palencia;081;Guaza de Campos;61;34;27
34;Palencia;082;Hérmedes de Cerrato;87;47;40
34;Palencia;083;Herrera de Pisuerga;2132;1039;1093
34;Palencia;084;Herrera de Valdecañas;147;79;68
34;Palencia;086;Hontoria de Cerrato;109;58;51
34;Palencia;087;Hornillos de Cerrato;137;72;65
34;Palencia;088;Husillos;290;159;131
34;Palencia;089;Itero de la Vega;179;97;82
34;Palencia;091;Lagartos;137;78;59
34;Palencia;092;Lantadilla;331;177;154
34;Palencia;094;Ledigos;64;37;27
34;Palencia;903;Loma de Ucieza;232;135;97
34;Palencia;096;Lomas;56;37;19
34;Palencia;098;Magaz de Pisuerga;975;514;461
34;Palencia;099;Manquillos;77;41;36
34;Palencia;100;Mantinos;156;87;69
34;Palencia;101;Marcilla de Campos;40;19;21
34;Palencia;102;Mazariegos;221;128;93
34;Palencia;103;Mazuecos de Valdeginate;98;56;42
34;Palencia;104;Melgar de Yuso;263;152;111
34;Palencia;106;Meneses de Campos;121;62;59
34;Palencia;107;Micieces de Ojeda;83;47;36
34;Palencia;108;Monzón de Campos;623;322;301
34;Palencia;109;Moratinos;60;36;24
34;Palencia;110;Mudá;94;49;45
34;Palencia;112;Nogal de las Huertas;44;26;18
34;Palencia;113;Olea de Boedo;36;13;23
34;Palencia;114;Olmos de Ojeda;213;130;83
34;Palencia;116;Osornillo;63;32;31
34;Palencia;901;Osorno la Mayor;1298;683;615
34;Palencia;120;Palencia;79595;37516;42079
34;Palencia;121;Palenzuela;208;112;96
34;Palencia;122;Páramo de Boedo;111;59;52
34;Palencia;123;Paredes de Nava;1981;1008;973
34;Palencia;124;Payo de Ojeda;63;37;26
34;Palencia;125;Pedraza de Campos;96;49;47
34;Palencia;126;Pedrosa de la Vega;347;189;158
34;Palencia;127;Perales;111;58;53
34;Palencia;904;Pernía, La;349;205;144
34;Palencia;129;Pino del Río;192;118;74
34;Palencia;130;Piña de Campos;229;120;109
34;Palencia;131;Población de Arroyo;62;34;28
34;Palencia;132;Población de Campos;135;77;58
34;Palencia;133;Población de Cerrato;112;62;50
34;Palencia;134;Polentinos;55;30;25
34;Palencia;135;Pomar de Valdivia;462;259;203
34;Palencia;136;Poza de la Vega;225;124;101
34;Palencia;137;Pozo de Urama;30;19;11
34;Palencia;139;Prádanos de Ojeda;197;108;89
34;Palencia;140;Puebla de Valdavia, La;109;56;53
34;Palencia;141;Quintana del Puente;277;157;120
34;Palencia;143;Quintanilla de Onsoña;192;112;80
34;Palencia;146;Reinoso de Cerrato;54;36;18
34;Palencia;147;Renedo de la Vega;203;110;93
34;Palencia;149;Requena de Campos;20;10;10
34;Palencia;151;Respenda de la Peña;181;106;75
34;Palencia;152;Revenga de Campos;162;85;77
34;Palencia;154;Revilla de Collazos;86;46;40
34;Palencia;155;Ribas de Campos;166;85;81
34;Palencia;156;Riberos de la Cueza;59;39;20
34;Palencia;157;Saldaña;3121;1564;1557
34;Palencia;158;Salinas de Pisuerga;358;183;175
34;Palencia;159;San Cebrián de Campos;446;246;200
34;Palencia;160;San Cebrián de Mudá;160;87;73
34;Palencia;161;San Cristóbal de Boedo;23;14;9
34;Palencia;163;San Mamés de Campos;53;27;26
34;Palencia;165;San Román de la Cuba;71;40;31
34;Palencia;167;Santa Cecilia del Alcor;129;76;53
34;Palencia;168;Santa Cruz de Boedo;59;33;26
34;Palencia;169;Santervás de la Vega;479;266;213
34;Palencia;170;Santibáñez de Ecla;65;33;32
34;Palencia;171;Santibáñez de la Peña;1101;542;559
34;Palencia;174;Santoyo;224;121;103
34;Palencia;175;Serna, La;96;61;35
34;Palencia;177;Soto de Cerrato;195;114;81
34;Palencia;176;Sotobañado y Priorato;159;93;66
34;Palencia;178;Tabanera de Cerrato;126;73;53
34;Palencia;179;Tabanera de Valdavia;31;16;15
34;Palencia;180;Támara de Campos;79;41;38
34;Palencia;181;Tariego de Cerrato;526;281;245
34;Palencia;182;Torquemada;1025;555;470
34;Palencia;184;Torremormojón;55;31;24
34;Palencia;185;Triollo;60;34;26
34;Palencia;186;Valbuena de Pisuerga;52;30;22
34;Palencia;189;Valdeolmillos;69;37;32
34;Palencia;190;Valderrábano;57;29;28
34;Palencia;192;Valde-Ucieza;108;64;44
34;Palencia;196;Valle de Cerrato;96;58;38
34;Palencia;902;Valle del Retortillo;185;106;79
34;Palencia;199;Velilla del Río Carrión;1406;723;683
34;Palencia;023;Venta de Baños;6432;3229;3203
34;Palencia;201;Vertavillo;208;111;97
34;Palencia;093;Vid de Ojeda, La;106;64;42
34;Palencia;202;Villabasta de Valdavia;31;16;15
34;Palencia;204;Villacidaler;48;29;19
34;Palencia;205;Villaconancio;63;37;26
34;Palencia;206;Villada;1036;520;516
34;Palencia;208;Villaeles de Valdavia;60;34;26
34;Palencia;210;Villahán;104;52;52
34;Palencia;211;Villaherreros;208;102;106
34;Palencia;213;Villalaco;65;33;32
34;Palencia;214;Villalba de Guardo;204;110;94
34;Palencia;215;Villalcázar de Sirga;158;83;75
34;Palencia;216;Villalcón;71;40;31
34;Palencia;217;Villalobón;1573;795;778
34;Palencia;218;Villaluenga de la Vega;565;327;238
34;Palencia;220;Villamartín de Campos;181;102;79
34;Palencia;221;Villamediana;185;102;83
34;Palencia;222;Villameriel;127;72;55
34;Palencia;223;Villamoronta;262;150;112
34;Palencia;224;Villamuera de la Cueza;51;31;20
34;Palencia;225;Villamuriel de Cerrato;6370;3288;3082
34;Palencia;227;Villanueva del Rebollar;78;38;40
34;Palencia;228;Villanuño de Valdavia;94;53;41
34;Palencia;229;Villaprovedo;69;46;23
34;Palencia;230;Villarmentero de Campos;21;11;10
34;Palencia;231;Villarrabé;218;116;102
34;Palencia;232;Villarramiel;860;458;402
34;Palencia;233;Villasarracino;142;81;61
34;Palencia;234;Villasila de Valdavia;77;53;24
34;Palencia;236;Villaturde;167;88;79
34;Palencia;237;Villaumbrales;686;350;336
34;Palencia;238;Villaviudas;395;187;208
34;Palencia;240;Villerías de Campos;94;54;40
34;Palencia;241;Villodre;16;11;5
34;Palencia;242;Villodrigo;122;68;54
34;Palencia;243;Villoldo;364;199;165
34;Palencia;245;Villota del Páramo;326;189;137
34;Palencia;246;Villovieco;70;40;30
35;Palmas, Las;001;Agaete;5618;2813;2805
35;Palmas, Las;002;Agüimes;30294;15351;14943
35;Palmas, Las;020;Aldea de San Nicolás, La;7969;4036;3933
35;Palmas, Las;003;Antigua;11024;5875;5149
35;Palmas, Las;004;Arrecife;56940;28539;28401
35;Palmas, Las;005;Artenara;1177;641;536
35;Palmas, Las;006;Arucas;37054;18448;18606
35;Palmas, Las;007;Betancuria;713;364;349
35;Palmas, Las;008;Firgas;7486;3782;3704
35;Palmas, Las;009;Gáldar;24235;12165;12070
35;Palmas, Las;010;Haría;4755;2446;2309
35;Palmas, Las;011;Ingenio;30258;15365;14893
35;Palmas, Las;012;Mogán;22277;11557;10720
35;Palmas, Las;013;Moya;7845;3988;3857
35;Palmas, Las;014;Oliva, La;25199;13367;11832
35;Palmas, Las;015;Pájara;19271;10061;9210
35;Palmas, Las;016;Palmas de Gran Canaria, Las;379766;184254;195512
35;Palmas, Las;017;Puerto del Rosario;37363;19082;18281
35;Palmas, Las;018;San Bartolomé;18402;9288;9114
35;Palmas, Las;019;San Bartolomé de Tirajana;54932;28653;26279
35;Palmas, Las;021;Santa Brígida;18582;9214;9368
35;Palmas, Las;022;Santa Lucía de Tirajana;69069;34529;34540
35;Palmas, Las;023;Santa María de Guía de Gran Canaria;13890;6926;6964
35;Palmas, Las;024;Teguise;21454;10883;10571
35;Palmas, Las;025;Tejeda;2001;1064;937
35;Palmas, Las;026;Telde;102078;50487;51591
35;Palmas, Las;027;Teror;12499;6435;6064
35;Palmas, Las;028;Tías;20019;10241;9778
35;Palmas, Las;029;Tinajo;5824;3014;2810
35;Palmas, Las;030;Tuineje;13797;7071;6726
35;Palmas, Las;032;Valleseco;3856;2030;1826
35;Palmas, Las;031;Valsequillo de Gran Canaria;9276;4682;4594
35;Palmas, Las;033;Vega de San Mateo;7668;3910;3758
35;Palmas, Las;034;Yaiza;15815;8288;7527
36;Pontevedra;020;Agolada;2585;1278;1307
36;Pontevedra;001;Arbo;2846;1440;1406
36;Pontevedra;003;Baiona;12072;5982;6090
36;Pontevedra;002;Barro;3726;1844;1882
36;Pontevedra;004;Bueu;12251;6031;6220
36;Pontevedra;005;Caldas de Reis;9834;4742;5092
36;Pontevedra;006;Cambados;13895;6744;7151
36;Pontevedra;007;Campo Lameiro;1931;922;1009
36;Pontevedra;008;Cangas;26520;13081;13439
36;Pontevedra;009;Cañiza, A;5230;2551;2679
36;Pontevedra;010;Catoira;3368;1651;1717
36;Pontevedra;011;Cerdedo;1828;854;974
36;Pontevedra;012;Cotobade;4332;2099;2233
36;Pontevedra;013;Covelo;2617;1293;1324
36;Pontevedra;014;Crecente;2252;1077;1175
36;Pontevedra;015;Cuntis;4878;2311;2567
36;Pontevedra;016;Dozón;1174;610;564
36;Pontevedra;017;Estrada, A;21025;10072;10953
36;Pontevedra;018;Forcarei;3683;1728;1955
36;Pontevedra;019;Fornelos de Montes;1794;850;944
36;Pontevedra;021;Gondomar;14056;6954;7102
36;Pontevedra;022;Grove, O;10801;5306;5495
36;Pontevedra;023;Guarda, A;10193;4969;5224
36;Pontevedra;901;Illa de Arousa, A;4956;2459;2497
36;Pontevedra;024;Lalín;20005;9707;10298
36;Pontevedra;025;Lama, A;2670;1296;1374
36;Pontevedra;026;Marín;25084;12588;12496
36;Pontevedra;027;Meaño;5382;2611;2771
36;Pontevedra;028;Meis;5006;2399;2607
36;Pontevedra;029;Moaña;19492;9527;9965
36;Pontevedra;030;Mondariz;4665;2273;2392
36;Pontevedra;031;Mondariz-Balneario;652;329;323
36;Pontevedra;032;Moraña;4358;2111;2247
36;Pontevedra;033;Mos;15305;7549;7756
36;Pontevedra;034;Neves, As;4066;1971;2095
36;Pontevedra;035;Nigrán;17619;8660;8959
36;Pontevedra;036;Oia;3008;1511;1497
36;Pontevedra;037;Pazos de Borbén;3067;1494;1573
36;Pontevedra;041;Poio;16842;8326;8516
36;Pontevedra;043;Ponte Caldelas;5540;2691;2849
36;Pontevedra;042;Ponteareas;22990;11214;11776
36;Pontevedra;044;Pontecesures;3062;1532;1530
36;Pontevedra;038;Pontevedra;82539;39074;43465
36;Pontevedra;039;Porriño, O;18898;9296;9602
36;Pontevedra;040;Portas;3061;1467;1594
36;Pontevedra;045;Redondela;29697;14516;15181
36;Pontevedra;046;Ribadumia;5087;2457;2630
36;Pontevedra;047;Rodeiro;2700;1371;1329
36;Pontevedra;048;Rosal, O;6406;3154;3252
36;Pontevedra;049;Salceda de Caselas;8873;4433;4440
36;Pontevedra;050;Salvaterra de Miño;9619;4796;4823
36;Pontevedra;051;Sanxenxo;17391;8613;8778
36;Pontevedra;052;Silleda;8772;4254;4518
36;Pontevedra;053;Soutomaior;7317;3640;3677
36;Pontevedra;054;Tomiño;13662;6856;6806
36;Pontevedra;055;Tui;17013;8169;8844
36;Pontevedra;056;Valga;6062;2965;3097
36;Pontevedra;057;Vigo;294098;139688;154410
36;Pontevedra;059;Vila de Cruces;5556;2711;2845
36;Pontevedra;058;Vilaboa;6059;2934;3125
36;Pontevedra;060;Vilagarcía de Arousa;37482;17978;19504
36;Pontevedra;061;Vilanova de Arousa;10422;5105;5317
26;Rioja, La;001;Ábalos;252;150;102
26;Rioja, La;002;Agoncillo;1123;634;489
26;Rioja, La;003;Aguilar del Río Alhama;509;252;257
26;Rioja, La;004;Ajamil de Cameros;71;47;24
26;Rioja, La;005;Albelda de Iregua;3284;1686;1598
26;Rioja, La;006;Alberite;2456;1237;1219
26;Rioja, La;007;Alcanadre;710;377;333
26;Rioja, La;008;Aldeanueva de Ebro;2779;1444;1335
26;Rioja, La;009;Alesanco;505;268;237
26;Rioja, La;010;Alesón;124;74;50
26;Rioja, La;011;Alfaro;9568;4828;4740
26;Rioja, La;012;Almarza de Cameros;22;14;8
26;Rioja, La;013;Anguciana;453;247;206
26;Rioja, La;014;Anguiano;537;303;234
26;Rioja, La;015;Arenzana de Abajo;232;121;111
26;Rioja, La;016;Arenzana de Arriba;33;21;12
26;Rioja, La;017;Arnedillo;468;234;234
26;Rioja, La;018;Arnedo;14597;7222;7375
26;Rioja, La;019;Arrúbal;481;257;224
26;Rioja, La;020;Ausejo;796;424;372
26;Rioja, La;021;Autol;4427;2215;2212
26;Rioja, La;022;Azofra;205;108;97
26;Rioja, La;023;Badarán;534;266;268
26;Rioja, La;024;Bañares;284;144;140
26;Rioja, La;026;Baños de Río Tobía;1621;810;811
26;Rioja, La;025;Baños de Rioja;92;54;38
26;Rioja, La;027;Berceo;172;111;61
26;Rioja, La;028;Bergasa;152;84;68
26;Rioja, La;029;Bergasillas Bajera;39;20;19
26;Rioja, La;030;Bezares;15;8;7
26;Rioja, La;031;Bobadilla;120;63;57
26;Rioja, La;032;Brieva de Cameros;53;34;19
26;Rioja, La;033;Briñas;210;101;109
26;Rioja, La;034;Briones;835;446;389
26;Rioja, La;035;Cabezón de Cameros;16;12;4
26;Rioja, La;036;Calahorra;23955;11763;12192
26;Rioja, La;037;Camprovín;154;87;67
26;Rioja, La;038;Canales de la Sierra;97;62;35
26;Rioja, La;039;Canillas de Río Tuerto;38;18;20
26;Rioja, La;040;Cañas;92;47;45
26;Rioja, La;041;Cárdenas;162;85;77
26;Rioja, La;042;Casalarreina;1190;611;579
26;Rioja, La;043;Castañares de Rioja;439;218;221
26;Rioja, La;044;Castroviejo;68;40;28
26;Rioja, La;045;Cellorigo;12;5;7
26;Rioja, La;046;Cenicero;2028;1019;1009
26;Rioja, La;047;Cervera del Río Alhama;2427;1230;1197
26;Rioja, La;048;Cidamón;27;15;12
26;Rioja, La;049;Cihuri;226;116;110
26;Rioja, La;050;Cirueña;130;84;46
26;Rioja, La;051;Clavijo;307;176;131
26;Rioja, La;052;Cordovín;167;82;85
26;Rioja, La;053;Corera;253;135;118
26;Rioja, La;054;Cornago;355;202;153
26;Rioja, La;055;Corporales;47;25;22
26;Rioja, La;056;Cuzcurrita de Río Tirón;507;277;230
26;Rioja, La;057;Daroca de Rioja;54;35;19
26;Rioja, La;058;Enciso;166;103;63
26;Rioja, La;059;Entrena;1489;766;723
26;Rioja, La;060;Estollo;91;59;32
26;Rioja, La;061;Ezcaray;2050;1071;979
26;Rioja, La;062;Foncea;99;52;47
26;Rioja, La;063;Fonzaleche;146;97;49
26;Rioja, La;064;Fuenmayor;3146;1591;1555
26;Rioja, La;065;Galbárruli;46;31;15
26;Rioja, La;066;Galilea;363;185;178
26;Rioja, La;067;Gallinero de Cameros;25;17;8
26;Rioja, La;068;Gimileo;127;70;57
26;Rioja, La;069;Grañón;279;155;124
26;Rioja, La;070;Grávalos;208;108;100
26;Rioja, La;071;Haro;11414;5652;5762
26;Rioja, La;072;Herce;340;178;162
26;Rioja, La;073;Herramélluri;109;60;49
26;Rioja, La;074;Hervías;118;57;61
26;Rioja, La;075;Hormilla;455;245;210
26;Rioja, La;076;Hormilleja;150;74;76
26;Rioja, La;077;Hornillos de Cameros;31;16;15
26;Rioja, La;078;Hornos de Moncalvillo;91;56;35
26;Rioja, La;079;Huércanos;852;457;395
26;Rioja, La;080;Igea;612;339;273
26;Rioja, La;081;Jalón de Cameros;18;10;8
26;Rioja, La;082;Laguna de Cameros;128;74;54
26;Rioja, La;083;Lagunilla del Jubera;327;182;145
26;Rioja, La;084;Lardero;9448;4788;4660
26;Rioja, La;086;Ledesma de la Cogolla;18;13;5
26;Rioja, La;087;Leiva;277;142;135
26;Rioja, La;088;Leza de Río Leza;38;22;16
26;Rioja, La;089;Logroño;151344;72079;79265
26;Rioja, La;091;Lumbreras;163;106;57
26;Rioja, La;092;Manjarrés;117;71;46
26;Rioja, La;093;Mansilla de la Sierra;71;49;22
26;Rioja, La;094;Manzanares de Rioja;83;50;33
26;Rioja, La;095;Matute;109;55;54
26;Rioja, La;096;Medrano;316;168;148
26;Rioja, La;098;Munilla;116;58;58
26;Rioja, La;099;Murillo de Río Leza;1708;870;838
26;Rioja, La;100;Muro de Aguas;58;35;23
26;Rioja, La;101;Muro en Cameros;48;30;18
26;Rioja, La;102;Nájera;8185;4046;4139
26;Rioja, La;103;Nalda;952;510;442
26;Rioja, La;104;Navajún;16;12;4
26;Rioja, La;105;Navarrete;2928;1475;1453
26;Rioja, La;106;Nestares;97;53;44
26;Rioja, La;107;Nieva de Cameros;93;60;33
26;Rioja, La;109;Ochánduri;98;59;39
26;Rioja, La;108;Ocón;282;176;106
26;Rioja, La;110;Ojacastro;187;108;79
26;Rioja, La;111;Ollauri;281;150;131
26;Rioja, La;112;Ortigosa de Cameros;260;151;109
26;Rioja, La;113;Pazuengos;35;25;10
26;Rioja, La;114;Pedroso;81;55;26
26;Rioja, La;115;Pinillos;15;8;7
26;Rioja, La;117;Pradejón;3976;2045;1931
26;Rioja, La;118;Pradillo;61;31;30
26;Rioja, La;119;Préjano;244;139;105
26;Rioja, La;120;Quel;1996;1043;953
26;Rioja, La;121;Rabanera;34;25;9
26;Rioja, La;122;Rasillo de Cameros, El;151;79;72
26;Rioja, La;123;Redal, El;143;80;63
26;Rioja, La;124;Ribafrecha;1021;538;483
26;Rioja, La;125;Rincón de Soto;3729;1897;1832
26;Rioja, La;126;Robres del Castillo;31;20;11
26;Rioja, La;127;Rodezno;274;154;120
26;Rioja, La;128;Sajazarra;125;63;62
26;Rioja, La;129;San Asensio;1183;630;553
26;Rioja, La;130;San Millán de la Cogolla;244;160;84
26;Rioja, La;131;San Millán de Yécora;35;24;11
26;Rioja, La;132;San Román de Cameros;149;82;67
26;Rioja, La;139;San Torcuato;62;34;28
26;Rioja, La;142;San Vicente de la Sonsierra;1007;521;486
26;Rioja, La;134;Santa Coloma;106;63;43
26;Rioja, La;135;Santa Engracia del Jubera;181;112;69
26;Rioja, La;136;Santa Eulalia Bajera;112;59;53
26;Rioja, La;138;Santo Domingo de la Calzada;6401;3240;3161
26;Rioja, La;140;Santurde de Rioja;293;154;139
26;Rioja, La;141;Santurdejo;126;77;49
26;Rioja, La;143;Sojuela;282;172;110
26;Rioja, La;144;Sorzano;239;134;105
26;Rioja, La;145;Sotés;292;169;123
26;Rioja, La;146;Soto en Cameros;112;61;51
26;Rioja, La;147;Terroba;33;17;16
26;Rioja, La;148;Tirgo;211;106;105
26;Rioja, La;149;Tobía;61;36;25
26;Rioja, La;150;Tormantos;137;79;58
26;Rioja, La;153;Torre en Cameros;12;10;2
26;Rioja, La;151;Torrecilla en Cameros;519;277;242
26;Rioja, La;152;Torrecilla sobre Alesanco;36;21;15
26;Rioja, La;154;Torremontalbo;14;8;6
26;Rioja, La;155;Treviana;179;93;86
26;Rioja, La;157;Tricio;390;190;200
26;Rioja, La;158;Tudelilla;376;204;172
26;Rioja, La;160;Uruñuela;958;483;475
26;Rioja, La;161;Valdemadera;8;5;3
26;Rioja, La;162;Valgañón;137;86;51
26;Rioja, La;163;Ventosa;172;95;77
26;Rioja, La;164;Ventrosa;67;41;26
26;Rioja, La;165;Viguera;437;251;186
26;Rioja, La;166;Villalba de Rioja;125;78;47
26;Rioja, La;167;Villalobar de Rioja;63;46;17
26;Rioja, La;168;Villamediana de Iregua;7643;3863;3780
26;Rioja, La;169;Villanueva de Cameros;71;41;30
26;Rioja, La;170;Villar de Arnedo, El;629;323;306
26;Rioja, La;171;Villar de Torre;188;111;77
26;Rioja, La;172;Villarejo;31;24;7
26;Rioja, La;173;Villarroya;8;4;4
26;Rioja, La;174;Villarta-Quintana;155;89;66
26;Rioja, La;175;Villavelayo;57;37;20
26;Rioja, La;176;Villaverde de Rioja;63;35;28
26;Rioja, La;177;Villoslada de Cameros;354;218;136
26;Rioja, La;178;Viniegra de Abajo;86;53;33
26;Rioja, La;179;Viniegra de Arriba;45;28;17
26;Rioja, La;180;Zarratón;268;150;118
26;Rioja, La;181;Zarzosa;15;11;4
26;Rioja, La;183;Zorraquín;82;37;45
37;Salamanca;001;Abusejo;213;112;101
37;Salamanca;002;Agallas;157;79;78
37;Salamanca;003;Ahigal de los Aceiteros;136;72;64
37;Salamanca;004;Ahigal de Villarino;41;23;18
37;Salamanca;005;Alameda de Gardón, La;89;47;42
37;Salamanca;006;Alamedilla, La;146;74;72
37;Salamanca;007;Alaraz;502;259;243
37;Salamanca;008;Alba de Tormes;5309;2630;2679
37;Salamanca;009;Alba de Yeltes;240;125;115
37;Salamanca;010;Alberca, La;1121;557;564
37;Salamanca;011;Alberguería de Argañán, La;138;69;69
37;Salamanca;012;Alconada;160;85;75
37;Salamanca;015;Aldea del Obispo;313;167;146
37;Salamanca;013;Aldeacipreste;126;69;57
37;Salamanca;014;Aldeadávila de la Ribera;1264;646;618
37;Salamanca;016;Aldealengua;696;354;342
37;Salamanca;017;Aldeanueva de Figueroa;291;152;139
37;Salamanca;018;Aldeanueva de la Sierra;108;59;49
37;Salamanca;019;Aldearrodrigo;155;80;75
37;Salamanca;020;Aldearrubia;489;270;219
37;Salamanca;021;Aldeaseca de Alba;86;40;46
37;Salamanca;022;Aldeaseca de la Frontera;295;152;143
37;Salamanca;023;Aldeatejada;1724;875;849
37;Salamanca;024;Aldeavieja de Tormes;107;58;49
37;Salamanca;025;Aldehuela de la Bóveda;287;157;130
37;Salamanca;026;Aldehuela de Yeltes;213;114;99
37;Salamanca;027;Almenara de Tormes;250;143;107
37;Salamanca;028;Almendra;172;96;76
37;Salamanca;029;Anaya de Alba;219;127;92
37;Salamanca;030;Añover de Tormes;94;51;43
37;Salamanca;031;Arabayona de Mógica;396;216;180
37;Salamanca;032;Arapiles;644;337;307
37;Salamanca;033;Arcediano;109;59;50
37;Salamanca;034;Arco, El;94;49;45
37;Salamanca;035;Armenteros;281;159;122
37;Salamanca;037;Atalaya, La;119;67;52
37;Salamanca;038;Babilafuente;877;454;423
37;Salamanca;039;Bañobárez;317;167;150
37;Salamanca;040;Barbadillo;398;207;191
37;Salamanca;041;Barbalos;79;42;37
37;Salamanca;042;Barceo;48;28;20
37;Salamanca;044;Barruecopardo;496;274;222
37;Salamanca;045;Bastida, La;28;17;11
37;Salamanca;046;Béjar;13724;6513;7211
37;Salamanca;047;Beleña;220;104;116
37;Salamanca;049;Bermellar;148;77;71
37;Salamanca;050;Berrocal de Huebra;70;40;30
37;Salamanca;051;Berrocal de Salvatierra;87;46;41
37;Salamanca;052;Boada;298;153;145
37;Salamanca;054;Bodón, El;296;153;143
37;Salamanca;055;Bogajo;144;78;66
37;Salamanca;056;Bouza, La;65;29;36
37;Salamanca;057;Bóveda del Río Almar;242;128;114
37;Salamanca;058;Brincones;60;30;30
37;Salamanca;059;Buenamadre;136;74;62
37;Salamanca;060;Buenavista;265;150;115
37;Salamanca;061;Cabaco, El;244;124;120
37;Salamanca;063;Cabeza de Béjar, La;82;48;34
37;Salamanca;065;Cabeza del Caballo;349;190;159
37;Salamanca;062;Cabezabellosa de la Calzada;88;49;39
37;Salamanca;067;Cabrerizos;4198;2115;2083
37;Salamanca;068;Cabrillas;405;205;200
37;Salamanca;069;Calvarrasa de Abajo;1155;596;559
37;Salamanca;070;Calvarrasa de Arriba;620;326;294
37;Salamanca;071;Calzada de Béjar, La;90;49;41
37;Salamanca;072;Calzada de Don Diego;185;98;87
37;Salamanca;073;Calzada de Valdunciel;655;340;315
37;Salamanca;074;Campillo de Azaba;173;100;73
37;Salamanca;077;Campo de Peñaranda, El;278;157;121
37;Salamanca;078;Candelario;930;462;468
37;Salamanca;079;Canillas de Abajo;70;50;20
37;Salamanca;080;Cantagallo;270;144;126
37;Salamanca;081;Cantalapiedra;1027;531;496
37;Salamanca;082;Cantalpino;937;508;429
37;Salamanca;083;Cantaracillo;195;105;90
37;Salamanca;085;Carbajosa de la Sagrada;6740;3399;3341
37;Salamanca;086;Carpio de Azaba;104;61;43
37;Salamanca;087;Carrascal de Barregas;1086;571;515
37;Salamanca;088;Carrascal del Obispo;225;119;106
37;Salamanca;089;Casafranca;72;42;30
37;Salamanca;090;Casas del Conde, Las;56;31;25
37;Salamanca;091;Casillas de Flores;189;95;94
37;Salamanca;092;Castellanos de Moriscos;2322;1204;1118
37;Salamanca;185;Castellanos de Villiquera;684;372;312
37;Salamanca;096;Castillejo de Martín Viejo;238;134;104
37;Salamanca;097;Castraz;37;24;13
37;Salamanca;098;Cepeda;371;187;184
37;Salamanca;099;Cereceda de la Sierra;79;42;37
37;Salamanca;100;Cerezal de Peñahorcada;81;46;35
37;Salamanca;101;Cerralbo;178;98;80
37;Salamanca;102;Cerro, El;449;225;224
37;Salamanca;103;Cespedosa de Tormes;534;284;250
37;Salamanca;114;Chagarcía Medianero;95;49;46
37;Salamanca;104;Cilleros de la Bastida;26;14;12
37;Salamanca;106;Cipérez;284;144;140
37;Salamanca;107;Ciudad Rodrigo;13052;6310;6742
37;Salamanca;108;Coca de Alba;105;50;55
37;Salamanca;109;Colmenar de Montemayor;189;105;84
37;Salamanca;110;Cordovilla;132;73;59
37;Salamanca;112;Cristóbal;175;99;76
37;Salamanca;113;Cubo de Don Sancho, El;465;249;216
37;Salamanca;115;Dios le Guarde;141;74;67
37;Salamanca;116;Doñinos de Ledesma;72;35;37
37;Salamanca;117;Doñinos de Salamanca;1952;1027;925
37;Salamanca;118;Ejeme;137;79;58
37;Salamanca;120;Encina de San Silvestre;110;58;52
37;Salamanca;119;Encina, La;117;74;43
37;Salamanca;121;Encinas de Abajo;666;343;323
37;Salamanca;122;Encinas de Arriba;248;127;121
37;Salamanca;123;Encinasola de los Comendadores;194;104;90
37;Salamanca;124;Endrinal;238;129;109
37;Salamanca;125;Escurial de la Sierra;254;140;114
37;Salamanca;126;Espadaña;36;20;16
37;Salamanca;127;Espeja;252;131;121
37;Salamanca;128;Espino de la Orbada;283;153;130
37;Salamanca;129;Florida de Liébana;281;153;128
37;Salamanca;130;Forfoleda;187;101;86
37;Salamanca;131;Frades de la Sierra;214;114;100
37;Salamanca;132;Fregeneda, La;382;184;198
37;Salamanca;133;Fresnedoso;108;62;46
37;Salamanca;134;Fresno Alhándiga;247;135;112
37;Salamanca;135;Fuente de San Esteban, La;1376;695;681
37;Salamanca;136;Fuenteguinaldo;706;352;354
37;Salamanca;137;Fuenteliante;110;56;54
37;Salamanca;138;Fuenterroble de Salvatierra;252;130;122
37;Salamanca;139;Fuentes de Béjar;254;132;122
37;Salamanca;140;Fuentes de Oñoro;1070;552;518
37;Salamanca;141;Gajates;166;76;90
37;Salamanca;142;Galindo y Perahuy;710;408;302
37;Salamanca;143;Galinduste;452;225;227
37;Salamanca;144;Galisancho;395;220;175
37;Salamanca;145;Gallegos de Argañán;291;152;139
37;Salamanca;146;Gallegos de Solmirón;140;74;66
37;Salamanca;147;Garcibuey;185;101;84
37;Salamanca;148;Garcihernández;491;253;238
37;Salamanca;149;Garcirrey;73;42;31
37;Salamanca;150;Gejuelo del Barro;40;23;17
37;Salamanca;151;Golpejas;157;81;76
37;Salamanca;152;Gomecello;480;254;226
37;Salamanca;154;Guadramiro;152;87;65
37;Salamanca;155;Guijo de Ávila;87;52;35
37;Salamanca;156;Guijuelo;5673;2827;2846
37;Salamanca;157;Herguijuela de Ciudad Rodrigo;81;46;35
37;Salamanca;158;Herguijuela de la Sierra;274;149;125
37;Salamanca;159;Herguijuela del Campo;92;42;50
37;Salamanca;160;Hinojosa de Duero;712;351;361
37;Salamanca;161;Horcajo de Montemayor;159;86;73
37;Salamanca;162;Horcajo Medianero;218;118;100
37;Salamanca;163;Hoya, La;43;26;17
37;Salamanca;164;Huerta;306;166;140
37;Salamanca;165;Iruelos;39;15;24
37;Salamanca;166;Ituero de Azaba;232;120;112
37;Salamanca;167;Juzbado;166;88;78
37;Salamanca;168;Lagunilla;507;273;234
37;Salamanca;169;Larrodrigo;191;110;81
37;Salamanca;170;Ledesma;1778;881;897
37;Salamanca;171;Ledrada;507;256;251
37;Salamanca;172;Linares de Riofrío;983;546;437
37;Salamanca;173;Lumbrales;1735;875;860
37;Salamanca;175;Machacón;456;240;216
37;Salamanca;174;Macotera;1184;627;557
37;Salamanca;176;Madroñal;159;93;66
37;Salamanca;177;Maíllo, El;289;153;136
37;Salamanca;178;Malpartida;100;57;43
37;Salamanca;179;Mancera de Abajo;230;121;109
37;Salamanca;180;Manzano, El;73;39;34
37;Salamanca;181;Martiago;296;159;137
37;Salamanca;183;Martín de Yeltes;447;228;219
37;Salamanca;182;Martinamor;97;59;38
37;Salamanca;184;Masueco;348;181;167
37;Salamanca;186;Mata de Ledesma, La;109;59;50
37;Salamanca;187;Matilla de los Caños del Río;633;322;311
37;Salamanca;188;Maya, La;199;117;82
37;Salamanca;189;Membribe de la Sierra;139;80;59
37;Salamanca;190;Mieza;227;112;115
37;Salamanca;191;Milano, El;111;62;49
37;Salamanca;192;Miranda de Azán;423;228;195
37;Salamanca;193;Miranda del Castañar;450;238;212
37;Salamanca;194;Mogarraz;314;166;148
37;Salamanca;195;Molinillo;57;33;24
37;Salamanca;196;Monforte de la Sierra;89;48;41
37;Salamanca;197;Monleón;91;53;38
37;Salamanca;198;Monleras;245;116;129
37;Salamanca;199;Monsagro;148;80;68
37;Salamanca;200;Montejo;206;111;95
37;Salamanca;201;Montemayor del Río;301;155;146
37;Salamanca;202;Monterrubio de Armuña;1324;708;616
37;Salamanca;203;Monterrubio de la Sierra;182;100;82
37;Salamanca;204;Morasverdes;288;149;139
37;Salamanca;205;Morille;252;132;120
37;Salamanca;206;Moríñigo;102;55;47
37;Salamanca;207;Moriscos;354;196;158
37;Salamanca;208;Moronta;84;50;34
37;Salamanca;209;Mozárbez;512;269;243
37;Salamanca;211;Narros de Matalayegua;241;131;110
37;Salamanca;213;Nava de Béjar;98;52;46
37;Salamanca;214;Nava de Francia;138;73;65
37;Salamanca;215;Nava de Sotrobal;170;95;75
37;Salamanca;212;Navacarros;120;66;54
37;Salamanca;216;Navales;341;183;158
37;Salamanca;217;Navalmoral de Béjar;60;26;34
37;Salamanca;218;Navamorales;73;44;29
37;Salamanca;219;Navarredonda de la Rinconada;194;100;94
37;Salamanca;221;Navasfrías;475;251;224
37;Salamanca;222;Negrilla de Palencia;98;56;42
37;Salamanca;223;Olmedo de Camaces;115;62;53
37;Salamanca;224;Orbada, La;225;119;106
37;Salamanca;225;Pajares de la Laguna;119;64;55
37;Salamanca;226;Palacios del Arzobispo;170;86;84
37;Salamanca;228;Palaciosrubios;393;210;183
37;Salamanca;229;Palencia de Negrilla;172;92;80
37;Salamanca;230;Parada de Arriba;265;137;128
37;Salamanca;231;Parada de Rubiales;281;144;137
37;Salamanca;232;Paradinas de San Juan;421;239;182
37;Salamanca;233;Pastores;58;32;26
37;Salamanca;234;Payo, El;404;197;207
37;Salamanca;235;Pedraza de Alba;249;129;120
37;Salamanca;236;Pedrosillo de Alba;152;84;68
37;Salamanca;237;Pedrosillo de los Aires;385;214;171
37;Salamanca;238;Pedrosillo el Ralo;143;74;69
37;Salamanca;239;Pedroso de la Armuña, El;252;127;125
37;Salamanca;240;Pelabravo;1126;596;530
37;Salamanca;241;Pelarrodríguez;173;105;68
37;Salamanca;242;Pelayos;105;63;42
37;Salamanca;243;Peña, La;110;52;58
37;Salamanca;244;Peñacaballera;144;69;75
37;Salamanca;245;Peñaparda;375;189;186
37;Salamanca;246;Peñaranda de Bracamonte;6557;3214;3343
37;Salamanca;247;Peñarandilla;214;112;102
37;Salamanca;248;Peralejos de Abajo;169;85;84
37;Salamanca;249;Peralejos de Arriba;45;26;19
37;Salamanca;250;Pereña de la Ribera;391;202;189
37;Salamanca;251;Peromingo;135;64;71
37;Salamanca;252;Pinedas;112;63;49
37;Salamanca;253;Pino de Tormes, El;158;86;72
37;Salamanca;254;Pitiegua;198;114;84
37;Salamanca;255;Pizarral;56;30;26
37;Salamanca;256;Poveda de las Cintas;251;142;109
37;Salamanca;257;Pozos de Hinojo;53;29;24
37;Salamanca;258;Puebla de Azaba;210;115;95
37;Salamanca;259;Puebla de San Medel;45;26;19
37;Salamanca;260;Puebla de Yeltes;153;85;68
37;Salamanca;261;Puente del Congosto;240;132;108
37;Salamanca;262;Puertas;84;45;39
37;Salamanca;263;Puerto de Béjar;385;193;192
37;Salamanca;264;Puerto Seguro;66;34;32
37;Salamanca;265;Rágama;242;124;118
37;Salamanca;266;Redonda, La;94;54;40
37;Salamanca;267;Retortillo;227;123;104
37;Salamanca;268;Rinconada de la Sierra, La;120;64;56
37;Salamanca;269;Robleda;526;280;246
37;Salamanca;270;Robliza de Cojos;211;108;103
37;Salamanca;271;Rollán;376;203;173
37;Salamanca;272;Saelices el Chico;155;79;76
37;Salamanca;273;Sagrada, La;116;64;52
37;Salamanca;303;Sahugo, El;188;100;88
37;Salamanca;274;Salamanca;146438;66858;79580
37;Salamanca;275;Saldeana;125;69;56
37;Salamanca;276;Salmoral;158;99;59
37;Salamanca;277;Salvatierra de Tormes;63;30;33
37;Salamanca;278;San Cristóbal de la Cuesta;1017;545;472
37;Salamanca;284;San Esteban de la Sierra;346;184;162
37;Salamanca;285;San Felices de los Gallegos;451;229;222
37;Salamanca;286;San Martín del Castañar;243;132;111
37;Salamanca;287;San Miguel de Valero;355;178;177
37;Salamanca;036;San Miguel del Robledo;66;34;32
37;Salamanca;288;San Morales;288;159;129
37;Salamanca;289;San Muñoz;277;142;135
37;Salamanca;291;San Pedro de Rozados;307;166;141
37;Salamanca;290;San Pedro del Valle;152;84;68
37;Salamanca;292;San Pelayo de Guareña;96;50;46
37;Salamanca;280;Sanchón de la Ribera;82;48;34
37;Salamanca;281;Sanchón de la Sagrada;40;24;16
37;Salamanca;282;Sanchotello;238;124;114
37;Salamanca;279;Sancti-Spíritus;880;470;410
37;Salamanca;283;Sando;136;82;54
37;Salamanca;293;Santa María de Sando;124;62;62
37;Salamanca;294;Santa Marta de Tormes;14970;7368;7602
37;Salamanca;296;Santiago de la Puebla;366;189;177
37;Salamanca;297;Santibáñez de Béjar;488;250;238
37;Salamanca;298;Santibáñez de la Sierra;191;106;85
37;Salamanca;299;Santiz;254;127;127
37;Salamanca;300;Santos, Los;645;327;318
37;Salamanca;301;Sardón de los Frailes;84;50;34
37;Salamanca;302;Saucelle;324;170;154
37;Salamanca;304;Sepulcro-Hilario;186;106;80
37;Salamanca;305;Sequeros;239;117;122
37;Salamanca;306;Serradilla del Arroyo;286;157;129
37;Salamanca;307;Serradilla del Llano;171;85;86
37;Salamanca;309;Sierpe, La;50;26;24
37;Salamanca;310;Sieteiglesias de Tormes;214;110;104
37;Salamanca;311;Sobradillo;243;119;124
37;Salamanca;312;Sorihuela;270;137;133
37;Salamanca;313;Sotoserrano;606;323;283
37;Salamanca;314;Tabera de Abajo;115;64;51
37;Salamanca;315;Tala, La;96;52;44
37;Salamanca;316;Tamames;838;429;409
37;Salamanca;317;Tarazona de Guareña;334;178;156
37;Salamanca;318;Tardáguila;228;135;93
37;Salamanca;319;Tejado, El;127;67;60
37;Salamanca;320;Tejeda y Segoyuela;100;56;44
37;Salamanca;321;Tenebrón;163;81;82
37;Salamanca;322;Terradillos;3152;1619;1533
37;Salamanca;323;Topas;552;298;254
37;Salamanca;324;Tordillos;395;212;183
37;Salamanca;325;Tornadizo, El;94;51;43
37;Salamanca;327;Torresmenudas;195;99;96
37;Salamanca;328;Trabanca;228;114;114
37;Salamanca;329;Tremedal de Tormes;40;19;21
37;Salamanca;330;Valdecarros;364;187;177
37;Salamanca;331;Valdefuentes de Sangusín;231;129;102
37;Salamanca;332;Valdehijaderos;86;46;40
37;Salamanca;333;Valdelacasa;236;139;97
37;Salamanca;334;Valdelageve;86;45;41
37;Salamanca;335;Valdelosa;454;223;231
37;Salamanca;336;Valdemierque;57;35;22
37;Salamanca;337;Valderrodrigo;153;75;78
37;Salamanca;338;Valdunciel;93;46;47
37;Salamanca;339;Valero;309;166;143
37;Salamanca;343;Vallejera de Riofrío;70;35;35
37;Salamanca;340;Valsalabroso;149;87;62
37;Salamanca;341;Valverde de Valdelacasa;85;50;35
37;Salamanca;342;Valverdón;282;145;137
37;Salamanca;344;Vecinos;273;139;134
37;Salamanca;345;Vega de Tirados;181;94;87
37;Salamanca;346;Veguillas, Las;288;134;154
37;Salamanca;347;Vellés, La;561;306;255
37;Salamanca;348;Ventosa del Río Almar;118;67;51
37;Salamanca;349;Vídola, La;121;55;66
37;Salamanca;351;Villaflores;293;148;145
37;Salamanca;352;Villagonzalo de Tormes;216;125;91
37;Salamanca;353;Villalba de los Llanos;142;80;62
37;Salamanca;354;Villamayor;6962;3486;3476
37;Salamanca;355;Villanueva del Conde;183;95;88
37;Salamanca;356;Villar de Argañán;90;49;41
37;Salamanca;357;Villar de Ciervo;298;157;141
37;Salamanca;358;Villar de Gallimazo;198;122;76
37;Salamanca;359;Villar de la Yegua;202;106;96
37;Salamanca;360;Villar de Peralonso;259;124;135
37;Salamanca;361;Villar de Samaniego;89;50;39
37;Salamanca;362;Villares de la Reina;6188;3092;3096
37;Salamanca;363;Villares de Yeltes;131;63;68
37;Salamanca;364;Villarino de los Aires;892;461;431
37;Salamanca;365;Villarmayor;200;106;94
37;Salamanca;366;Villarmuerto;41;27;14
37;Salamanca;367;Villasbuenas;209;114;95
37;Salamanca;368;Villasdardo;17;6;11
37;Salamanca;369;Villaseco de los Gamitos;152;88;64
37;Salamanca;370;Villaseco de los Reyes;372;211;161
37;Salamanca;371;Villasrubias;299;163;136
37;Salamanca;372;Villaverde de Guareña;155;84;71
37;Salamanca;373;Villavieja de Yeltes;861;447;414
37;Salamanca;374;Villoria;1429;722;707
37;Salamanca;375;Villoruela;836;422;414
37;Salamanca;350;Vilvestre;447;218;229
37;Salamanca;376;Vitigudino;2700;1326;1374
37;Salamanca;377;Yecla de Yeltes;276;145;131
37;Salamanca;378;Zamarra;108;60;48
37;Salamanca;379;Zamayón;194;110;84
37;Salamanca;380;Zarapicos;51;26;25
37;Salamanca;381;Zarza de Pumareda, La;144;81;63
37;Salamanca;382;Zorita de la Frontera;194;99;95
38;Santa Cruz de Tenerife;001;Adeje;45405;23024;22381
38;Santa Cruz de Tenerife;002;Agulo;1081;555;526
38;Santa Cruz de Tenerife;003;Alajeró;2025;1072;953
38;Santa Cruz de Tenerife;004;Arafo;5499;2726;2773
38;Santa Cruz de Tenerife;005;Arico;7327;3825;3502
38;Santa Cruz de Tenerife;006;Arona;79928;40919;39009
38;Santa Cruz de Tenerife;007;Barlovento;1910;960;950
38;Santa Cruz de Tenerife;008;Breña Alta;7170;3542;3628
38;Santa Cruz de Tenerife;009;Breña Baja;5362;2687;2675
38;Santa Cruz de Tenerife;010;Buenavista del Norte;4859;2472;2387
38;Santa Cruz de Tenerife;011;Candelaria;26490;12882;13608
38;Santa Cruz de Tenerife;012;Fasnia;2820;1465;1355
38;Santa Cruz de Tenerife;013;Frontera;3926;1990;1936
38;Santa Cruz de Tenerife;014;Fuencaliente de la Palma;1730;881;849
38;Santa Cruz de Tenerife;015;Garachico;4966;2483;2483
38;Santa Cruz de Tenerife;016;Garafía;1590;816;774
38;Santa Cruz de Tenerife;017;Granadilla de Abona;44846;22506;22340
38;Santa Cruz de Tenerife;018;Guancha, La;5433;2664;2769
38;Santa Cruz de Tenerife;019;Guía de Isora;20373;10177;10196
38;Santa Cruz de Tenerife;020;Güímar;18777;9285;9492
38;Santa Cruz de Tenerife;021;Hermigua;1950;991;959
38;Santa Cruz de Tenerife;022;Icod de los Vinos;22659;11176;11483
38;Santa Cruz de Tenerife;024;Llanos de Aridane, Los;20227;9833;10394
38;Santa Cruz de Tenerife;025;Matanza de Acentejo, La;8752;4387;4365
38;Santa Cruz de Tenerife;026;Orotava, La;41317;20400;20917
38;Santa Cruz de Tenerife;027;Paso, El;7563;3757;3806
38;Santa Cruz de Tenerife;901;Pinar de El Hierro, El;1791;931;860
38;Santa Cruz de Tenerife;028;Puerto de la Cruz;29412;14381;15031
38;Santa Cruz de Tenerife;029;Puntagorda;2027;1031;996
38;Santa Cruz de Tenerife;030;Puntallana;2372;1193;1179
38;Santa Cruz de Tenerife;031;Realejos, Los;36276;17844;18432
38;Santa Cruz de Tenerife;032;Rosario, El;17277;8781;8496
38;Santa Cruz de Tenerife;033;San Andrés y Sauces;4265;2146;2119
38;Santa Cruz de Tenerife;023;San Cristóbal de La Laguna;152843;74382;78461
38;Santa Cruz de Tenerife;034;San Juan de la Rambla;4958;2475;2483
38;Santa Cruz de Tenerife;035;San Miguel de Abona;17090;8619;8471
38;Santa Cruz de Tenerife;036;San Sebastián de la Gomera;8591;4338;4253
38;Santa Cruz de Tenerife;037;Santa Cruz de la Palma;15900;7716;8184
38;Santa Cruz de Tenerife;038;Santa Cruz de Tenerife;203811;97375;106436
38;Santa Cruz de Tenerife;039;Santa Úrsula;14246;7128;7118
38;Santa Cruz de Tenerife;040;Santiago del Teide;10690;5311;5379
38;Santa Cruz de Tenerife;041;Sauzal, El;8930;4410;4520
38;Santa Cruz de Tenerife;042;Silos, Los;4805;2397;2408
38;Santa Cruz de Tenerife;043;Tacoronte;23893;11908;11985
38;Santa Cruz de Tenerife;044;Tanque, El;2698;1317;1381
38;Santa Cruz de Tenerife;045;Tazacorte;4771;2420;2351
38;Santa Cruz de Tenerife;046;Tegueste;11107;5506;5601
38;Santa Cruz de Tenerife;047;Tijarafe;2596;1314;1282
38;Santa Cruz de Tenerife;049;Valle Gran Rey;4223;2144;2079
38;Santa Cruz de Tenerife;050;Vallehermoso;2913;1490;1423
38;Santa Cruz de Tenerife;048;Valverde;4870;2483;2387
38;Santa Cruz de Tenerife;051;Victoria de Acentejo, La;9026;4542;4484
38;Santa Cruz de Tenerife;052;Vilaflor de Chasna;1671;856;815
38;Santa Cruz de Tenerife;053;Villa de Mazo;4863;2441;2422
40;Segovia;001;Abades;863;433;430
40;Segovia;002;Adrada de Pirón;41;19;22
40;Segovia;003;Adrados;155;83;72
40;Segovia;004;Aguilafuente;639;310;329
40;Segovia;005;Alconada de Maderuelo;37;23;14
40;Segovia;012;Aldea Real;332;177;155
40;Segovia;006;Aldealcorvo;20;13;7
40;Segovia;007;Aldealengua de Pedraza;83;51;32
40;Segovia;008;Aldealengua de Santa María;70;34;36
40;Segovia;009;Aldeanueva de la Serrezuela;55;38;17
40;Segovia;010;Aldeanueva del Codonal;134;73;61
40;Segovia;013;Aldeasoña;61;36;25
40;Segovia;014;Aldehorno;57;32;25
40;Segovia;015;Aldehuela del Codonal;34;18;16
40;Segovia;016;Aldeonte;59;27;32
40;Segovia;017;Anaya;123;60;63
40;Segovia;018;Añe;98;56;42
40;Segovia;019;Arahuetes;41;27;14
40;Segovia;020;Arcones;214;102;112
40;Segovia;021;Arevalillo de Cega;30;18;12
40;Segovia;022;Armuña;233;131;102
40;Segovia;024;Ayllón;1268;656;612
40;Segovia;025;Barbolla;200;112;88
40;Segovia;026;Basardilla;137;63;74
40;Segovia;028;Bercial;115;59;56
40;Segovia;029;Bercimuel;32;16;16
40;Segovia;030;Bernardos;547;294;253
40;Segovia;031;Bernuy de Porreros;719;385;334
40;Segovia;032;Boceguillas;793;407;386
40;Segovia;033;Brieva;93;50;43
40;Segovia;034;Caballar;96;49;47
40;Segovia;035;Cabañas de Polendos;180;103;77
40;Segovia;036;Cabezuela;674;344;330
40;Segovia;037;Calabazas de Fuentidueña;39;22;17
40;Segovia;039;Campo de San Pedro;281;156;125
40;Segovia;040;Cantalejo;3693;1861;1832
40;Segovia;041;Cantimpalos;1346;703;643
40;Segovia;043;Carbonero el Mayor;2540;1303;1237
40;Segovia;044;Carrascal del Río;150;82;68
40;Segovia;045;Casla;156;87;69
40;Segovia;046;Castillejo de Mesleón;143;85;58
40;Segovia;047;Castro de Fuentidueña;32;20;12
40;Segovia;048;Castrojimeno;38;19;19
40;Segovia;049;Castroserna de Abajo;74;39;35
40;Segovia;051;Castroserracín;64;34;30
40;Segovia;052;Cedillo de la Torre;111;56;55
40;Segovia;053;Cerezo de Abajo;148;78;70
40;Segovia;054;Cerezo de Arriba;145;80;65
40;Segovia;065;Chañe;887;423;464
40;Segovia;055;Cilleruelo de San Mamés;39;25;14
40;Segovia;056;Cobos de Fuentidueña;39;19;20
40;Segovia;057;Coca;1896;952;944
40;Segovia;058;Codorniz;351;179;172
40;Segovia;059;Collado Hermoso;145;70;75
40;Segovia;060;Condado de Castilnovo;105;60;45
40;Segovia;061;Corral de Ayllón;85;50;35
40;Segovia;902;Cozuelos de Fuentidueña;134;75;59
40;Segovia;062;Cubillo;74;43;31
40;Segovia;063;Cuéllar;9477;4773;4704
40;Segovia;905;Cuevas de Provanco;140;75;65
40;Segovia;068;Domingo García;28;17;11
40;Segovia;069;Donhierro;102;54;48
40;Segovia;070;Duruelo;181;108;73
40;Segovia;071;Encinas;50;27;23
40;Segovia;072;Encinillas;250;144;106
40;Segovia;073;Escalona del Prado;558;295;263
40;Segovia;074;Escarabajosa de Cabezas;327;176;151
40;Segovia;075;Escobar de Polendos;184;97;87
40;Segovia;076;Espinar, El;9486;4876;4610
40;Segovia;077;Espirdo;1107;597;510
40;Segovia;078;Fresneda de Cuéllar;178;101;77
40;Segovia;079;Fresno de Cantespino;277;149;128
40;Segovia;080;Fresno de la Fuente;94;50;44
40;Segovia;081;Frumales;127;65;62
40;Segovia;082;Fuente de Santa Cruz;128;67;61
40;Segovia;083;Fuente el Olmo de Fuentidueña;176;65;111
40;Segovia;084;Fuente el Olmo de Íscar;68;38;30
40;Segovia;086;Fuentepelayo;914;479;435
40;Segovia;087;Fuentepiñel;99;53;46
40;Segovia;088;Fuenterrebollo;369;193;176
40;Segovia;089;Fuentesaúco de Fuentidueña;249;134;115
40;Segovia;091;Fuentesoto;112;60;52
40;Segovia;092;Fuentidueña;144;83;61
40;Segovia;093;Gallegos;94;51;43
40;Segovia;094;Garcillán;453;237;216
40;Segovia;095;Gomezserracín;676;348;328
40;Segovia;097;Grajera;234;127;107
40;Segovia;099;Honrubia de la Cuesta;65;37;28
40;Segovia;100;Hontalbilla;316;167;149
40;Segovia;101;Hontanares de Eresma;1301;685;616
40;Segovia;103;Huertos, Los;181;107;74
40;Segovia;104;Ituero y Lama;375;202;173
40;Segovia;105;Juarros de Riomoros;59;35;24
40;Segovia;106;Juarros de Voltoya;238;120;118
40;Segovia;107;Labajos;145;80;65
40;Segovia;108;Laguna de Contreras;124;69;55
40;Segovia;109;Languilla;85;45;40
40;Segovia;110;Lastras de Cuéllar;407;207;200
40;Segovia;111;Lastras del Pozo;79;38;41
40;Segovia;112;Lastrilla, La;3669;1874;1795
40;Segovia;113;Losa, La;535;293;242
40;Segovia;115;Maderuelo;119;63;56
40;Segovia;903;Marazoleja;114;70;44
40;Segovia;118;Marazuela;54;32;22
40;Segovia;119;Martín Miguel;222;131;91
40;Segovia;120;Martín Muñoz de la Dehesa;222;119;103
40;Segovia;121;Martín Muñoz de las Posadas;337;179;158
40;Segovia;122;Marugán;624;333;291
40;Segovia;124;Mata de Cuéllar;280;144;136
40;Segovia;123;Matabuena;193;109;84
40;Segovia;125;Matilla, La;105;59;46
40;Segovia;126;Melque de Cercos;91;46;45
40;Segovia;127;Membibre de la Hoz;34;19;15
40;Segovia;128;Migueláñez;153;83;70
40;Segovia;129;Montejo de Arévalo;192;105;87
40;Segovia;130;Montejo de la Vega de la Serrezuela;150;88;62
40;Segovia;131;Monterrubio;62;34;28
40;Segovia;132;Moral de Hornuez;71;39;32
40;Segovia;134;Mozoncillo;932;499;433
40;Segovia;135;Muñopedro;332;172;160
40;Segovia;136;Muñoveros;159;78;81
40;Segovia;138;Nava de la Asunción;2882;1447;1435
40;Segovia;139;Navafría;324;173;151
40;Segovia;140;Navalilla;123;64;59
40;Segovia;141;Navalmanzano;1121;590;531
40;Segovia;142;Navares de Ayuso;54;26;28
40;Segovia;143;Navares de Enmedio;99;56;43
40;Segovia;144;Navares de las Cuevas;28;18;10
40;Segovia;145;Navas de Oro;1387;715;672
40;Segovia;904;Navas de Riofrío;421;198;223
40;Segovia;146;Navas de San Antonio;390;200;190
40;Segovia;148;Nieva;300;157;143
40;Segovia;149;Olombrada;605;322;283
40;Segovia;150;Orejana;74;44;30
40;Segovia;151;Ortigosa de Pestaño;74;38;36
40;Segovia;901;Ortigosa del Monte;547;295;252
40;Segovia;152;Otero de Herreros;981;502;479
40;Segovia;154;Pajarejos;20;12;8
40;Segovia;155;Palazuelos de Eresma;4986;2581;2405
40;Segovia;156;Pedraza;416;232;184
40;Segovia;157;Pelayos del Arroyo;57;34;23
40;Segovia;158;Perosillo;18;13;5
40;Segovia;159;Pinarejos;181;104;77
40;Segovia;160;Pinarnegrillo;112;62;50
40;Segovia;161;Pradales;47;26;21
40;Segovia;162;Prádena;545;291;254
40;Segovia;163;Puebla de Pedraza;59;34;25
40;Segovia;164;Rapariegos;208;110;98
40;Segovia;181;Real Sitio de San Ildefonso;5403;2666;2737
40;Segovia;165;Rebollo;91;49;42
40;Segovia;166;Remondo;296;148;148
40;Segovia;168;Riaguas de San Bartolomé;38;22;16
40;Segovia;170;Riaza;2290;1244;1046
40;Segovia;171;Ribota;43;35;8
40;Segovia;172;Riofrío de Riaza;53;34;19
40;Segovia;173;Roda de Eresma;197;107;90
40;Segovia;174;Sacramenia;429;224;205
40;Segovia;176;Samboal;484;261;223
40;Segovia;177;San Cristóbal de Cuéllar;159;86;73
40;Segovia;178;San Cristóbal de la Vega;117;58;59
40;Segovia;906;San Cristóbal de Segovia;2964;1501;1463
40;Segovia;182;San Martín y Mudrián;258;129;129
40;Segovia;183;San Miguel de Bernuy;154;79;75
40;Segovia;184;San Pedro de Gaíllos;322;174;148
40;Segovia;179;Sanchonuño;949;459;490
40;Segovia;180;Sangarcía;336;184;152
40;Segovia;185;Santa María la Real de Nieva;1045;554;491
40;Segovia;186;Santa Marta del Cerro;42;20;22
40;Segovia;188;Santiuste de Pedraza;111;67;44
40;Segovia;189;Santiuste de San Juan Bautista;599;327;272
40;Segovia;190;Santo Domingo de Pirón;62;38;24
40;Segovia;191;Santo Tomé del Puerto;293;164;129
40;Segovia;192;Sauquillo de Cabezas;186;101;85
40;Segovia;193;Sebúlcor;278;145;133
40;Segovia;194;Segovia;52728;25004;27724
40;Segovia;195;Sepúlveda;1168;609;559
40;Segovia;196;Sequera de Fresno;45;25;20
40;Segovia;198;Sotillo;26;15;11
40;Segovia;199;Sotosalbos;118;59;59
40;Segovia;200;Tabanera la Luenga;48;22;26
40;Segovia;201;Tolocirio;53;25;28
40;Segovia;206;Torre Val de San Pedro;196;100;96
40;Segovia;202;Torreadrada;72;32;40
40;Segovia;203;Torrecaballeros;1288;642;646
40;Segovia;204;Torrecilla del Pinar;219;117;102
40;Segovia;205;Torreiglesias;328;170;158
40;Segovia;207;Trescasas;1007;520;487
40;Segovia;208;Turégano;1039;521;518
40;Segovia;210;Urueñas;104;62;42
40;Segovia;211;Valdeprados;80;46;34
40;Segovia;212;Valdevacas de Montejo;32;15;17
40;Segovia;213;Valdevacas y Guijar;107;53;54
40;Segovia;218;Valle de Tabladillo;102;59;43
40;Segovia;219;Vallelado;718;385;333
40;Segovia;220;Valleruela de Pedraza;73;37;36
40;Segovia;221;Valleruela de Sepúlveda;54;26;28
40;Segovia;214;Valseca;264;147;117
40;Segovia;215;Valtiendas;91;54;37
40;Segovia;216;Valverde del Majano;1063;535;528
40;Segovia;222;Veganzones;264;146;118
40;Segovia;223;Vegas de Matute;285;166;119
40;Segovia;224;Ventosilla y Tejadilla;26;17;9
40;Segovia;225;Villacastín;1521;787;734
40;Segovia;228;Villaverde de Íscar;623;331;292
40;Segovia;229;Villaverde de Montejo;40;22;18
40;Segovia;230;Villeguillo;117;71;46
40;Segovia;231;Yanguas de Eresma;137;68;69
40;Segovia;233;Zarzuela del Monte;548;280;268
40;Segovia;234;Zarzuela del Pinar;473;247;226
41;Sevilla;001;Aguadulce;2114;1043;1071
41;Sevilla;002;Alanís;1820;912;908
41;Sevilla;003;Albaida del Aljarafe;3110;1554;1556
41;Sevilla;004;Alcalá de Guadaíra;74845;37222;37623
41;Sevilla;005;Alcalá del Río;11745;5967;5778
41;Sevilla;006;Alcolea del Río;3414;1712;1702
41;Sevilla;007;Algaba, La;16279;8056;8223
41;Sevilla;008;Algámitas;1291;675;616
41;Sevilla;009;Almadén de la Plata;1480;762;718
41;Sevilla;010;Almensilla;5861;2937;2924
41;Sevilla;011;Arahal;19550;9683;9867
41;Sevilla;012;Aznalcázar;4469;2267;2202
41;Sevilla;013;Aznalcóllar;6168;3161;3007
41;Sevilla;014;Badolatosa;3147;1625;1522
41;Sevilla;015;Benacazón;7163;3581;3582
41;Sevilla;016;Bollullos de la Mitación;10199;5139;5060
41;Sevilla;017;Bormujos;21362;10603;10759
41;Sevilla;018;Brenes;12697;6372;6325
41;Sevilla;019;Burguillos;6420;3249;3171
41;Sevilla;020;Cabezas de San Juan, Las;16514;8342;8172
41;Sevilla;021;Camas;26861;13114;13747
41;Sevilla;022;Campana, La;5410;2705;2705
41;Sevilla;023;Cantillana;10717;5476;5241
41;Sevilla;901;Cañada Rosal;3305;1634;1671
41;Sevilla;024;Carmona;28656;14439;14217
41;Sevilla;025;Carrión de los Céspedes;2563;1230;1333
41;Sevilla;026;Casariche;5594;2853;2741
41;Sevilla;027;Castilblanco de los Arroyos;4946;2492;2454
41;Sevilla;028;Castilleja de Guzmán;2855;1457;1398
41;Sevilla;029;Castilleja de la Cuesta;17459;8469;8990
41;Sevilla;030;Castilleja del Campo;622;317;305
41;Sevilla;031;Castillo de las Guardas, El;1511;764;747
41;Sevilla;032;Cazalla de la Sierra;5007;2465;2542
41;Sevilla;033;Constantina;6190;3072;3118
41;Sevilla;034;Coria del Río;30358;15134;15224
41;Sevilla;035;Coripe;1359;680;679
41;Sevilla;036;Coronil, El;4946;2474;2472
41;Sevilla;037;Corrales, Los;4003;2051;1952
41;Sevilla;903;Cuervo de Sevilla, El;8694;4439;4255
41;Sevilla;038;Dos Hermanas;131317;64762;66555
41;Sevilla;039;Écija;40320;19864;20456
41;Sevilla;040;Espartinas;14909;7475;7434
41;Sevilla;041;Estepa;12716;6312;6404
41;Sevilla;042;Fuentes de Andalucía;7190;3583;3607
41;Sevilla;043;Garrobo, El;777;400;377
41;Sevilla;044;Gelves;9838;4882;4956
41;Sevilla;045;Gerena;7404;3746;3658
41;Sevilla;046;Gilena;3861;1948;1913
41;Sevilla;047;Gines;13309;6558;6751
41;Sevilla;048;Guadalcanal;2744;1368;1376
41;Sevilla;049;Guillena;12506;6317;6189
41;Sevilla;050;Herrera;6467;3212;3255
41;Sevilla;051;Huévar del Aljarafe;2791;1440;1351
41;Sevilla;902;Isla Mayor;5938;2977;2961
41;Sevilla;052;Lantejuela;3873;1978;1895
41;Sevilla;053;Lebrija;27449;13730;13719
41;Sevilla;054;Lora de Estepa;856;437;419
41;Sevilla;055;Lora del Río;19328;9572;9756
41;Sevilla;056;Luisiana, La;4674;2357;2317
41;Sevilla;057;Madroño, El;305;151;154
41;Sevilla;058;Mairena del Alcor;22749;11416;11333
41;Sevilla;059;Mairena del Aljarafe;44388;21742;22646
41;Sevilla;060;Marchena;19878;9945;9933
41;Sevilla;061;Marinaleda;2734;1398;1336
41;Sevilla;062;Martín de la Jara;2756;1423;1333
41;Sevilla;063;Molares, Los;3467;1779;1688
41;Sevilla;064;Montellano;7088;3549;3539
41;Sevilla;065;Morón de la Frontera;28223;13945;14278
41;Sevilla;066;Navas de la Concepción, Las;1639;805;834
41;Sevilla;067;Olivares;9522;4795;4727
41;Sevilla;068;Osuna;17801;8809;8992
41;Sevilla;069;Palacios y Villafranca, Los;38157;19212;18945
41;Sevilla;070;Palomares del Río;8211;4118;4093
41;Sevilla;071;Paradas;7024;3509;3515
41;Sevilla;072;Pedrera;5328;2632;2696
41;Sevilla;073;Pedroso, El;2124;1058;1066
41;Sevilla;074;Peñaflor;3721;1880;1841
41;Sevilla;075;Pilas;13987;7069;6918
41;Sevilla;076;Pruna;2696;1386;1310
41;Sevilla;077;Puebla de Cazalla, La;11241;5599;5642
41;Sevilla;078;Puebla de los Infantes, La;3100;1537;1563
41;Sevilla;079;Puebla del Río, La;12114;6007;6107
41;Sevilla;080;Real de la Jara, El;1581;768;813
41;Sevilla;081;Rinconada, La;38180;18980;19200
41;Sevilla;082;Roda de Andalucía, La;4282;2125;2157
41;Sevilla;083;Ronquillo, El;1398;727;671
41;Sevilla;084;Rubio, El;3524;1729;1795
41;Sevilla;085;Salteras;5492;2667;2825
41;Sevilla;086;San Juan de Aznalfarache;21390;10361;11029
41;Sevilla;088;San Nicolás del Puerto;599;303;296
41;Sevilla;087;Sanlúcar la Mayor;13451;6648;6803
41;Sevilla;089;Santiponce;8453;4220;4233
41;Sevilla;090;Saucejo, El;4399;2172;2227
41;Sevilla;091;Sevilla;693878;329591;364287
41;Sevilla;092;Tocina;9728;4809;4919
41;Sevilla;093;Tomares;24743;12235;12508
41;Sevilla;094;Umbrete;8606;4331;4275
41;Sevilla;095;Utrera;52558;26176;26382
41;Sevilla;096;Valencina de la Concepción;7948;3944;4004
41;Sevilla;097;Villamanrique de la Condesa;4503;2214;2289
41;Sevilla;100;Villanueva de San Juan;1232;589;643
41;Sevilla;098;Villanueva del Ariscal;6395;3133;3262
41;Sevilla;099;Villanueva del Río y Minas;4944;2464;2480
41;Sevilla;101;Villaverde del Río;7823;3987;3836
41;Sevilla;102;Viso del Alcor, El;19149;9605;9544
42;Soria;001;Abejar;336;185;151
42;Soria;003;Adradas;51;28;23
42;Soria;004;Ágreda;3053;1549;1504
42;Soria;006;Alconaba;195;125;70
42;Soria;007;Alcubilla de Avellaneda;130;65;65
42;Soria;008;Alcubilla de las Peñas;58;35;23
42;Soria;009;Aldealafuente;93;53;40
42;Soria;010;Aldealices;25;15;10
42;Soria;011;Aldealpozo;20;10;10
42;Soria;012;Aldealseñor;41;22;19
42;Soria;013;Aldehuela de Periáñez;41;21;20
42;Soria;014;Aldehuelas, Las;68;36;32
42;Soria;015;Alentisque;32;18;14
42;Soria;016;Aliud;17;11;6
42;Soria;017;Almajano;179;92;87
42;Soria;018;Almaluez;163;98;65
42;Soria;019;Almarza;587;335;252
42;Soria;020;Almazán;5734;2904;2830
42;Soria;021;Almazul;84;49;35
42;Soria;022;Almenar de Soria;240;140;100
42;Soria;023;Alpanseque;70;37;33
42;Soria;024;Arancón;91;58;33
42;Soria;025;Arcos de Jalón;1661;892;769
42;Soria;026;Arenillas;29;13;16
42;Soria;027;Arévalo de la Sierra;76;48;28
42;Soria;028;Ausejo de la Sierra;84;47;37
42;Soria;029;Baraona;163;94;69
42;Soria;030;Barca;108;65;43
42;Soria;031;Barcones;25;16;9
42;Soria;032;Bayubas de Abajo;157;81;76
42;Soria;033;Bayubas de Arriba;52;31;21
42;Soria;034;Beratón;37;20;17
42;Soria;035;Berlanga de Duero;943;474;469
42;Soria;036;Blacos;50;28;22
42;Soria;037;Bliecos;37;22;15
42;Soria;038;Borjabad;35;21;14
42;Soria;039;Borobia;258;135;123
42;Soria;041;Buberos;36;20;16
42;Soria;042;Buitrago;60;33;27
42;Soria;043;Burgo de Osma-Ciudad de Osma;5066;2532;2534
42;Soria;044;Cabrejas del Campo;60;36;24
42;Soria;045;Cabrejas del Pinar;376;215;161
42;Soria;046;Calatañazor;55;31;24
42;Soria;048;Caltojar;65;40;25
42;Soria;049;Candilichera;127;74;53
42;Soria;050;Cañamaque;36;26;10
42;Soria;051;Carabantes;22;10;12
42;Soria;052;Caracena;15;10;5
42;Soria;053;Carrascosa de Abajo;28;18;10
42;Soria;054;Carrascosa de la Sierra;20;14;6
42;Soria;055;Casarejos;185;96;89
42;Soria;056;Castilfrío de la Sierra;29;19;10
42;Soria;058;Castillejo de Robledo;115;66;49
42;Soria;057;Castilruiz;197;108;89
42;Soria;059;Centenera de Andaluz;21;9;12
42;Soria;060;Cerbón;33;22;11
42;Soria;061;Cidones;333;192;141
42;Soria;062;Cigudosa;28;19;9
42;Soria;063;Cihuela;58;31;27
42;Soria;064;Ciria;93;52;41
42;Soria;065;Cirujales del Río;23;15;8
42;Soria;068;Coscurita;92;54;38
42;Soria;069;Covaleda;1779;908;871
42;Soria;070;Cubilla;40;25;15
42;Soria;071;Cubo de la Solana;193;107;86
42;Soria;073;Cueva de Ágreda;77;46;31
42;Soria;075;Dévanos;92;49;43
42;Soria;076;Deza;242;127;115
42;Soria;078;Duruelo de la Sierra;1175;606;569
42;Soria;079;Escobosa de Almazán;28;19;9
42;Soria;080;Espeja de San Marcelino;173;97;76
42;Soria;081;Espejón;188;96;92
42;Soria;082;Estepa de San Juan;7;5;2
42;Soria;083;Frechilla de Almazán;24;12;12
42;Soria;084;Fresno de Caracena;26;16;10
42;Soria;085;Fuentearmegil;197;111;86
42;Soria;086;Fuentecambrón;41;23;18
42;Soria;087;Fuentecantos;53;26;27
42;Soria;088;Fuentelmonge;76;43;33
42;Soria;089;Fuentelsaz de Soria;59;29;30
42;Soria;090;Fuentepinilla;97;60;37
42;Soria;092;Fuentes de Magaña;75;42;33
42;Soria;093;Fuentestrún;50;30;20
42;Soria;094;Garray;702;376;326
42;Soria;095;Golmayo;2484;1300;1184
42;Soria;096;Gómara;335;184;151
42;Soria;097;Gormaz;28;21;7
42;Soria;098;Herrera de Soria;11;7;4
42;Soria;100;Hinojosa del Campo;32;21;11
42;Soria;103;Langa de Duero;756;408;348
42;Soria;105;Liceras;57;29;28
42;Soria;106;Losilla, La;16;10;6
42;Soria;107;Magaña;87;51;36
42;Soria;108;Maján;13;7;6
42;Soria;110;Matalebreras;77;45;32
42;Soria;111;Matamala de Almazán;329;178;151
42;Soria;113;Medinaceli;732;363;369
42;Soria;115;Miño de Medinaceli;76;48;28
42;Soria;116;Miño de San Esteban;53;33;20
42;Soria;117;Molinos de Duero;178;92;86
42;Soria;118;Momblona;23;16;7
42;Soria;119;Monteagudo de las Vicarías;218;111;107
42;Soria;120;Montejo de Tiermes;174;117;57
42;Soria;121;Montenegro de Cameros;70;43;27
42;Soria;123;Morón de Almazán;216;113;103
42;Soria;124;Muriel de la Fuente;66;37;29
42;Soria;125;Muriel Viejo;98;57;41
42;Soria;127;Nafría de Ucero;39;24;15
42;Soria;128;Narros;42;23;19
42;Soria;129;Navaleno;832;439;393
42;Soria;130;Nepas;60;39;21
42;Soria;131;Nolay;57;30;27
42;Soria;132;Noviercas;158;84;74
42;Soria;134;Ólvega;3715;1914;1801
42;Soria;135;Oncala;82;46;36
42;Soria;139;Pinilla del Campo;23;13;10
42;Soria;140;Portillo de Soria;15;10;5
42;Soria;141;Póveda de Soria, La;115;67;48
42;Soria;142;Pozalmuro;68;30;38
42;Soria;144;Quintana Redonda;507;286;221
42;Soria;145;Quintanas de Gormaz;149;87;62
42;Soria;148;Quiñonería;9;4;5
42;Soria;149;Rábanos, Los;507;289;218
42;Soria;151;Rebollar;39;18;21
42;Soria;152;Recuerda;93;52;41
42;Soria;153;Rello;17;11;6
42;Soria;154;Renieblas;102;62;40
42;Soria;155;Retortillo de Soria;182;106;76
42;Soria;156;Reznos;33;22;11
42;Soria;157;Riba de Escalote, La;16;11;5
42;Soria;158;Rioseco de Soria;131;76;55
42;Soria;159;Rollamienta;39;26;13
42;Soria;160;Royo, El;305;163;142
42;Soria;161;Salduero;155;85;70
42;Soria;162;San Esteban de Gormaz;3070;1604;1466
42;Soria;163;San Felices;55;34;21
42;Soria;164;San Leonardo de Yagüe;2164;1100;1064
42;Soria;165;San Pedro Manrique;594;330;264
42;Soria;166;Santa Cruz de Yanguas;67;44;23
42;Soria;167;Santa María de Huerta;319;176;143
42;Soria;168;Santa María de las Hoyas;119;67;52
42;Soria;171;Serón de Nágima;135;72;63
42;Soria;172;Soliedra;36;20;16
42;Soria;173;Soria;39168;18557;20611
42;Soria;174;Sotillo del Rincón;198;103;95
42;Soria;175;Suellacabras;25;15;10
42;Soria;176;Tajahuerce;30;17;13
42;Soria;177;Tajueco;79;45;34
42;Soria;178;Talveila;133;73;60
42;Soria;181;Tardelcuende;450;239;211
42;Soria;182;Taroda;51;27;24
42;Soria;183;Tejado;125;71;54
42;Soria;184;Torlengua;71;38;33
42;Soria;185;Torreblacos;26;14;12
42;Soria;187;Torrubia de Soria;75;50;25
42;Soria;188;Trévago;55;24;31
42;Soria;189;Ucero;61;31;30
42;Soria;190;Vadillo;116;66;50
42;Soria;191;Valdeavellano de Tera;203;119;84
42;Soria;192;Valdegeña;43;30;13
42;Soria;193;Valdelagua del Cerro;14;9;5
42;Soria;194;Valdemaluque;189;87;102
42;Soria;195;Valdenebro;119;70;49
42;Soria;196;Valdeprado;14;10;4
42;Soria;197;Valderrodilla;79;43;36
42;Soria;198;Valtajeros;23;13;10
42;Soria;200;Velamazán;85;55;30
42;Soria;201;Velilla de la Sierra;25;15;10
42;Soria;202;Velilla de los Ajos;25;15;10
42;Soria;204;Viana de Duero;59;43;16
42;Soria;205;Villaciervos;95;61;34
42;Soria;206;Villanueva de Gormaz;8;5;3
42;Soria;207;Villar del Ala;51;25;26
42;Soria;208;Villar del Campo;22;14;8
42;Soria;209;Villar del Río;159;103;56
42;Soria;211;Villares de Soria, Los;91;52;39
42;Soria;212;Villasayas;78;52;26
42;Soria;213;Villaseca de Arciel;38;20;18
42;Soria;215;Vinuesa;938;506;432
42;Soria;216;Vizmanos;27;20;7
42;Soria;217;Vozmediano;37;24;13
42;Soria;218;Yanguas;107;68;39
42;Soria;219;Yelo;46;25;21
43;Tarragona;001;Aiguamúrcia;912;486;426
43;Tarragona;002;Albinyana;2320;1171;1149
43;Tarragona;003;Albiol, L';448;228;220
43;Tarragona;004;Alcanar;9603;4863;4740
43;Tarragona;005;Alcover;5073;2535;2538
43;Tarragona;904;Aldea, L';4245;2239;2006
43;Tarragona;006;Aldover;918;459;459
43;Tarragona;007;Aleixar, L';885;448;437
43;Tarragona;008;Alfara de Carles;378;202;176
43;Tarragona;009;Alforja;1883;956;927
43;Tarragona;010;Alió;419;202;217
43;Tarragona;011;Almoster;1410;702;708
43;Tarragona;012;Altafulla;5052;2482;2570
43;Tarragona;013;Ametlla de Mar, L';7183;3617;3566
43;Tarragona;906;Ampolla, L';3473;1766;1707
43;Tarragona;014;Amposta;20952;10564;10388
43;Tarragona;016;Arboç, L';5513;2853;2660
43;Tarragona;015;Arbolí;123;71;52
43;Tarragona;017;Argentera, L';147;82;65
43;Tarragona;018;Arnes;474;242;232
43;Tarragona;019;Ascó;1682;877;805
43;Tarragona;020;Banyeres del Penedès;3103;1561;1542
43;Tarragona;021;Barberà de la Conca;505;267;238
43;Tarragona;022;Batea;1945;966;979
43;Tarragona;023;Bellmunt del Priorat;303;153;150
43;Tarragona;024;Bellvei;2185;1140;1045
43;Tarragona;025;Benifallet;717;356;361
43;Tarragona;026;Benissanet;1251;683;568
43;Tarragona;027;Bisbal de Falset, La;221;120;101
43;Tarragona;028;Bisbal del Penedès, La;3474;1838;1636
43;Tarragona;029;Blancafort;413;211;202
43;Tarragona;030;Bonastre;641;329;312
43;Tarragona;031;Borges del Camp, Les;2087;1043;1044
43;Tarragona;032;Bot;618;320;298
43;Tarragona;033;Botarell;1101;576;525
43;Tarragona;034;Bràfim;665;334;331
43;Tarragona;035;Cabacés;330;166;164
43;Tarragona;036;Cabra del Camp;1109;578;531
43;Tarragona;037;Calafell;24256;12191;12065
43;Tarragona;903;Camarles;3476;1780;1696
43;Tarragona;038;Cambrils;32915;16170;16745
43;Tarragona;907;Canonja, La;5839;2891;2948
43;Tarragona;039;Capafonts;111;58;53
43;Tarragona;040;Capçanes;413;204;209
43;Tarragona;041;Caseres;258;131;127
43;Tarragona;042;Castellvell del Camp;2897;1448;1449
43;Tarragona;043;Catllar, El;4215;2176;2039
43;Tarragona;045;Colldejou;172;94;78
43;Tarragona;046;Conesa;120;58;62
43;Tarragona;047;Constantí;6416;3337;3079
43;Tarragona;048;Corbera d'Ebre;1095;572;523
43;Tarragona;049;Cornudella de Montsant;981;539;442
43;Tarragona;050;Creixell;3492;1771;1721
43;Tarragona;051;Cunit;11883;5889;5994
43;Tarragona;901;Deltebre;11676;5901;5775
43;Tarragona;053;Duesaigües;236;128;108
43;Tarragona;054;Espluga de Francolí, L';3818;1846;1972
43;Tarragona;055;Falset;2867;1435;1432
43;Tarragona;056;Fatarella, La;1028;512;516
43;Tarragona;057;Febró, La;39;28;11
43;Tarragona;058;Figuera, La;117;66;51
43;Tarragona;059;Figuerola del Camp;349;167;182
43;Tarragona;060;Flix;3754;1868;1886
43;Tarragona;061;Forès;51;27;24
43;Tarragona;062;Freginals;399;214;185
43;Tarragona;063;Galera, La;770;397;373
43;Tarragona;064;Gandesa;3009;1536;1473
43;Tarragona;065;Garcia;583;299;284
43;Tarragona;066;Garidells, Els;188;92;96
43;Tarragona;067;Ginestar;802;418;384
43;Tarragona;068;Godall;632;311;321
43;Tarragona;069;Gratallops;243;131;112
43;Tarragona;070;Guiamets, Els;277;129;148
43;Tarragona;071;Horta de Sant Joan;1217;632;585
43;Tarragona;072;Lloar, El;121;66;55
43;Tarragona;073;Llorac;111;61;50
43;Tarragona;074;Llorenç del Penedès;2323;1152;1171
43;Tarragona;076;Marçà;596;314;282
43;Tarragona;075;Margalef;106;64;42
43;Tarragona;077;Mas de Barberans;604;297;307
43;Tarragona;078;Masdenverge;1096;565;531
43;Tarragona;079;Masllorenç;501;271;230
43;Tarragona;080;Masó, La;290;155;135
43;Tarragona;081;Maspujols;786;403;383
43;Tarragona;082;Masroig, El;511;280;231
43;Tarragona;083;Milà, El;178;88;90
43;Tarragona;084;Miravet;747;402;345
43;Tarragona;085;Molar, El;291;156;135
43;Tarragona;086;Montblanc;7283;3684;3599
43;Tarragona;088;Montbrió del Camp;2693;1382;1311
43;Tarragona;089;Montferri;378;207;171
43;Tarragona;090;Montmell, El;1373;749;624
43;Tarragona;091;Mont-ral;176;98;78
43;Tarragona;092;Mont-roig del Camp;11877;6202;5675
43;Tarragona;093;Móra d'Ebre;5477;2699;2778
43;Tarragona;094;Móra la Nova;3185;1600;1585
43;Tarragona;095;Morell, El;3524;1808;1716
43;Tarragona;096;Morera de Montsant, La;147;86;61
43;Tarragona;097;Nou de Gaià, La;537;264;273
43;Tarragona;098;Nulles;448;233;215
43;Tarragona;100;Pallaresos, Els;4547;2298;2249
43;Tarragona;099;Palma d'Ebre, La;376;178;198
43;Tarragona;101;Passanant i Belltall;173;100;73
43;Tarragona;102;Paüls;582;285;297
43;Tarragona;103;Perafort;1320;697;623
43;Tarragona;104;Perelló, El;2925;1500;1425
43;Tarragona;105;Piles, Les;209;112;97
43;Tarragona;106;Pinell de Brai, El;1053;533;520
43;Tarragona;107;Pira;494;262;232
43;Tarragona;108;Pla de Santa Maria, El;2333;1212;1121
43;Tarragona;109;Pobla de Mafumet, La;3675;1897;1778
43;Tarragona;110;Pobla de Massaluca, La;341;182;159
43;Tarragona;111;Pobla de Montornès, La;2861;1518;1343
43;Tarragona;112;Poboleda;363;196;167
43;Tarragona;113;Pont d'Armentera, El;545;277;268
43;Tarragona;141;Pontils;121;69;52
43;Tarragona;114;Porrera;448;243;205
43;Tarragona;115;Pradell de la Teixeta;183;82;101
43;Tarragona;116;Prades;623;319;304
43;Tarragona;117;Prat de Comte;165;89;76
43;Tarragona;118;Pratdip;697;368;329
43;Tarragona;119;Puigpelat;1119;577;542
43;Tarragona;120;Querol;563;312;251
43;Tarragona;121;Rasquera;864;430;434
43;Tarragona;122;Renau;151;79;72
43;Tarragona;123;Reus;103194;50011;53183
43;Tarragona;124;Riba, La;605;325;280
43;Tarragona;125;Riba-roja d'Ebre;1172;618;554
43;Tarragona;126;Riera de Gaià, La;1679;841;838
43;Tarragona;127;Riudecanyes;1151;600;551
43;Tarragona;128;Riudecols;1216;636;580
43;Tarragona;129;Riudoms;6633;3409;3224
43;Tarragona;130;Rocafort de Queralt;251;133;118
43;Tarragona;131;Roda de Berà;6352;3288;3064
43;Tarragona;132;Rodonyà;501;258;243
43;Tarragona;133;Roquetes;8234;4246;3988
43;Tarragona;134;Rourell, El;404;207;197
43;Tarragona;135;Salomó;539;275;264
43;Tarragona;905;Salou;26459;13863;12596
43;Tarragona;136;Sant Carles de la Ràpita;14760;7259;7501
43;Tarragona;137;Sant Jaume dels Domenys;2521;1299;1222
43;Tarragona;902;Sant Jaume d'Enveja;3538;1801;1737
43;Tarragona;138;Santa Bàrbara;3734;1904;1830
43;Tarragona;139;Santa Coloma de Queralt;2850;1414;1436
43;Tarragona;140;Santa Oliva;3283;1674;1609
43;Tarragona;142;Sarral;1585;806;779
43;Tarragona;143;Savallà del Comtat;62;31;31
43;Tarragona;144;Secuita, La;1670;839;831
43;Tarragona;145;Selva del Camp, La;5559;2797;2762
43;Tarragona;146;Senan;47;31;16
43;Tarragona;044;Sénia, La;5799;2912;2887
43;Tarragona;147;Solivella;629;313;316
43;Tarragona;148;Tarragona;131255;63920;67335
43;Tarragona;149;Tivenys;868;443;425
43;Tarragona;150;Tivissa;1751;876;875
43;Tarragona;151;Torre de Fontaubella, La;129;67;62
43;Tarragona;152;Torre de l'Espanyol, La;644;338;306
43;Tarragona;153;Torredembarra;15371;7528;7843
43;Tarragona;154;Torroja del Priorat;164;92;72
43;Tarragona;155;Tortosa;33864;16964;16900
43;Tarragona;156;Ulldecona;6637;3394;3243
43;Tarragona;157;Ulldemolins;404;228;176
43;Tarragona;158;Vallclara;109;62;47
43;Tarragona;159;Vallfogona de Riucorb;95;58;37
43;Tarragona;160;Vallmoll;1651;836;815
43;Tarragona;161;Valls;24321;12127;12194
43;Tarragona;162;Vandellòs i l'Hospitalet de l'Infant;6050;3019;3031
43;Tarragona;163;Vendrell, El;36558;18229;18329
43;Tarragona;164;Vespella de Gaià;425;232;193
43;Tarragona;165;Vilabella;803;421;382
43;Tarragona;175;Vilalba dels Arcs;669;341;328
43;Tarragona;166;Vilallonga del Camp;2228;1138;1090
43;Tarragona;168;Vilanova de Prades;121;61;60
43;Tarragona;167;Vilanova d'Escornalbou;538;288;250
43;Tarragona;169;Vilaplana;624;316;308
43;Tarragona;170;Vila-rodona;1276;647;629
43;Tarragona;171;Vila-seca;22332;11314;11018
43;Tarragona;172;Vilaverd;469;246;223
43;Tarragona;173;Vilella Alta, La;135;70;65
43;Tarragona;174;Vilella Baixa, La;197;109;88
43;Tarragona;176;Vimbodí i Poblet;966;542;424
43;Tarragona;177;Vinebre;435;219;216
43;Tarragona;178;Vinyols i els Arcs;1931;993;938
43;Tarragona;052;Xerta;1209;589;620
44;Teruel;001;Ababuj;73;45;28
44;Teruel;002;Abejuela;54;34;20
44;Teruel;003;Aguatón;19;7;12
44;Teruel;004;Aguaviva;586;289;297
44;Teruel;005;Aguilar del Alfambra;66;41;25
44;Teruel;006;Alacón;293;151;142
44;Teruel;007;Alba;210;114;96
44;Teruel;008;Albalate del Arzobispo;2001;1017;984
44;Teruel;009;Albarracín;1049;545;504
44;Teruel;010;Albentosa;270;138;132
44;Teruel;011;Alcaine;74;46;28
44;Teruel;012;Alcalá de la Selva;399;220;179
44;Teruel;013;Alcañiz;16230;8105;8125
44;Teruel;014;Alcorisa;3374;1714;1660
44;Teruel;016;Alfambra;571;295;276
44;Teruel;017;Aliaga;365;202;163
44;Teruel;021;Allepuz;118;56;62
44;Teruel;022;Alloza;604;305;299
44;Teruel;023;Allueva;27;14;13
44;Teruel;018;Almohaja;20;15;5
44;Teruel;019;Alobras;70;41;29
44;Teruel;020;Alpeñés;21;12;9
44;Teruel;024;Anadón;25;15;10
44;Teruel;025;Andorra;8065;4101;3964
44;Teruel;026;Arcos de las Salinas;105;56;49
44;Teruel;027;Arens de Lledó;206;100;106
44;Teruel;028;Argente;214;101;113
44;Teruel;029;Ariño;763;386;377
44;Teruel;031;Azaila;116;58;58
44;Teruel;032;Bádenas;19;11;8
44;Teruel;033;Báguena;327;179;148
44;Teruel;034;Bañón;150;83;67
44;Teruel;035;Barrachina;133;73;60
44;Teruel;036;Bea;26;17;9
44;Teruel;037;Beceite;566;299;267
44;Teruel;039;Bello;238;113;125
44;Teruel;038;Belmonte de San José;117;57;60
44;Teruel;040;Berge;246;125;121
44;Teruel;041;Bezas;67;37;30
44;Teruel;042;Blancas;149;84;65
44;Teruel;043;Blesa;109;65;44
44;Teruel;044;Bordón;117;66;51
44;Teruel;045;Bronchales;423;247;176
44;Teruel;046;Bueña;55;27;28
44;Teruel;047;Burbáguena;254;126;128
44;Teruel;048;Cabra de Mora;73;43;30
44;Teruel;049;Calaceite;1052;535;517
44;Teruel;050;Calamocha;4417;2180;2237
44;Teruel;051;Calanda;3893;1911;1982
44;Teruel;052;Calomarde;87;50;37
44;Teruel;053;Camañas;125;67;58
44;Teruel;054;Camarena de la Sierra;123;74;49
44;Teruel;055;Camarillas;99;60;39
44;Teruel;056;Caminreal;659;342;317
44;Teruel;059;Cantavieja;741;393;348
44;Teruel;060;Cañada de Benatanduz;41;27;14
44;Teruel;061;Cañada de Verich, La;102;61;41
44;Teruel;062;Cañada Vellida;36;26;10
44;Teruel;063;Cañizar del Olivar;103;56;47
44;Teruel;064;Cascante del Río;80;49;31
44;Teruel;065;Castejón de Tornos;60;38;22
44;Teruel;066;Castel de Cabra;122;65;57
44;Teruel;070;Castellar, El;58;37;21
44;Teruel;071;Castellote;728;380;348
44;Teruel;067;Castelnou;142;71;71
44;Teruel;068;Castelserás;840;443;397
44;Teruel;074;Cedrillas;619;315;304
44;Teruel;075;Celadas;398;222;176
44;Teruel;076;Cella;2776;1462;1314
44;Teruel;077;Cerollera, La;106;68;38
44;Teruel;080;Codoñera, La;365;189;176
44;Teruel;082;Corbalán;110;60;50
44;Teruel;084;Cortes de Aragón;58;27;31
44;Teruel;085;Cosa;57;32;25
44;Teruel;086;Cretas;573;289;284
44;Teruel;087;Crivillén;74;37;37
44;Teruel;088;Cuba, La;37;19;18
44;Teruel;089;Cubla;54;37;17
44;Teruel;090;Cucalón;104;62;42
44;Teruel;092;Cuervo, El;87;47;40
44;Teruel;093;Cuevas de Almudén;140;83;57
44;Teruel;094;Cuevas Labradas;123;68;55
44;Teruel;096;Ejulve;200;102;98
44;Teruel;097;Escorihuela;158;79;79
44;Teruel;099;Escucha;953;523;430
44;Teruel;100;Estercuel;229;131;98
44;Teruel;101;Ferreruela de Huerva;69;37;32
44;Teruel;102;Fonfría;31;18;13
44;Teruel;103;Formiche Alto;180;98;82
44;Teruel;105;Fórnoles;86;43;43
44;Teruel;106;Fortanete;203;118;85
44;Teruel;107;Foz-Calanda;269;143;126
44;Teruel;108;Fresneda, La;474;265;209
44;Teruel;109;Frías de Albarracín;131;72;59
44;Teruel;110;Fuenferrada;57;32;25
44;Teruel;111;Fuentes Calientes;93;51;42
44;Teruel;112;Fuentes Claras;528;294;234
44;Teruel;113;Fuentes de Rubielos;121;66;55
44;Teruel;114;Fuentespalda;285;143;142
44;Teruel;115;Galve;167;86;81
44;Teruel;116;Gargallo;103;54;49
44;Teruel;117;Gea de Albarracín;387;203;184
44;Teruel;118;Ginebrosa, La;203;114;89
44;Teruel;119;Griegos;157;94;63
44;Teruel;120;Guadalaviar;247;143;104
44;Teruel;121;Gúdar;77;43;34
44;Teruel;122;Híjar;1761;888;873
44;Teruel;123;Hinojosa de Jarque;136;77;59
44;Teruel;124;Hoz de la Vieja, La;82;44;38
44;Teruel;125;Huesa del Común;73;43;30
44;Teruel;126;Iglesuela del Cid, La;432;224;208
44;Teruel;127;Jabaloyas;77;42;35
44;Teruel;128;Jarque de la Val;78;41;37
44;Teruel;129;Jatiel;48;27;21
44;Teruel;130;Jorcas;41;23;18
44;Teruel;131;Josa;36;21;15
44;Teruel;132;Lagueruela;81;42;39
44;Teruel;133;Lanzuela;29;21;8
44;Teruel;135;Libros;124;76;48
44;Teruel;136;Lidón;52;27;25
44;Teruel;137;Linares de Mora;287;166;121
44;Teruel;141;Lledó;169;90;79
44;Teruel;138;Loscos;151;89;62
44;Teruel;142;Maicas;36;20;16
44;Teruel;143;Manzanera;510;269;241
44;Teruel;144;Martín del Río;441;225;216
44;Teruel;145;Mas de las Matas;1318;681;637
44;Teruel;146;Mata de los Olmos, La;261;128;133
44;Teruel;147;Mazaleón;534;288;246
44;Teruel;148;Mezquita de Jarque;115;67;48
44;Teruel;149;Mirambel;119;65;54
44;Teruel;150;Miravete de la Sierra;29;20;9
44;Teruel;151;Molinos;258;138;120
44;Teruel;152;Monforte de Moyuela;66;47;19
44;Teruel;153;Monreal del Campo;2611;1305;1306
44;Teruel;154;Monroyo;360;217;143
44;Teruel;155;Montalbán;1327;674;653
44;Teruel;156;Monteagudo del Castillo;52;29;23
44;Teruel;157;Monterde de Albarracín;69;39;30
44;Teruel;158;Mora de Rubielos;1585;808;777
44;Teruel;159;Moscardón;58;31;27
44;Teruel;160;Mosqueruela;593;322;271
44;Teruel;161;Muniesa;635;337;298
44;Teruel;163;Noguera de Albarracín;151;80;71
44;Teruel;164;Nogueras;29;20;9
44;Teruel;165;Nogueruelas;207;113;94
44;Teruel;167;Obón;48;27;21
44;Teruel;168;Odón;226;118;108
44;Teruel;169;Ojos Negros;413;223;190
44;Teruel;171;Olba;240;137;103
44;Teruel;172;Oliete;412;218;194
44;Teruel;173;Olmos, Los;127;69;58
44;Teruel;174;Orihuela del Tremedal;535;285;250
44;Teruel;175;Orrios;137;69;68
44;Teruel;176;Palomar de Arroyos;182;106;76
44;Teruel;177;Pancrudo;112;68;44
44;Teruel;178;Parras de Castellote, Las;59;34;25
44;Teruel;179;Peñarroya de Tastavins;477;260;217
44;Teruel;180;Peracense;72;41;31
44;Teruel;181;Peralejos;86;45;41
44;Teruel;182;Perales del Alfambra;238;127;111
44;Teruel;183;Pitarque;90;45;45
44;Teruel;184;Plou;52;30;22
44;Teruel;185;Pobo, El;142;88;54
44;Teruel;187;Portellada, La;240;121;119
44;Teruel;189;Pozondón;62;33;29
44;Teruel;190;Pozuel del Campo;74;39;35
44;Teruel;191;Puebla de Híjar, La;947;472;475
44;Teruel;192;Puebla de Valverde, La;500;269;231
44;Teruel;193;Puertomingalvo;119;69;50
44;Teruel;194;Ráfales;133;71;62
44;Teruel;195;Rillo;97;54;43
44;Teruel;196;Riodeva;163;79;84
44;Teruel;197;Ródenas;66;38;28
44;Teruel;198;Royuela;221;123;98
44;Teruel;199;Rubiales;53;30;23
44;Teruel;200;Rubielos de la Cérida;41;22;19
44;Teruel;201;Rubielos de Mora;661;343;318
44;Teruel;203;Salcedillo;13;10;3
44;Teruel;204;Saldón;27;17;10
44;Teruel;205;Samper de Calanda;854;422;432
44;Teruel;206;San Agustín;141;89;52
44;Teruel;207;San Martín del Río;174;89;85
44;Teruel;208;Santa Cruz de Nogueras;39;20;19
44;Teruel;209;Santa Eulalia;1081;542;539
44;Teruel;210;Sarrión;1167;624;543
44;Teruel;211;Segura de los Baños;40;25;15
44;Teruel;212;Seno;43;21;22
44;Teruel;213;Singra;80;45;35
44;Teruel;215;Terriente;178;104;74
44;Teruel;216;Teruel;35590;17054;18536
44;Teruel;217;Toril y Masegoso;30;25;5
44;Teruel;218;Tormón;34;20;14
44;Teruel;219;Tornos;235;123;112
44;Teruel;220;Torralba de los Sisones;157;86;71
44;Teruel;223;Torre de Arcas;81;38;43
44;Teruel;224;Torre de las Arcas;29;14;15
44;Teruel;225;Torre del Compte;137;69;68
44;Teruel;227;Torre los Negros;90;49;41
44;Teruel;221;Torrecilla de Alcañiz;407;215;192
44;Teruel;222;Torrecilla del Rebollar;144;88;56
44;Teruel;226;Torrelacárcel;184;96;88
44;Teruel;228;Torremocha de Jiloca;110;63;47
44;Teruel;229;Torres de Albarracín;181;98;83
44;Teruel;230;Torrevelilla;200;96;104
44;Teruel;231;Torrijas;45;21;24
44;Teruel;232;Torrijo del Campo;489;254;235
44;Teruel;234;Tramacastiel;75;43;32
44;Teruel;235;Tramacastilla;107;50;57
44;Teruel;236;Tronchón;68;38;30
44;Teruel;237;Urrea de Gaén;488;243;245
44;Teruel;238;Utrillas;3110;1609;1501
44;Teruel;239;Valacloche;27;16;11
44;Teruel;240;Valbona;193;105;88
44;Teruel;241;Valdealgorfa;664;332;332
44;Teruel;243;Valdecuenca;40;26;14
44;Teruel;244;Valdelinares;85;52;33
44;Teruel;245;Valdeltormo;312;154;158
44;Teruel;246;Valderrobres;2342;1192;1150
44;Teruel;247;Valjunquera;358;184;174
44;Teruel;249;Vallecillo, El;60;34;26
44;Teruel;250;Veguillas de la Sierra;22;14;8
44;Teruel;251;Villafranca del Campo;299;156;143
44;Teruel;252;Villahermosa del Campo;103;67;36
44;Teruel;256;Villanueva del Rebollar de la Sierra;51;29;22
44;Teruel;257;Villar del Cobo;189;105;84
44;Teruel;258;Villar del Salz;74;44;30
44;Teruel;260;Villarluengo;189;114;75
44;Teruel;261;Villarquemado;869;452;417
44;Teruel;262;Villarroya de los Pinares;163;85;78
44;Teruel;263;Villastar;526;267;259
44;Teruel;264;Villel;342;199;143
44;Teruel;265;Vinaceite;262;138;124
44;Teruel;266;Visiedo;133;61;72
44;Teruel;267;Vivel del Río Martín;83;46;37
44;Teruel;268;Zoma, La;18;7;11
45;Toledo;001;Ajofrín;2314;1165;1149
45;Toledo;002;Alameda de la Sagra;3478;1817;1661
45;Toledo;003;Albarreal de Tajo;713;372;341
45;Toledo;004;Alcabón;720;386;334
45;Toledo;005;Alcañizo;292;148;144
45;Toledo;006;Alcaudete de la Jara;1897;956;941
45;Toledo;007;Alcolea de Tajo;830;419;411
45;Toledo;008;Aldea en Cabo;184;95;89
45;Toledo;009;Aldeanueva de Barbarroya;612;305;307
45;Toledo;010;Aldeanueva de San Bartolomé;475;243;232
45;Toledo;011;Almendral de la Cañada;339;180;159
45;Toledo;012;Almonacid de Toledo;865;427;438
45;Toledo;013;Almorox;2248;1186;1062
45;Toledo;014;Añover de Tajo;5191;2662;2529
45;Toledo;015;Arcicóllar;833;409;424
45;Toledo;016;Argés;6000;3018;2982
45;Toledo;017;Azután;291;145;146
45;Toledo;018;Barcience;747;397;350
45;Toledo;019;Bargas;10008;4983;5025
45;Toledo;020;Belvís de la Jara;1663;825;838
45;Toledo;021;Borox;3605;1879;1726
45;Toledo;022;Buenaventura;445;234;211
45;Toledo;023;Burguillos de Toledo;3028;1532;1496
45;Toledo;024;Burujón;1399;732;667
45;Toledo;025;Cabañas de la Sagra;1760;926;834
45;Toledo;026;Cabañas de Yepes;272;142;130
45;Toledo;027;Cabezamesada;433;234;199
45;Toledo;028;Calera y Chozas;4691;2384;2307
45;Toledo;029;Caleruela;234;124;110
45;Toledo;030;Calzada de Oropesa;564;302;262
45;Toledo;031;Camarena;3776;1972;1804
45;Toledo;032;Camarenilla;553;283;270
45;Toledo;033;Campillo de la Jara, El;405;208;197
45;Toledo;034;Camuñas;1824;937;887
45;Toledo;035;Cardiel de los Montes;372;199;173
45;Toledo;036;Carmena;785;403;382
45;Toledo;037;Carpio de Tajo, El;2038;1013;1025
45;Toledo;038;Carranque;4545;2357;2188
45;Toledo;039;Carriches;294;153;141
45;Toledo;040;Casar de Escalona, El;1986;1059;927
45;Toledo;041;Casarrubios del Monte;5319;2806;2513
45;Toledo;042;Casasbuenas;208;104;104
45;Toledo;043;Castillo de Bayuela;978;502;476
45;Toledo;045;Cazalegas;1730;883;847
45;Toledo;046;Cebolla;3527;1789;1738
45;Toledo;047;Cedillo del Condado;3604;1896;1708
45;Toledo;048;Cerralbos, Los;434;232;202
45;Toledo;049;Cervera de los Montes;521;267;254
45;Toledo;056;Chozas de Canales;3763;1968;1795
45;Toledo;057;Chueca;269;146;123
45;Toledo;050;Ciruelos;564;304;260
45;Toledo;051;Cobeja;2196;1139;1057
45;Toledo;052;Cobisa;4154;2079;2075
45;Toledo;053;Consuegra;10437;5258;5179
45;Toledo;054;Corral de Almaguer;5677;2886;2791
45;Toledo;055;Cuerva;1400;725;675
45;Toledo;058;Domingo Pérez;461;231;230
45;Toledo;059;Dosbarrios;2255;1149;1106
45;Toledo;060;Erustes;225;120;105
45;Toledo;061;Escalona;3306;1697;1609
45;Toledo;062;Escalonilla;1470;725;745
45;Toledo;063;Espinoso del Rey;507;280;227
45;Toledo;064;Esquivias;5389;2725;2664
45;Toledo;065;Estrella, La;260;133;127
45;Toledo;066;Fuensalida;11068;5638;5430
45;Toledo;067;Gálvez;3187;1608;1579
45;Toledo;068;Garciotum;197;100;97
45;Toledo;069;Gerindote;2427;1261;1166
45;Toledo;070;Guadamur;1864;933;931
45;Toledo;071;Guardia, La;2329;1170;1159
45;Toledo;072;Herencias, Las;823;440;383
45;Toledo;073;Herreruela de Oropesa;357;177;180
45;Toledo;074;Hinojosa de San Vicente;413;227;186
45;Toledo;075;Hontanar;156;93;63
45;Toledo;076;Hormigos;741;409;332
45;Toledo;077;Huecas;661;345;316
45;Toledo;078;Huerta de Valdecarábanos;1798;888;910
45;Toledo;079;Iglesuela, La;430;230;200
45;Toledo;080;Illán de Vacas;6;4;2
45;Toledo;081;Illescas;25964;13205;12759
45;Toledo;082;Lagartera;1503;757;746
45;Toledo;083;Layos;644;328;316
45;Toledo;084;Lillo;2813;1454;1359
45;Toledo;085;Lominchar;2342;1226;1116
45;Toledo;086;Lucillos;613;318;295
45;Toledo;087;Madridejos;10876;5473;5403
45;Toledo;088;Magán;3202;1659;1543
45;Toledo;089;Malpica de Tajo;1861;950;911
45;Toledo;090;Manzaneque;391;191;200
45;Toledo;091;Maqueda;476;242;234
45;Toledo;092;Marjaliza;278;138;140
45;Toledo;093;Marrupe;170;90;80
45;Toledo;094;Mascaraque;479;244;235
45;Toledo;095;Mata, La;917;459;458
45;Toledo;096;Mazarambroz;1287;665;622
45;Toledo;097;Mejorada;1294;667;627
45;Toledo;098;Menasalbas;2814;1472;1342
45;Toledo;099;Méntrida;4984;2576;2408
45;Toledo;100;Mesegar de Tajo;228;116;112
45;Toledo;101;Miguel Esteban;5080;2534;2546
45;Toledo;102;Mocejón;4874;2466;2408
45;Toledo;103;Mohedas de la Jara;453;248;205
45;Toledo;104;Montearagón;554;288;266
45;Toledo;105;Montesclaros;440;236;204
45;Toledo;106;Mora;10077;5080;4997
45;Toledo;107;Nambroca;4442;2271;2171
45;Toledo;108;Nava de Ricomalillo, La;597;303;294
45;Toledo;109;Navahermosa;3878;2009;1869
45;Toledo;110;Navalcán;2166;1160;1006
45;Toledo;111;Navalmoralejo;70;35;35
45;Toledo;112;Navalmorales, Los;2757;1448;1309
45;Toledo;113;Navalucillos, Los;2357;1216;1141
45;Toledo;114;Navamorcuende;668;342;326
45;Toledo;115;Noblejas;3534;1808;1726
45;Toledo;116;Noez;926;473;453
45;Toledo;117;Nombela;946;487;459
45;Toledo;118;Novés;2727;1408;1319
45;Toledo;119;Numancia de la Sagra;4763;2501;2262
45;Toledo;120;Nuño Gómez;154;80;74
45;Toledo;121;Ocaña;10795;5506;5289
45;Toledo;122;Olías del Rey;7229;3682;3547
45;Toledo;123;Ontígola;4232;2257;1975
45;Toledo;124;Orgaz;2738;1367;1371
45;Toledo;125;Oropesa;2771;1361;1410
45;Toledo;126;Otero;371;189;182
45;Toledo;127;Palomeque;902;488;414
45;Toledo;128;Pantoja;3409;1719;1690
45;Toledo;129;Paredes de Escalona;142;69;73
45;Toledo;130;Parrillas;375;194;181
45;Toledo;131;Pelahustán;349;191;158
45;Toledo;132;Pepino;2714;1421;1293
45;Toledo;133;Polán;3851;1932;1919
45;Toledo;134;Portillo de Toledo;2187;1086;1101
45;Toledo;135;Puebla de Almoradiel, La;5546;2812;2734
45;Toledo;136;Puebla de Montalbán, La;8063;4088;3975
45;Toledo;137;Pueblanueva, La;2304;1158;1146
45;Toledo;138;Puente del Arzobispo, El;1337;651;686
45;Toledo;139;Puerto de San Vicente;192;96;96
45;Toledo;140;Pulgar;1603;831;772
45;Toledo;141;Quero;1084;553;531
45;Toledo;142;Quintanar de la Orden;11604;5826;5778
45;Toledo;143;Quismondo;1568;795;773
45;Toledo;144;Real de San Vicente, El;1031;547;484
45;Toledo;145;Recas;4311;2387;1924
45;Toledo;146;Retamoso de la Jara;106;53;53
45;Toledo;147;Rielves;760;385;375
45;Toledo;148;Robledo del Mazo;327;186;141
45;Toledo;149;Romeral, El;706;351;355
45;Toledo;150;San Bartolomé de las Abiertas;524;278;246
45;Toledo;151;San Martín de Montalbán;800;401;399
45;Toledo;152;San Martín de Pusa;741;390;351
45;Toledo;153;San Pablo de los Montes;1910;960;950
45;Toledo;154;San Román de los Montes;1855;990;865
45;Toledo;155;Santa Ana de Pusa;449;250;199
45;Toledo;156;Santa Cruz de la Zarza;4426;2234;2192
45;Toledo;157;Santa Cruz del Retamar;2901;1504;1397
45;Toledo;158;Santa Olalla;3277;1664;1613
45;Toledo;901;Santo Domingo-Caudilla;1021;540;481
45;Toledo;159;Sartajada;102;59;43
45;Toledo;160;Segurilla;1318;676;642
45;Toledo;161;Seseña;21558;11237;10321
45;Toledo;162;Sevilleja de la Jara;751;403;348
45;Toledo;163;Sonseca;11289;5709;5580
45;Toledo;164;Sotillo de las Palomas;213;118;95
45;Toledo;165;Talavera de la Reina;85150;41166;43984
45;Toledo;166;Tembleque;2149;1095;1054
45;Toledo;167;Toboso, El;1964;992;972
45;Toledo;168;Toledo;83226;39859;43367
45;Toledo;169;Torralba de Oropesa;227;119;108
45;Toledo;171;Torre de Esteban Hambrán, La;1770;914;856
45;Toledo;170;Torrecilla de la Jara;262;136;126
45;Toledo;172;Torrico;827;420;407
45;Toledo;173;Torrijos;13273;6554;6719
45;Toledo;174;Totanés;386;199;187
45;Toledo;175;Turleque;818;417;401
45;Toledo;176;Ugena;5282;2727;2555
45;Toledo;177;Urda;2830;1413;1417
45;Toledo;179;Valdeverdeja;647;311;336
45;Toledo;180;Valmojado;4079;2077;2002
45;Toledo;181;Velada;2893;1501;1392
45;Toledo;182;Ventas con Peña Aguilera, Las;1206;622;584
45;Toledo;183;Ventas de Retamosa, Las;3382;1777;1605
45;Toledo;184;Ventas de San Julián, Las;238;112;126
45;Toledo;186;Villa de Don Fadrique, La;3918;1937;1981
45;Toledo;185;Villacañas;10070;5004;5066
45;Toledo;187;Villafranca de los Caballeros;5196;2586;2610
45;Toledo;188;Villaluenga de la Sagra;3857;1914;1943
45;Toledo;189;Villamiel de Toledo;872;464;408
45;Toledo;190;Villaminaya;559;283;276
45;Toledo;191;Villamuelas;671;346;325
45;Toledo;192;Villanueva de Alcardete;3503;1822;1681
45;Toledo;193;Villanueva de Bogas;774;397;377
45;Toledo;194;Villarejo de Montalbán;81;44;37
45;Toledo;195;Villarrubia de Santiago;2665;1349;1316
45;Toledo;196;Villaseca de la Sagra;1808;914;894
45;Toledo;197;Villasequilla;2545;1311;1234
45;Toledo;198;Villatobas;2515;1291;1224
45;Toledo;199;Viso de San Juan, El;4263;2283;1980
45;Toledo;200;Yébenes, Los;6132;3138;2994
45;Toledo;201;Yeles;5038;2698;2340
45;Toledo;202;Yepes;5055;2585;2470
45;Toledo;203;Yuncler;3594;1824;1770
45;Toledo;204;Yunclillos;878;466;412
45;Toledo;205;Yuncos;10607;5491;5116
46;Valencia/València;001;Ademuz;1149;609;540
46;Valencia/València;002;Ador;1374;714;660
46;Valencia/València;004;Agullent;2402;1184;1218
46;Valencia/València;042;Aielo de Malferit;4705;2349;2356
46;Valencia/València;043;Aielo de Rugat;173;91;82
46;Valencia/València;005;Alaquàs;29838;14654;15184
46;Valencia/València;006;Albaida;5987;2957;3030
46;Valencia/València;007;Albal;16029;8006;8023
46;Valencia/València;008;Albalat de la Ribera;3467;1761;1706
46;Valencia/València;009;Albalat dels Sorells;3896;1878;2018
46;Valencia/València;010;Albalat dels Tarongers;1178;628;550
46;Valencia/València;011;Alberic;10498;5269;5229
46;Valencia/València;012;Alborache;1136;597;539
46;Valencia/València;013;Alboraya;23819;11684;12135
46;Valencia/València;014;Albuixech;3928;1943;1985
46;Valencia/València;016;Alcàntera de Xúquer;1341;665;676
46;Valencia/València;015;Alcàsser;9612;4876;4736
46;Valencia/València;018;Alcublas;727;368;359
46;Valencia/València;020;Alcúdia de Crespins, l';5282;2645;2637
46;Valencia/València;019;Alcúdia, l';11691;5744;5947
46;Valencia/València;021;Aldaia;31120;15554;15566
46;Valencia/València;022;Alfafar;21125;10405;10720
46;Valencia/València;024;Alfara de la Baronia;526;273;253
46;Valencia/València;025;Alfara del Patriarca;3228;1590;1638
46;Valencia/València;026;Alfarp;1532;791;741
46;Valencia/València;027;Alfarrasí;1247;615;632
46;Valencia/València;023;Alfauir;458;231;227
46;Valencia/València;028;Algar de Palancia;503;253;250
46;Valencia/València;029;Algemesí;27633;13714;13919
46;Valencia/València;030;Algimia de Alfara;1048;517;531
46;Valencia/València;031;Alginet;13144;6701;6443
46;Valencia/València;032;Almàssera;7269;3548;3721
46;Valencia/València;033;Almiserà;272;137;135
46;Valencia/València;034;Almoines;2302;1158;1144
46;Valencia/València;035;Almussafes;8759;4403;4356
46;Valencia/València;036;Alpuente;679;379;300
46;Valencia/València;037;Alqueria de la Comtessa, l';1504;742;762
46;Valencia/València;017;Alzira;44554;21684;22870
46;Valencia/València;038;Andilla;362;228;134
46;Valencia/València;039;Anna;2712;1365;1347
46;Valencia/València;040;Antella;1301;644;657
46;Valencia/València;041;Aras de los Olmos;382;217;165
46;Valencia/València;003;Atzeneta d'Albaida;1160;597;563
46;Valencia/València;044;Ayora;5303;2667;2636
46;Valencia/València;046;Barx;1264;658;606
46;Valencia/València;045;Barxeta;1615;822;793
46;Valencia/València;047;Bèlgida;683;335;348
46;Valencia/València;048;Bellreguard;4623;2315;2308
46;Valencia/València;049;Bellús;326;164;162
46;Valencia/València;050;Benagéber;217;122;95
46;Valencia/València;051;Benaguasil;10936;5574;5362
46;Valencia/València;052;Benavites;626;296;330
46;Valencia/València;053;Beneixida;690;327;363
46;Valencia/València;054;Benetússer;14436;7061;7375
46;Valencia/València;055;Beniarjó;1754;872;882
46;Valencia/València;056;Beniatjar;240;119;121
46;Valencia/València;057;Benicolet;612;312;300
46;Valencia/València;904;Benicull de Xúquer;993;511;482
46;Valencia/València;060;Benifaió;11913;5927;5986
46;Valencia/València;059;Benifairó de la Valldigna;1622;802;820
46;Valencia/València;058;Benifairó de les Valls;2239;1122;1117
46;Valencia/València;061;Beniflá;453;228;225
46;Valencia/València;062;Benigànim;6120;3102;3018
46;Valencia/València;063;Benimodo;2229;1150;1079
46;Valencia/València;064;Benimuslem;658;335;323
46;Valencia/València;065;Beniparrell;1922;986;936
46;Valencia/València;066;Benirredrà;1592;769;823
46;Valencia/València;067;Benisanó;2233;1121;1112
46;Valencia/València;068;Benissoda;431;237;194
46;Valencia/València;069;Benisuera;191;98;93
46;Valencia/València;070;Bétera;22349;11231;11118
46;Valencia/València;071;Bicorp;533;271;262
46;Valencia/València;072;Bocairent;4357;2190;2167
46;Valencia/València;073;Bolbaite;1389;695;694
46;Valencia/València;074;Bonrepòs i Mirambell;3566;1755;1811
46;Valencia/València;075;Bufali;167;92;75
46;Valencia/València;076;Bugarra;739;371;368
46;Valencia/València;077;Buñol;9726;4876;4850
46;Valencia/València;078;Burjassot;37546;18165;19381
46;Valencia/València;079;Calles;391;223;168
46;Valencia/València;080;Camporrobles;1322;672;650
46;Valencia/València;081;Canals;13628;6835;6793
46;Valencia/València;082;Canet d'En Berenguer;6426;3281;3145
46;Valencia/València;083;Carcaixent;20479;10129;10350
46;Valencia/València;084;Càrcer;1965;947;1018
46;Valencia/València;085;Carlet;15397;7676;7721
46;Valencia/València;086;Carrícola;98;51;47
46;Valencia/València;087;Casas Altas;146;77;69
46;Valencia/València;088;Casas Bajas;188;97;91
46;Valencia/València;089;Casinos;2785;1429;1356
46;Valencia/València;090;Castelló de Rugat;2287;1164;1123
46;Valencia/València;091;Castellonet de la Conquesta;133;73;60
46;Valencia/València;092;Castielfabib;275;139;136
46;Valencia/València;093;Catadau;2761;1382;1379
46;Valencia/València;094;Catarroja;27688;13727;13961
46;Valencia/València;095;Caudete de las Fuentes;724;384;340
46;Valencia/València;096;Cerdà;361;185;176
46;Valencia/València;107;Chella;2604;1277;1327
46;Valencia/València;106;Chelva;1446;751;695
46;Valencia/València;108;Chera;527;283;244
46;Valencia/València;109;Cheste;8459;4317;4142
46;Valencia/València;111;Chiva;15004;7747;7257
46;Valencia/València;112;Chulilla;676;353;323
46;Valencia/València;097;Cofrentes;1097;560;537
46;Valencia/València;098;Corbera;3233;1613;1620
46;Valencia/València;099;Cortes de Pallás;993;532;461
46;Valencia/València;100;Cotes;357;178;179
46;Valencia/València;105;Cullera;22236;11070;11166
46;Valencia/València;113;Daimús;3054;1529;1525
46;Valencia/València;114;Domeño;718;365;353
46;Valencia/València;115;Dos Aguas;443;251;192
46;Valencia/València;116;Eliana, l';17436;8559;8877
46;Valencia/València;117;Emperador;687;359;328
46;Valencia/València;118;Enguera;5083;2535;2548
46;Valencia/València;119;Ènova, l';941;483;458
46;Valencia/València;120;Estivella;1380;685;695
46;Valencia/València;121;Estubeny;119;59;60
46;Valencia/València;122;Faura;3477;1759;1718
46;Valencia/València;123;Favara;2461;1237;1224
46;Valencia/València;126;Foios;7199;3528;3671
46;Valencia/València;128;Font de la Figuera, la;2139;1074;1065
46;Valencia/València;127;Font d'En Carròs, la;3761;1871;1890
46;Valencia/València;124;Fontanars dels Alforins;1003;517;486
46;Valencia/València;125;Fortaleny;1039;518;521
46;Valencia/València;129;Fuenterrobles;698;379;319
46;Valencia/València;131;Gandia;75514;37513;38001
46;Valencia/València;902;Gátova;364;172;192
46;Valencia/València;130;Gavarda;1113;530;583
46;Valencia/València;132;Genovés;2821;1429;1392
46;Valencia/València;133;Gestalgar;663;342;321
46;Valencia/València;134;Gilet;3314;1703;1611
46;Valencia/València;135;Godella;13071;6317;6754
46;Valencia/València;136;Godelleta;3380;1730;1650
46;Valencia/València;137;Granja de la Costera, la;331;172;159
46;Valencia/València;138;Guadasséquies;466;250;216
46;Valencia/València;139;Guadassuar;5927;2900;3027
46;Valencia/València;140;Guardamar de la Safor;489;263;226
46;Valencia/València;141;Higueruelas;516;270;246
46;Valencia/València;142;Jalance;914;477;437
46;Valencia/València;144;Jarafuel;808;409;399
46;Valencia/València;154;Llanera de Ranes;1058;532;526
46;Valencia/València;155;Llaurí;1233;616;617
46;Valencia/València;147;Llíria;22745;11526;11219
46;Valencia/València;152;Llocnou de la Corona;144;77;67
46;Valencia/València;153;Llocnou de Sant Jeroni;527;262;265
46;Valencia/València;151;Llocnou d'En Fenollet;919;481;438
46;Valencia/València;156;Llombai;2765;1391;1374
46;Valencia/València;157;Llosa de Ranes, la;3575;1841;1734
46;Valencia/València;150;Llutxent;2422;1245;1177
46;Valencia/València;148;Loriguilla;1953;1024;929
46;Valencia/València;149;Losa del Obispo;502;266;236
46;Valencia/València;158;Macastre;1249;645;604
46;Valencia/València;159;Manises;30807;15204;15603
46;Valencia/València;160;Manuel;2507;1223;1284
46;Valencia/València;161;Marines;1859;963;896
46;Valencia/València;162;Massalavés;1597;835;762
46;Valencia/València;163;Massalfassar;2473;1232;1241
46;Valencia/València;164;Massamagrell;15523;7687;7836
46;Valencia/València;165;Massanassa;9264;4594;4670
46;Valencia/València;166;Meliana;10588;5230;5358
46;Valencia/València;167;Millares;387;192;195
46;Valencia/València;168;Miramar;2620;1383;1237
46;Valencia/València;169;Mislata;43320;21093;22227
46;Valencia/València;170;Mogente/Moixent;4527;2281;2246
46;Valencia/València;171;Moncada;21842;10777;11065
46;Valencia/València;173;Montaverner;1691;850;841
46;Valencia/València;174;Montesa;1257;635;622
46;Valencia/València;175;Montitxelvo/Montichelvo;665;332;333
46;Valencia/València;176;Montroi/Montroy;2891;1528;1363
46;Valencia/València;172;Montserrat;7231;3750;3481
46;Valencia/València;177;Museros;6189;3132;3057
46;Valencia/València;178;Náquera;6204;3240;2964
46;Valencia/València;179;Navarrés;3104;1578;1526
46;Valencia/València;180;Novelé/Novetlè;856;422;434
46;Valencia/València;181;Oliva;26190;12982;13208
46;Valencia/València;183;Olleria, l';8369;4245;4124
46;Valencia/València;182;Olocau;1670;895;775
46;Valencia/València;184;Ontinyent;35621;17639;17982
46;Valencia/València;185;Otos;455;233;222
46;Valencia/València;186;Paiporta;24810;12371;12439
46;Valencia/València;187;Palma de Gandía;1652;845;807
46;Valencia/València;188;Palmera;992;529;463
46;Valencia/València;189;Palomar, el;588;293;295
46;Valencia/València;190;Paterna;67340;33479;33861
46;Valencia/València;191;Pedralba;2859;1506;1353
46;Valencia/València;192;Petrés;977;479;498
46;Valencia/València;193;Picanya;11270;5536;5734
46;Valencia/València;194;Picassent;20427;10324;10103
46;Valencia/València;195;Piles;2740;1373;1367
46;Valencia/València;196;Pinet;170;83;87
46;Valencia/València;199;Pobla de Farnals, la;7776;3912;3864
46;Valencia/València;202;Pobla de Vallbona, la;22994;11626;11368
46;Valencia/València;200;Pobla del Duc, la;2556;1237;1319
46;Valencia/València;203;Pobla Llarga, la;4536;2278;2258
46;Valencia/València;197;Polinyà de Xúquer;2526;1288;1238
46;Valencia/València;198;Potries;1020;502;518
46;Valencia/València;205;Puçol;19357;9569;9788
46;Valencia/València;201;Puebla de San Miguel;72;42;30
46;Valencia/València;204;Puig de Santa Maria, el;8844;4271;4573
46;Valencia/València;101;Quart de les Valls;1056;506;550
46;Valencia/València;102;Quart de Poblet;24864;12217;12647
46;Valencia/València;103;Quartell;1557;760;797
46;Valencia/València;104;Quatretonda;2378;1201;1177
46;Valencia/València;206;Quesa;690;355;335
46;Valencia/València;207;Rafelbunyol;8883;4400;4483
46;Valencia/València;208;Rafelcofer;1410;674;736
46;Valencia/València;209;Rafelguaraf;2422;1203;1219
46;Valencia/València;210;Ráfol de Salem;423;203;220
46;Valencia/València;212;Real;2291;1193;1098
46;Valencia/València;211;Real de Gandía;2286;1115;1171
46;Valencia/València;213;Requena;20621;10316;10305
46;Valencia/València;214;Riba-roja de Túria;21391;10866;10525
46;Valencia/València;215;Riola;1838;932;906
46;Valencia/València;216;Rocafort;6829;3359;3470
46;Valencia/València;217;Rotglà i Corberà;1144;567;577
46;Valencia/València;218;Rótova;1285;667;618
46;Valencia/València;219;Rugat;179;91;88
46;Valencia/València;220;Sagunto/Sagunt;64944;31919;33025
46;Valencia/València;221;Salem;432;215;217
46;Valencia/València;903;San Antonio de Benagéber;7981;3937;4044
46;Valencia/València;222;Sant Joanet;476;238;238
46;Valencia/València;223;Sedaví;10180;4941;5239
46;Valencia/València;224;Segart;170;86;84
46;Valencia/València;225;Sellent;401;209;192
46;Valencia/València;226;Sempere;52;24;28
46;Valencia/València;227;Senyera;1175;573;602
46;Valencia/València;228;Serra;3142;1639;1503
46;Valencia/València;229;Siete Aguas;1282;698;584
46;Valencia/València;230;Silla;18570;9237;9333
46;Valencia/València;231;Simat de la Valldigna;3362;1715;1647
46;Valencia/València;232;Sinarcas;1168;595;573
46;Valencia/València;233;Sollana;4941;2429;2512
46;Valencia/València;234;Sot de Chera;424;213;211
46;Valencia/València;235;Sueca;28252;13994;14258
46;Valencia/València;236;Sumacàrcer;1168;577;591
46;Valencia/València;237;Tavernes Blanques;9244;4516;4728
46;Valencia/València;238;Tavernes de la Valldigna;17734;8939;8795
46;Valencia/València;239;Teresa de Cofrentes;675;345;330
46;Valencia/València;240;Terrateig;300;159;141
46;Valencia/València;241;Titaguas;473;244;229
46;Valencia/València;242;Torrebaja;435;222;213
46;Valencia/València;243;Torrella;156;88;68
46;Valencia/València;244;Torrent;80107;39608;40499
46;Valencia/València;245;Torres Torres;642;350;292
46;Valencia/València;246;Tous;1265;635;630
46;Valencia/València;247;Tuéjar;1158;619;539
46;Valencia/València;248;Turís;6528;3421;3107
46;Valencia/València;249;Utiel;11915;5986;5929
46;Valencia/València;250;Valencia;786189;375291;410898
46;Valencia/València;251;Vallada;3121;1581;1540
46;Valencia/València;252;Vallanca;149;81;68
46;Valencia/València;253;Vallés;145;76;69
46;Valencia/València;254;Venta del Moro;1376;729;647
46;Valencia/València;255;Vilallonga/Villalonga;4352;2173;2179
46;Valencia/València;256;Vilamarxant;9208;4761;4447
46;Valencia/València;257;Villanueva de Castellón;7270;3593;3677
46;Valencia/València;258;Villar del Arzobispo;3597;1811;1786
46;Valencia/València;259;Villargordo del Cabriel;650;345;305
46;Valencia/València;260;Vinalesa;3284;1609;1675
46;Valencia/València;145;Xàtiva;29095;14202;14893
46;Valencia/València;143;Xeraco;5881;3004;2877
46;Valencia/València;146;Xeresa;2239;1143;1096
46;Valencia/València;110;Xirivella;28963;14301;14662
46;Valencia/València;261;Yátova;2117;1094;1023
46;Valencia/València;262;Yesa, La;252;136;116
46;Valencia/València;263;Zarra;463;252;211
47;Valladolid;001;Adalia;59;36;23
47;Valladolid;002;Aguasal;26;19;7
47;Valladolid;003;Aguilar de Campos;284;159;125
47;Valladolid;004;Alaejos;1418;753;665
47;Valladolid;005;Alcazarén;693;373;320
47;Valladolid;006;Aldea de San Miguel;227;117;110
47;Valladolid;007;Aldeamayor de San Martín;4968;2554;2414
47;Valladolid;008;Almenara de Adaja;31;13;18
47;Valladolid;009;Amusquillo;109;69;40
47;Valladolid;010;Arroyo de la Encomienda;18491;9342;9149
47;Valladolid;011;Ataquines;596;324;272
47;Valladolid;012;Bahabón;131;63;68
47;Valladolid;013;Barcial de la Loma;110;58;52
47;Valladolid;014;Barruelo del Valle;67;40;27
47;Valladolid;015;Becilla de Valderaduey;265;151;114
47;Valladolid;016;Benafarces;80;43;37
47;Valladolid;017;Bercero;218;117;101
47;Valladolid;018;Berceruelo;37;21;16
47;Valladolid;019;Berrueces;99;52;47
47;Valladolid;020;Bobadilla del Campo;311;174;137
47;Valladolid;021;Bocigas;86;45;41
47;Valladolid;022;Bocos de Duero;57;26;31
47;Valladolid;023;Boecillo;4016;2057;1959
47;Valladolid;024;Bolaños de Campos;347;185;162
47;Valladolid;025;Brahojos de Medina;129;68;61
47;Valladolid;026;Bustillo de Chaves;91;49;42
47;Valladolid;027;Cabezón de Pisuerga;3605;1844;1761
47;Valladolid;028;Cabezón de Valderaduey;35;18;17
47;Valladolid;029;Cabreros del Monte;67;38;29
47;Valladolid;030;Campaspero;1141;620;521
47;Valladolid;031;Campillo, El;223;127;96
47;Valladolid;032;Camporredondo;166;96;70
47;Valladolid;033;Canalejas de Peñafiel;264;143;121
47;Valladolid;034;Canillas de Esgueva;82;46;36
47;Valladolid;035;Carpio;1057;567;490
47;Valladolid;036;Casasola de Arión;275;155;120
47;Valladolid;037;Castrejón de Trabancos;194;96;98
47;Valladolid;038;Castrillo de Duero;133;74;59
47;Valladolid;039;Castrillo-Tejeriego;197;108;89
47;Valladolid;040;Castrobol;66;34;32
47;Valladolid;041;Castrodeza;176;108;68
47;Valladolid;042;Castromembibre;65;38;27
47;Valladolid;043;Castromonte;321;182;139
47;Valladolid;044;Castronuevo de Esgueva;393;216;177
47;Valladolid;045;Castronuño;889;443;446
47;Valladolid;046;Castroponce;144;82;62
47;Valladolid;047;Castroverde de Cerrato;233;143;90
47;Valladolid;048;Ceinos de Campos;247;136;111
47;Valladolid;049;Cervillego de la Cruz;95;52;43
47;Valladolid;050;Cigales;5071;2588;2483
47;Valladolid;051;Ciguñuela;390;206;184
47;Valladolid;052;Cistérniga;8789;4480;4309
47;Valladolid;053;Cogeces de Íscar;142;74;68
47;Valladolid;054;Cogeces del Monte;727;394;333
47;Valladolid;055;Corcos;216;115;101
47;Valladolid;056;Corrales de Duero;85;49;36
47;Valladolid;057;Cubillas de Santa Marta;296;168;128
47;Valladolid;058;Cuenca de Campos;243;128;115
47;Valladolid;059;Curiel de Duero;111;73;38
47;Valladolid;060;Encinas de Esgueva;279;158;121
47;Valladolid;061;Esguevillas de Esgueva;283;152;131
47;Valladolid;062;Fombellida;185;108;77
47;Valladolid;063;Fompedraza;118;64;54
47;Valladolid;064;Fontihoyuelo;33;20;13
47;Valladolid;065;Fresno el Viejo;946;497;449
47;Valladolid;066;Fuensaldaña;1518;780;738
47;Valladolid;067;Fuente el Sol;181;98;83
47;Valladolid;068;Fuente-Olmedo;42;19;23
47;Valladolid;069;Gallegos de Hornija;137;69;68
47;Valladolid;070;Gatón de Campos;44;23;21
47;Valladolid;071;Geria;519;255;264
47;Valladolid;073;Herrín de Campos;129;62;67
47;Valladolid;074;Hornillos de Eresma;169;92;77
47;Valladolid;075;Íscar;6536;3311;3225
47;Valladolid;076;Laguna de Duero;22601;11294;11307
47;Valladolid;077;Langayo;268;170;98
47;Valladolid;079;Llano de Olmedo;67;38;29
47;Valladolid;078;Lomoviejo;185;96;89
47;Valladolid;080;Manzanillo;49;28;21
47;Valladolid;081;Marzales;52;24;28
47;Valladolid;082;Matapozuelos;1016;516;500
47;Valladolid;083;Matilla de los Caños;94;52;42
47;Valladolid;084;Mayorga;1689;825;864
47;Valladolid;086;Medina de Rioseco;4821;2375;2446
47;Valladolid;085;Medina del Campo;21110;10223;10887
47;Valladolid;087;Megeces;447;234;213
47;Valladolid;088;Melgar de Abajo;115;64;51
47;Valladolid;089;Melgar de Arriba;181;100;81
47;Valladolid;090;Mojados;3135;1632;1503
47;Valladolid;091;Monasterio de Vega;90;48;42
47;Valladolid;092;Montealegre de Campos;127;73;54
47;Valladolid;093;Montemayor de Pililla;918;489;429
47;Valladolid;094;Moral de la Reina;191;107;84
47;Valladolid;095;Moraleja de las Panaderas;40;27;13
47;Valladolid;096;Morales de Campos;155;83;72
47;Valladolid;097;Mota del Marqués;392;200;192
47;Valladolid;098;Mucientes;699;352;347
47;Valladolid;099;Mudarra, La;166;86;80
47;Valladolid;100;Muriel;146;77;69
47;Valladolid;101;Nava del Rey;2125;1093;1032
47;Valladolid;102;Nueva Villa de las Torres;316;180;136
47;Valladolid;103;Olivares de Duero;317;174;143
47;Valladolid;104;Olmedo;3744;1836;1908
47;Valladolid;105;Olmos de Esgueva;226;119;107
47;Valladolid;106;Olmos de Peñafiel;65;36;29
47;Valladolid;109;Palazuelo de Vedija;206;109;97
47;Valladolid;110;Parrilla, La;502;251;251
47;Valladolid;111;Pedraja de Portillo, La;1143;588;555
47;Valladolid;112;Pedrajas de San Esteban;3432;1767;1665
47;Valladolid;113;Pedrosa del Rey;198;106;92
47;Valladolid;114;Peñafiel;5419;2709;2710
47;Valladolid;115;Peñaflor de Hornija;319;179;140
47;Valladolid;116;Pesquera de Duero;474;263;211
47;Valladolid;117;Piña de Esgueva;330;169;161
47;Valladolid;118;Piñel de Abajo;183;98;85
47;Valladolid;119;Piñel de Arriba;99;50;49
47;Valladolid;121;Pollos;623;329;294
47;Valladolid;122;Portillo;2441;1270;1171
47;Valladolid;123;Pozal de Gallinas;561;306;255
47;Valladolid;124;Pozaldez;499;272;227
47;Valladolid;125;Pozuelo de la Orden;63;38;25
47;Valladolid;126;Puras;55;28;27
47;Valladolid;127;Quintanilla de Arriba;149;83;66
47;Valladolid;129;Quintanilla de Onésimo;1078;562;516
47;Valladolid;130;Quintanilla de Trigueros;115;59;56
47;Valladolid;128;Quintanilla del Molar;63;28;35
47;Valladolid;131;Rábano;195;107;88
47;Valladolid;132;Ramiro;46;27;19
47;Valladolid;133;Renedo de Esgueva;3620;1853;1767
47;Valladolid;134;Roales de Campos;174;99;75
47;Valladolid;135;Robladillo;99;59;40
47;Valladolid;137;Roturas;32;19;13
47;Valladolid;138;Rubí de Bracamonte;236;130;106
47;Valladolid;139;Rueda;1312;678;634
47;Valladolid;140;Saelices de Mayorga;123;73;50
47;Valladolid;141;Salvador de Zapardiel;139;81;58
47;Valladolid;142;San Cebrián de Mazote;177;102;75
47;Valladolid;143;San Llorente;135;76;59
47;Valladolid;144;San Martín de Valvení;88;48;40
47;Valladolid;145;San Miguel del Arroyo;704;377;327
47;Valladolid;146;San Miguel del Pino;316;173;143
47;Valladolid;147;San Pablo de la Moraleja;127;66;61
47;Valladolid;148;San Pedro de Latarce;522;288;234
47;Valladolid;149;San Pelayo;44;20;24
47;Valladolid;150;San Román de Hornija;346;164;182
47;Valladolid;151;San Salvador;32;17;15
47;Valladolid;156;San Vicente del Palacio;178;97;81
47;Valladolid;152;Santa Eufemia del Arroyo;108;60;48
47;Valladolid;153;Santervás de Campos;122;68;54
47;Valladolid;154;Santibáñez de Valcorba;173;99;74
47;Valladolid;155;Santovenia de Pisuerga;4203;2155;2048
47;Valladolid;157;Sardón de Duero;634;328;306
47;Valladolid;158;Seca, La;1107;564;543
47;Valladolid;159;Serrada;1173;628;545
47;Valladolid;160;Siete Iglesias de Trabancos;488;260;228
47;Valladolid;161;Simancas;5265;2661;2604
47;Valladolid;162;Tamariz de Campos;63;34;29
47;Valladolid;163;Tiedra;319;161;158
47;Valladolid;164;Tordehumos;443;220;223
47;Valladolid;165;Tordesillas;8936;4523;4413
47;Valladolid;169;Torre de Esgueva;73;35;38
47;Valladolid;170;Torre de Peñafiel;42;25;17
47;Valladolid;166;Torrecilla de la Abadesa;296;144;152
47;Valladolid;167;Torrecilla de la Orden;262;132;130
47;Valladolid;168;Torrecilla de la Torre;32;20;12
47;Valladolid;171;Torrelobatón;456;237;219
47;Valladolid;172;Torrescárcela;167;90;77
47;Valladolid;173;Traspinedo;1076;584;492
47;Valladolid;174;Trigueros del Valle;315;171;144
47;Valladolid;175;Tudela de Duero;8683;4451;4232
47;Valladolid;176;Unión de Campos, La;272;134;138
47;Valladolid;177;Urones de Castroponce;116;66;50
47;Valladolid;178;Urueña;191;105;86
47;Valladolid;179;Valbuena de Duero;475;248;227
47;Valladolid;180;Valdearcos de la Vega;91;47;44
47;Valladolid;181;Valdenebro de los Valles;208;103;105
47;Valladolid;182;Valdestillas;1732;896;836
47;Valladolid;183;Valdunquillo;158;77;81
47;Valladolid;186;Valladolid;303905;143197;160708
47;Valladolid;184;Valoria la Buena;680;359;321
47;Valladolid;185;Valverde de Campos;106;64;42
47;Valladolid;187;Vega de Ruiponce;106;64;42
47;Valladolid;188;Vega de Valdetronco;120;67;53
47;Valladolid;189;Velascálvaro;171;94;77
47;Valladolid;190;Velilla;111;55;56
47;Valladolid;191;Velliza;122;76;46
47;Valladolid;192;Ventosa de la Cuesta;113;63;50
47;Valladolid;193;Viana de Cega;2015;1053;962
47;Valladolid;195;Villabáñez;549;312;237
47;Valladolid;196;Villabaruz de Campos;38;17;21
47;Valladolid;197;Villabrágima;1061;557;504
47;Valladolid;198;Villacarralón;78;47;31
47;Valladolid;199;Villacid de Campos;86;51;35
47;Valladolid;200;Villaco;83;53;30
47;Valladolid;203;Villafrades de Campos;72;37;35
47;Valladolid;204;Villafranca de Duero;307;159;148
47;Valladolid;205;Villafrechós;491;262;229
47;Valladolid;206;Villafuerte;105;60;45
47;Valladolid;207;Villagarcía de Campos;334;193;141
47;Valladolid;208;Villagómez la Nueva;71;37;34
47;Valladolid;209;Villalán de Campos;46;29;17
47;Valladolid;210;Villalar de los Comuneros;437;214;223
47;Valladolid;211;Villalba de la Loma;62;31;31
47;Valladolid;212;Villalba de los Alcores;420;227;193
47;Valladolid;213;Villalbarba;130;68;62
47;Valladolid;214;Villalón de Campos;1716;842;874
47;Valladolid;215;Villamuriel de Campos;58;28;30
47;Valladolid;216;Villán de Tordesillas;122;70;52
47;Valladolid;217;Villanubla;2565;1345;1220
47;Valladolid;218;Villanueva de Duero;1193;618;575
47;Valladolid;219;Villanueva de la Condesa;69;34;35
47;Valladolid;220;Villanueva de los Caballeros;188;96;92
47;Valladolid;221;Villanueva de los Infantes;113;69;44
47;Valladolid;222;Villanueva de San Mancio;86;46;40
47;Valladolid;223;Villardefrades;183;102;81
47;Valladolid;224;Villarmentero de Esgueva;104;56;48
47;Valladolid;225;Villasexmir;82;48;34
47;Valladolid;226;Villavaquerín;181;104;77
47;Valladolid;227;Villavellid;68;40;28
47;Valladolid;228;Villaverde de Medina;527;290;237
47;Valladolid;229;Villavicencio de los Caballeros;243;119;124
47;Valladolid;194;Viloria;363;186;177
47;Valladolid;230;Wamba;343;180;163
47;Valladolid;231;Zaratán;6124;3164;2960
47;Valladolid;232;Zarza, La;115;64;51
49;Zamora;002;Abezames;66;34;32
49;Zamora;003;Alcañices;1108;555;553
49;Zamora;004;Alcubilla de Nogales;135;74;61
49;Zamora;005;Alfaraz de Sayago;149;85;64
49;Zamora;006;Algodre;167;94;73
49;Zamora;007;Almaraz de Duero;398;195;203
49;Zamora;008;Almeida de Sayago;500;272;228
49;Zamora;009;Andavías;448;230;218
49;Zamora;010;Arcenillas;415;210;205
49;Zamora;011;Arcos de la Polvorosa;242;127;115
49;Zamora;012;Argañín;82;40;42
49;Zamora;013;Argujillo;283;142;141
49;Zamora;014;Arquillinos;114;58;56
49;Zamora;015;Arrabalde;252;123;129
49;Zamora;016;Aspariegos;286;132;154
49;Zamora;017;Asturianos;275;138;137
49;Zamora;018;Ayoó de Vidriales;363;186;177
49;Zamora;019;Barcial del Barco;276;152;124
49;Zamora;020;Belver de los Montes;315;170;145
49;Zamora;021;Benavente;18550;8977;9573
49;Zamora;022;Benegiles;332;176;156
49;Zamora;023;Bermillo de Sayago;1104;581;523
49;Zamora;024;Bóveda de Toro, La;781;394;387
49;Zamora;025;Bretó;184;108;76
49;Zamora;026;Bretocino;248;133;115
49;Zamora;027;Brime de Sog;155;74;81
49;Zamora;028;Brime de Urz;129;76;53
49;Zamora;029;Burganes de Valverde;695;364;331
49;Zamora;030;Bustillo del Oro;86;44;42
49;Zamora;031;Cabañas de Sayago;153;82;71
49;Zamora;032;Calzadilla de Tera;350;165;185
49;Zamora;033;Camarzana de Tera;889;443;446
49;Zamora;034;Cañizal;485;252;233
49;Zamora;035;Cañizo;249;132;117
49;Zamora;036;Carbajales de Alba;586;297;289
49;Zamora;037;Carbellino;206;109;97
49;Zamora;038;Casaseca de Campeán;105;58;47
49;Zamora;039;Casaseca de las Chanas;378;206;172
49;Zamora;040;Castrillo de la Guareña;129;68;61
49;Zamora;041;Castrogonzalo;491;261;230
49;Zamora;042;Castronuevo;247;120;127
49;Zamora;043;Castroverde de Campos;349;178;171
49;Zamora;044;Cazurra;89;48;41
49;Zamora;046;Cerecinos de Campos;308;169;139
49;Zamora;047;Cerecinos del Carrizal;121;68;53
49;Zamora;048;Cernadilla;138;68;70
49;Zamora;050;Cobreros;591;320;271
49;Zamora;052;Coomonte;203;105;98
49;Zamora;053;Coreses;1080;560;520
49;Zamora;054;Corrales del Vino;1052;519;533
49;Zamora;055;Cotanes del Monte;117;65;52
49;Zamora;056;Cubillos;322;164;158
49;Zamora;057;Cubo de Benavente;116;64;52
49;Zamora;058;Cubo de Tierra del Vino, El;355;193;162
49;Zamora;059;Cuelgamures;93;59;34
49;Zamora;061;Entrala;165;87;78
49;Zamora;062;Espadañedo;129;63;66
49;Zamora;063;Faramontanos de Tábara;365;189;176
49;Zamora;064;Fariza;570;295;275
49;Zamora;065;Fermoselle;1335;689;646
49;Zamora;066;Ferreras de Abajo;565;289;276
49;Zamora;067;Ferreras de Arriba;414;220;194
49;Zamora;068;Ferreruela;518;284;234
49;Zamora;069;Figueruela de Arriba;405;194;211
49;Zamora;071;Fonfría;837;428;409
49;Zamora;075;Fresno de la Polvorosa;153;80;73
49;Zamora;076;Fresno de la Ribera;381;205;176
49;Zamora;077;Fresno de Sayago;204;109;95
49;Zamora;078;Friera de Valverde;185;97;88
49;Zamora;079;Fuente Encalada;119;67;52
49;Zamora;080;Fuentelapeña;778;414;364
49;Zamora;082;Fuentes de Ropel;416;211;205
49;Zamora;081;Fuentesaúco;1644;814;830
49;Zamora;083;Fuentesecas;64;30;34
49;Zamora;084;Fuentespreadas;322;174;148
49;Zamora;085;Galende;1190;607;583
49;Zamora;086;Gallegos del Pan;129;75;54
49;Zamora;087;Gallegos del Río;550;299;251
49;Zamora;088;Gamones;101;56;45
49;Zamora;090;Gema;217;111;106
49;Zamora;091;Granja de Moreruela;290;154;136
49;Zamora;092;Granucillo;144;71;73
49;Zamora;093;Guarrate;351;180;171
49;Zamora;094;Hermisende;273;145;128
49;Zamora;095;Hiniesta, La;333;171;162
49;Zamora;096;Jambrina;179;93;86
49;Zamora;097;Justel;99;60;39
49;Zamora;098;Losacino;241;133;108
49;Zamora;099;Losacio;144;71;73
49;Zamora;100;Lubián;345;183;162
49;Zamora;101;Luelmo;171;88;83
49;Zamora;102;Maderal, El;214;110;104
49;Zamora;103;Madridanos;478;246;232
49;Zamora;104;Mahide;381;208;173
49;Zamora;105;Maire de Castroponce;164;89;75
49;Zamora;107;Malva;140;67;73
49;Zamora;108;Manganeses de la Lampreana;519;262;257
49;Zamora;109;Manganeses de la Polvorosa;719;355;364
49;Zamora;110;Manzanal de Arriba;398;213;185
49;Zamora;112;Manzanal de los Infantes;142;81;61
49;Zamora;111;Manzanal del Barco;142;74;68
49;Zamora;113;Matilla de Arzón;184;109;75
49;Zamora;114;Matilla la Seca;46;23;23
49;Zamora;115;Mayalde;207;111;96
49;Zamora;116;Melgar de Tera;430;220;210
49;Zamora;117;Micereces de Tera;490;246;244
49;Zamora;118;Milles de la Polvorosa;230;123;107
49;Zamora;119;Molacillos;269;144;125
49;Zamora;120;Molezuelas de la Carballeda;86;48;38
49;Zamora;121;Mombuey;427;230;197
49;Zamora;122;Monfarracinos;992;504;488
49;Zamora;123;Montamarta;604;314;290
49;Zamora;124;Moral de Sayago;278;157;121
49;Zamora;126;Moraleja de Sayago;266;142;124
49;Zamora;125;Moraleja del Vino;1660;856;804
49;Zamora;128;Morales de Rey;618;312;306
49;Zamora;129;Morales de Toro;996;523;473
49;Zamora;130;Morales de Valverde;198;103;95
49;Zamora;127;Morales del Vino;2955;1541;1414
49;Zamora;131;Moralina;302;156;146
49;Zamora;132;Moreruela de los Infanzones;372;189;183
49;Zamora;133;Moreruela de Tábara;342;169;173
49;Zamora;134;Muelas de los Caballeros;205;114;91
49;Zamora;135;Muelas del Pan;705;353;352
49;Zamora;136;Muga de Sayago;374;177;197
49;Zamora;137;Navianos de Valverde;205;114;91
49;Zamora;138;Olmillos de Castro;250;134;116
49;Zamora;139;Otero de Bodas;182;97;85
49;Zamora;141;Pajares de la Lampreana;383;186;197
49;Zamora;143;Palacios de Sanabria;261;129;132
49;Zamora;142;Palacios del Pan;262;133;129
49;Zamora;145;Pedralba de la Pradería;306;162;144
49;Zamora;146;Pego, El;327;167;160
49;Zamora;147;Peleagonzalo;271;137;134
49;Zamora;148;Peleas de Abajo;235;123;112
49;Zamora;149;Peñausende;437;220;217
49;Zamora;150;Peque;154;69;85
49;Zamora;151;Perdigón, El;740;394;346
49;Zamora;152;Pereruela;591;318;273
49;Zamora;153;Perilla de Castro;182;92;90
49;Zamora;154;Pías;143;78;65
49;Zamora;155;Piedrahita de Castro;93;50;43
49;Zamora;156;Pinilla de Toro;252;135;117
49;Zamora;157;Pino del Oro;231;125;106
49;Zamora;158;Piñero, El;240;127;113
49;Zamora;160;Pobladura de Valderaduey;41;22;19
49;Zamora;159;Pobladura del Valle;313;165;148
49;Zamora;162;Porto;194;109;85
49;Zamora;163;Pozoantiguo;262;133;129
49;Zamora;164;Pozuelo de Tábara;172;89;83
49;Zamora;165;Prado;60;34;26
49;Zamora;166;Puebla de Sanabria;1484;711;773
49;Zamora;167;Pueblica de Valverde;226;123;103
49;Zamora;170;Quintanilla de Urz;109;55;54
49;Zamora;168;Quintanilla del Monte;100;48;52
49;Zamora;169;Quintanilla del Olmo;32;16;16
49;Zamora;171;Quiruelas de Vidriales;710;356;354
49;Zamora;172;Rabanales;576;296;280
49;Zamora;173;Rábano de Aliste;414;205;209
49;Zamora;174;Requejo;156;77;79
49;Zamora;175;Revellinos;279;151;128
49;Zamora;176;Riofrío de Aliste;747;401;346
49;Zamora;177;Rionegro del Puente;306;158;148
49;Zamora;178;Roales;848;457;391
49;Zamora;179;Robleda-Cervantes;464;245;219
49;Zamora;180;Roelos de Sayago;178;84;94
49;Zamora;181;Rosinos de la Requejada;398;213;185
49;Zamora;183;Salce;104;47;57
49;Zamora;184;Samir de los Caños;191;103;88
49;Zamora;185;San Agustín del Pozo;193;101;92
49;Zamora;186;San Cebrián de Castro;272;128;144
49;Zamora;187;San Cristóbal de Entreviñas;1481;777;704
49;Zamora;188;San Esteban del Molar;125;71;54
49;Zamora;189;San Justo;247;135;112
49;Zamora;190;San Martín de Valderaduey;65;33;32
49;Zamora;191;San Miguel de la Ribera;304;153;151
49;Zamora;192;San Miguel del Valle;156;74;82
49;Zamora;193;San Pedro de Ceque;513;265;248
49;Zamora;194;San Pedro de la Nave-Almendra;379;193;186
49;Zamora;208;San Vicente de la Cabeza;427;225;202
49;Zamora;209;San Vitero;563;313;250
49;Zamora;197;Santa Clara de Avedillo;180;93;87
49;Zamora;199;Santa Colomba de las Monjas;281;140;141
49;Zamora;200;Santa Cristina de la Polvorosa;1105;561;544
49;Zamora;201;Santa Croya de Tera;326;166;160
49;Zamora;202;Santa Eufemia del Barco;197;111;86
49;Zamora;203;Santa María de la Vega;352;181;171
49;Zamora;204;Santa María de Valverde;65;26;39
49;Zamora;205;Santibáñez de Tera;411;209;202
49;Zamora;206;Santibáñez de Vidriales;1044;529;515
49;Zamora;207;Santovenia;281;139;142
49;Zamora;210;Sanzoles;556;280;276
49;Zamora;214;Tábara;832;430;402
49;Zamora;216;Tapioles;166;97;69
49;Zamora;219;Toro;9214;4493;4721
49;Zamora;220;Torre del Valle, La;155;82;73
49;Zamora;221;Torregamones;304;158;146
49;Zamora;222;Torres del Carrizal;431;218;213
49;Zamora;223;Trabazos;1002;534;468
49;Zamora;224;Trefacio;192;96;96
49;Zamora;225;Uña de Quintana;157;80;77
49;Zamora;226;Vadillo de la Guareña;285;152;133
49;Zamora;227;Valcabado;361;183;178
49;Zamora;228;Valdefinjas;57;35;22
49;Zamora;229;Valdescorriel;148;74;74
49;Zamora;230;Vallesa de la Guareña;106;58;48
49;Zamora;231;Vega de Tera;385;188;197
49;Zamora;232;Vega de Villalobos;112;55;57
49;Zamora;233;Vegalatrave;93;52;41
49;Zamora;234;Venialbo;480;262;218
49;Zamora;235;Vezdemarbán;441;227;214
49;Zamora;236;Vidayanes;92;48;44
49;Zamora;237;Videmala;180;95;85
49;Zamora;238;Villabrázaro;238;128;110
49;Zamora;239;Villabuena del Puente;786;405;381
49;Zamora;240;Villadepera;242;130;112
49;Zamora;241;Villaescusa;276;149;127
49;Zamora;242;Villafáfila;506;260;246
49;Zamora;243;Villaferrueña;117;60;57
49;Zamora;244;Villageriz;50;30;20
49;Zamora;245;Villalazán;287;140;147
49;Zamora;246;Villalba de la Lampreana;257;142;115
49;Zamora;247;Villalcampo;476;236;240
49;Zamora;248;Villalobos;261;130;131
49;Zamora;249;Villalonso;101;54;47
49;Zamora;250;Villalpando;1523;754;769
49;Zamora;251;Villalube;174;92;82
49;Zamora;252;Villamayor de Campos;337;171;166
49;Zamora;255;Villamor de los Escuderos;422;224;198
49;Zamora;256;Villanázar;299;152;147
49;Zamora;257;Villanueva de Azoague;329;170;159
49;Zamora;258;Villanueva de Campeán;122;66;56
49;Zamora;259;Villanueva de las Peras;96;54;42
49;Zamora;260;Villanueva del Campo;914;453;461
49;Zamora;263;Villar de Fallaves;51;28;23
49;Zamora;264;Villar del Buey;653;339;314
49;Zamora;261;Villaralbo;1893;958;935
49;Zamora;262;Villardeciervos;464;223;241
49;Zamora;265;Villardiegua de la Ribera;134;67;67
49;Zamora;266;Villárdiga;87;46;41
49;Zamora;267;Villardondiego;99;57;42
49;Zamora;268;Villarrín de Campos;450;243;207
49;Zamora;269;Villaseco del Pan;256;124;132
49;Zamora;270;Villavendimio;163;98;65
49;Zamora;272;Villaveza de Valverde;89;45;44
49;Zamora;271;Villaveza del Agua;218;115;103
49;Zamora;273;Viñas;211;107;104
49;Zamora;275;Zamora;63831;29908;33923
50;Zaragoza;001;Abanto;113;62;51
50;Zaragoza;002;Acered;217;128;89
50;Zaragoza;003;Agón;155;85;70
50;Zaragoza;004;Aguarón;724;379;345
50;Zaragoza;005;Aguilón;254;137;117
50;Zaragoza;006;Ainzón;1143;583;560
50;Zaragoza;007;Aladrén;52;34;18
50;Zaragoza;008;Alagón;7014;3497;3517
50;Zaragoza;009;Alarba;152;90;62
50;Zaragoza;010;Alberite de San Juan;84;51;33
50;Zaragoza;011;Albeta;145;70;75
50;Zaragoza;012;Alborge;121;62;59
50;Zaragoza;013;Alcalá de Ebro;279;132;147
50;Zaragoza;014;Alcalá de Moncayo;186;107;79
50;Zaragoza;015;Alconchel de Ariza;80;46;34
50;Zaragoza;016;Aldehuela de Liestos;57;39;18
50;Zaragoza;017;Alfajarín;2266;1166;1100
50;Zaragoza;018;Alfamén;1466;780;686
50;Zaragoza;019;Alforque;64;35;29
50;Zaragoza;020;Alhama de Aragón;1077;555;522
50;Zaragoza;021;Almochuel;34;17;17
50;Zaragoza;022;Almolda, La;593;298;295
50;Zaragoza;023;Almonacid de la Cuba;255;132;123
50;Zaragoza;024;Almonacid de la Sierra;731;405;326
50;Zaragoza;025;Almunia de Doña Godina, La;7680;3915;3765
50;Zaragoza;026;Alpartir;564;288;276
50;Zaragoza;027;Ambel;256;124;132
50;Zaragoza;028;Anento;105;68;37
50;Zaragoza;029;Aniñón;761;417;344
50;Zaragoza;030;Añón de Moncayo;206;121;85
50;Zaragoza;031;Aranda de Moncayo;187;117;70
50;Zaragoza;032;Arándiga;340;175;165
50;Zaragoza;033;Ardisa;74;48;26
50;Zaragoza;034;Ariza;1196;615;581
50;Zaragoza;035;Artieda;81;48;33
50;Zaragoza;036;Asín;104;51;53
50;Zaragoza;037;Atea;112;64;48
50;Zaragoza;038;Ateca;1968;1015;953
50;Zaragoza;039;Azuara;606;330;276
50;Zaragoza;040;Badules;95;55;40
50;Zaragoza;041;Bagüés;13;8;5
50;Zaragoza;042;Balconchán;13;6;7
50;Zaragoza;043;Bárboles;340;187;153
50;Zaragoza;044;Bardallur;282;139;143
50;Zaragoza;045;Belchite;1562;793;769
50;Zaragoza;046;Belmonte de Gracián;211;117;94
50;Zaragoza;047;Berdejo;53;33;20
50;Zaragoza;048;Berrueco;37;19;18
50;Zaragoza;901;Biel;148;86;62
50;Zaragoza;050;Bijuesca;100;64;36
50;Zaragoza;051;Biota;1002;500;502
50;Zaragoza;052;Bisimbre;97;51;46
50;Zaragoza;053;Boquiñeni;871;445;426
50;Zaragoza;054;Bordalba;62;41;21
50;Zaragoza;055;Borja;4930;2462;2468
50;Zaragoza;056;Botorrita;484;267;217
50;Zaragoza;057;Brea de Aragón;1719;869;850
50;Zaragoza;058;Bubierca;76;37;39
50;Zaragoza;059;Bujaraloz;1008;528;480
50;Zaragoza;060;Bulbuente;236;126;110
50;Zaragoza;061;Bureta;253;137;116
50;Zaragoza;062;Burgo de Ebro, El;2348;1196;1152
50;Zaragoza;063;Buste, El;66;36;30
50;Zaragoza;064;Cabañas de Ebro;527;283;244
50;Zaragoza;065;Cabolafuente;38;21;17
50;Zaragoza;066;Cadrete;3602;1892;1710
50;Zaragoza;067;Calatayud;19724;9730;9994
50;Zaragoza;068;Calatorao;2864;1502;1362
50;Zaragoza;069;Calcena;79;50;29
50;Zaragoza;070;Calmarza;77;44;33
50;Zaragoza;071;Campillo de Aragón;141;77;64
50;Zaragoza;072;Carenas;172;90;82
50;Zaragoza;073;Cariñena;3389;1728;1661
50;Zaragoza;074;Caspe;9867;5098;4769
50;Zaragoza;075;Castejón de Alarba;95;58;37
50;Zaragoza;076;Castejón de las Armas;101;53;48
50;Zaragoza;077;Castejón de Valdejasa;228;117;111
50;Zaragoza;078;Castiliscar;280;142;138
50;Zaragoza;079;Cervera de la Cañada;311;169;142
50;Zaragoza;080;Cerveruela;33;21;12
50;Zaragoza;081;Cetina;645;328;317
50;Zaragoza;092;Chiprana;498;271;227
50;Zaragoza;093;Chodes;132;72;60
50;Zaragoza;082;Cimballa;113;57;56
50;Zaragoza;083;Cinco Olivas;113;56;57
50;Zaragoza;084;Clarés de Ribota;80;45;35
50;Zaragoza;085;Codo;194;95;99
50;Zaragoza;086;Codos;185;113;72
50;Zaragoza;087;Contamina;36;21;15
50;Zaragoza;088;Cosuenda;396;209;187
50;Zaragoza;089;Cuarte de Huerva;12141;6262;5879
50;Zaragoza;090;Cubel;189;93;96
50;Zaragoza;091;Cuerlas, Las;50;27;23
50;Zaragoza;094;Daroca;2113;1040;1073
50;Zaragoza;095;Ejea de los Caballeros;16754;8588;8166
50;Zaragoza;096;Embid de Ariza;47;22;25
50;Zaragoza;098;Encinacorba;222;112;110
50;Zaragoza;099;Épila;4545;2379;2166
50;Zaragoza;100;Erla;371;186;185
50;Zaragoza;101;Escatrón;1084;531;553
50;Zaragoza;102;Fabara;1227;666;561
50;Zaragoza;104;Farlete;414;206;208
50;Zaragoza;105;Fayón;355;185;170
50;Zaragoza;106;Fayos, Los;151;78;73
50;Zaragoza;107;Figueruelas;1229;621;608
50;Zaragoza;108;Fombuena;51;31;20
50;Zaragoza;109;Frago, El;104;65;39
50;Zaragoza;110;Frasno, El;415;225;190
50;Zaragoza;111;Fréscano;205;109;96
50;Zaragoza;113;Fuendejalón;833;448;385
50;Zaragoza;114;Fuendetodos;144;76;68
50;Zaragoza;115;Fuentes de Ebro;4594;2385;2209
50;Zaragoza;116;Fuentes de Jiloca;219;120;99
50;Zaragoza;117;Gallocanta;160;90;70
50;Zaragoza;118;Gallur;2695;1354;1341
50;Zaragoza;119;Gelsa;1087;567;520
50;Zaragoza;120;Godojos;35;20;15
50;Zaragoza;121;Gotor;334;177;157
50;Zaragoza;122;Grisel;74;45;29
50;Zaragoza;123;Grisén;656;332;324
50;Zaragoza;124;Herrera de los Navarros;550;290;260
50;Zaragoza;125;Ibdes;455;240;215
50;Zaragoza;126;Illueca;3139;1554;1585
50;Zaragoza;128;Isuerre;35;22;13
50;Zaragoza;129;Jaraba;324;164;160
50;Zaragoza;130;Jarque;473;259;214
50;Zaragoza;131;Jaulín;260;140;120
50;Zaragoza;132;Joyosa, La;1042;534;508
50;Zaragoza;133;Lagata;124;69;55
50;Zaragoza;134;Langa del Castillo;137;69;68
50;Zaragoza;135;Layana;114;62;52
50;Zaragoza;136;Lécera;729;396;333
50;Zaragoza;138;Lechón;56;33;23
50;Zaragoza;137;Leciñena;1220;619;601
50;Zaragoza;139;Letux;359;202;157
50;Zaragoza;140;Litago;174;97;77
50;Zaragoza;141;Lituénigo;123;65;58
50;Zaragoza;142;Lobera de Onsella;42;26;16
50;Zaragoza;143;Longares;847;499;348
50;Zaragoza;144;Longás;36;25;11
50;Zaragoza;146;Lucena de Jalón;242;132;110
50;Zaragoza;147;Luceni;1006;518;488
50;Zaragoza;148;Luesia;334;186;148
50;Zaragoza;149;Luesma;43;26;17
50;Zaragoza;150;Lumpiaque;886;456;430
50;Zaragoza;151;Luna;756;400;356
50;Zaragoza;152;Maella;1953;1042;911
50;Zaragoza;153;Magallón;1174;603;571
50;Zaragoza;154;Mainar;152;81;71
50;Zaragoza;155;Malanquilla;113;71;42
50;Zaragoza;156;Maleján;267;137;130
50;Zaragoza;160;Mallén;3292;1732;1560
50;Zaragoza;157;Malón;359;183;176
50;Zaragoza;159;Maluenda;1034;509;525
50;Zaragoza;161;Manchones;130;75;55
50;Zaragoza;162;Mara;182;93;89
50;Zaragoza;163;María de Huerva;5425;2792;2633
50;Zaragoza;902;Marracos;94;52;42
50;Zaragoza;164;Mediana de Aragón;457;219;238
50;Zaragoza;165;Mequinenza;2311;1180;1131
50;Zaragoza;166;Mesones de Isuela;291;141;150
50;Zaragoza;167;Mezalocha;235;135;100
50;Zaragoza;168;Mianos;31;19;12
50;Zaragoza;169;Miedes de Aragón;479;264;215
50;Zaragoza;170;Monegrillo;431;241;190
50;Zaragoza;171;Moneva;112;66;46
50;Zaragoza;172;Monreal de Ariza;222;126;96
50;Zaragoza;173;Monterde;278;157;121
50;Zaragoza;174;Montón;105;63;42
50;Zaragoza;175;Morata de Jalón;1204;592;612
50;Zaragoza;176;Morata de Jiloca;256;148;108
50;Zaragoza;177;Morés;362;195;167
50;Zaragoza;178;Moros;397;208;189
50;Zaragoza;179;Moyuela;280;153;127
50;Zaragoza;180;Mozota;121;60;61
50;Zaragoza;181;Muel;1335;684;651
50;Zaragoza;182;Muela, La;4980;2578;2402
50;Zaragoza;183;Munébrega;405;222;183
50;Zaragoza;184;Murero;131;76;55
50;Zaragoza;185;Murillo de Gállego;166;103;63
50;Zaragoza;186;Navardún;41;25;16
50;Zaragoza;187;Nigüella;78;47;31
50;Zaragoza;188;Nombrevilla;34;19;15
50;Zaragoza;189;Nonaspe;1008;538;470
50;Zaragoza;190;Novallas;913;495;418
50;Zaragoza;191;Novillas;578;283;295
50;Zaragoza;192;Nuévalos;327;181;146
50;Zaragoza;193;Nuez de Ebro;826;420;406
50;Zaragoza;194;Olvés;117;67;50
50;Zaragoza;195;Orcajo;56;38;18
50;Zaragoza;196;Orera;127;65;62
50;Zaragoza;197;Orés;112;66;46
50;Zaragoza;198;Oseja;61;36;25
50;Zaragoza;199;Osera de Ebro;407;205;202
50;Zaragoza;200;Paniza;691;367;324
50;Zaragoza;201;Paracuellos de Jiloca;590;305;285
50;Zaragoza;202;Paracuellos de la Ribera;168;87;81
50;Zaragoza;203;Pastriz;1280;616;664
50;Zaragoza;204;Pedrola;3560;1850;1710
50;Zaragoza;205;Pedrosas, Las;107;52;55
50;Zaragoza;206;Perdiguera;597;314;283
50;Zaragoza;207;Piedratajada;114;60;54
50;Zaragoza;208;Pina de Ebro;2535;1304;1231
50;Zaragoza;209;Pinseque;3606;1891;1715
50;Zaragoza;210;Pintanos, Los;44;26;18
50;Zaragoza;211;Plasencia de Jalón;342;187;155
50;Zaragoza;212;Pleitas;45;21;24
50;Zaragoza;213;Plenas;111;62;49
50;Zaragoza;214;Pomer;32;21;11
50;Zaragoza;215;Pozuel de Ariza;24;15;9
50;Zaragoza;216;Pozuelo de Aragón;288;154;134
50;Zaragoza;217;Pradilla de Ebro;560;300;260
50;Zaragoza;218;Puebla de Albortón;124;77;47
50;Zaragoza;219;Puebla de Alfindén, La;5948;3062;2886
50;Zaragoza;220;Puendeluna;51;27;24
50;Zaragoza;221;Purujosa;37;25;12
50;Zaragoza;222;Quinto;2020;1031;989
50;Zaragoza;223;Remolinos;1143;595;548
50;Zaragoza;224;Retascón;79;48;31
50;Zaragoza;225;Ricla;3122;1635;1487
50;Zaragoza;227;Romanos;111;62;49
50;Zaragoza;228;Rueda de Jalón;332;180;152
50;Zaragoza;229;Ruesca;73;37;36
50;Zaragoza;241;Sabiñán;743;397;346
50;Zaragoza;230;Sádaba;1404;718;686
50;Zaragoza;231;Salillas de Jalón;324;164;160
50;Zaragoza;232;Salvatierra de Esca;215;107;108
50;Zaragoza;233;Samper del Salz;123;72;51
50;Zaragoza;234;San Martín de la Virgen de Moncayo;279;158;121
50;Zaragoza;235;San Mateo de Gállego;3051;1574;1477
50;Zaragoza;236;Santa Cruz de Grío;135;74;61
50;Zaragoza;237;Santa Cruz de Moncayo;136;72;64
50;Zaragoza;238;Santa Eulalia de Gállego;110;57;53
50;Zaragoza;239;Santed;66;42;24
50;Zaragoza;240;Sástago;1217;620;597
50;Zaragoza;242;Sediles;105;63;42
50;Zaragoza;243;Sestrica;402;229;173
50;Zaragoza;244;Sierra de Luna;267;143;124
50;Zaragoza;245;Sigüés;103;56;47
50;Zaragoza;246;Sisamón;36;24;12
50;Zaragoza;247;Sobradiel;1077;527;550
50;Zaragoza;248;Sos del Rey Católico;614;314;300
50;Zaragoza;249;Tabuenca;352;201;151
50;Zaragoza;250;Talamantes;58;26;32
50;Zaragoza;251;Tarazona;10759;5331;5428
50;Zaragoza;252;Tauste;6941;3445;3496
50;Zaragoza;253;Terrer;520;281;239
50;Zaragoza;254;Tierga;200;110;90
50;Zaragoza;255;Tobed;243;129;114
50;Zaragoza;256;Torralba de los Frailes;86;46;40
50;Zaragoza;257;Torralba de Ribota;186;106;80
50;Zaragoza;258;Torralbilla;63;36;27
50;Zaragoza;259;Torrehermosa;69;38;31
50;Zaragoza;260;Torrelapaja;35;21;14
50;Zaragoza;261;Torrellas;269;142;127
50;Zaragoza;262;Torres de Berrellén;1491;777;714
50;Zaragoza;263;Torrijo de la Cañada;245;141;104
50;Zaragoza;264;Tosos;205;113;92
50;Zaragoza;265;Trasmoz;79;42;37
50;Zaragoza;266;Trasobares;128;79;49
50;Zaragoza;267;Uncastillo;684;328;356
50;Zaragoza;268;Undués de Lerda;61;38;23
50;Zaragoza;269;Urrea de Jalón;398;212;186
50;Zaragoza;270;Urriés;37;21;16
50;Zaragoza;271;Used;288;159;129
50;Zaragoza;272;Utebo;18430;9211;9219
50;Zaragoza;274;Val de San Martín;70;41;29
50;Zaragoza;273;Valdehorna;30;15;15
50;Zaragoza;275;Valmadrid;128;82;46
50;Zaragoza;276;Valpalmas;142;67;75
50;Zaragoza;277;Valtorres;66;32;34
50;Zaragoza;278;Velilla de Ebro;250;137;113
50;Zaragoza;279;Velilla de Jiloca;120;61;59
50;Zaragoza;280;Vera de Moncayo;388;199;189
50;Zaragoza;281;Vierlas;96;51;45
50;Zaragoza;283;Villadoz;90;56;34
50;Zaragoza;284;Villafeliche;195;102;93
50;Zaragoza;285;Villafranca de Ebro;836;414;422
50;Zaragoza;286;Villalba de Perejil;98;49;49
50;Zaragoza;287;Villalengua;348;184;164
50;Zaragoza;903;Villamayor de Gállego;2793;1411;1382
50;Zaragoza;288;Villanueva de Gállego;4614;2330;2284
50;Zaragoza;290;Villanueva de Huerva;491;257;234
50;Zaragoza;289;Villanueva de Jiloca;57;28;29
50;Zaragoza;291;Villar de los Navarros;113;62;51
50;Zaragoza;292;Villarreal de Huerva;247;129;118
50;Zaragoza;293;Villarroya de la Sierra;503;269;234
50;Zaragoza;294;Villarroya del Campo;80;45;35
50;Zaragoza;282;Vilueña, La;111;57;54
50;Zaragoza;295;Vistabella;45;29;16
50;Zaragoza;296;Zaida, La;473;233;240
50;Zaragoza;297;Zaragoza;664953;319795;345158
50;Zaragoza;298;Zuera;7820;4028;3792
