02;Albacete;001;Abengibre;761;366;395
02;Albacete;002;Alatoz;582;325;257
02;Albacete;003;Albacete;172426;84366;88060
02;Albacete;004;Albatana;714;367;347
02;Albacete;005;Alborea;710;365;345
02;Albacete;006;Alcadozo;688;367;321
02;Albacete;007;Alcalá del Júcar;1217;653;564
02;Albacete;008;Alcaraz;1463;741;722
02;Albacete;009;Almansa;24800;12332;12468
02;Albacete;010;Alpera;2289;1177;1112
02;Albacete;011;Ayna;690;368;322
02;Albacete;012;Balazote;2346;1202;1144
02;Albacete;014;Ballestero, El;427;218;209
02;Albacete;013;Balsa de Ves;155;87;68
02;Albacete;015;Barrax;1903;971;932
02;Albacete;016;Bienservida;634;332;302
02;Albacete;017;Bogarra;920;485;435
02;Albacete;018;Bonete;1123;579;544
02;Albacete;019;Bonillo, El;2889;1468;1421
02;Albacete;020;Carcelén;518;278;240
02;Albacete;021;Casas de Juan Núñez;1318;693;625
02;Albacete;022;Casas de Lázaro;380;212;168
02;Albacete;023;Casas de Ves;654;338;316
02;Albacete;024;Casas-Ibáñez;4555;2326;2229
02;Albacete;025;Caudete;10115;5146;4969
02;Albacete;026;Cenizate;1204;617;587
02;Albacete;029;Chinchilla de Monte-Aragón;4172;2176;1996
02;Albacete;027;Corral-Rubio;351;192;159
02;Albacete;028;Cotillas;139;72;67
02;Albacete;030;Elche de la Sierra;3711;1860;1851
02;Albacete;031;Férez;696;349;347
02;Albacete;032;Fuensanta;310;174;136
02;Albacete;033;Fuente-Álamo;2574;1354;1220
02;Albacete;034;Fuentealbilla;1876;949;927
02;Albacete;035;Gineta, La;2509;1292;1217
02;Albacete;036;Golosalvo;111;59;52
02;Albacete;037;Hellín;30419;15184;15235
02;Albacete;038;Herrera, La;340;173;167
02;Albacete;039;Higueruela;1222;630;592
02;Albacete;040;Hoya-Gonzalo;666;360;306
02;Albacete;041;Jorquera;377;198;179
02;Albacete;042;Letur;973;474;499
02;Albacete;043;Lezuza;1458;750;708
02;Albacete;044;Liétor;1279;667;612
02;Albacete;045;Madrigueras;4671;2400;2271
02;Albacete;046;Mahora;1355;691;664
02;Albacete;047;Masegoso;121;63;58
02;Albacete;048;Minaya;1543;798;745
02;Albacete;049;Molinicos;893;459;434
02;Albacete;050;Montalvos;108;57;51
02;Albacete;051;Montealegre del Castillo;2092;1061;1031
02;Albacete;052;Motilleja;550;293;257
02;Albacete;053;Munera;3627;1842;1785
02;Albacete;054;Navas de Jorquera;525;270;255
02;Albacete;055;Nerpio;1311;715;596
02;Albacete;056;Ontur;2111;1054;1057
02;Albacete;057;Ossa de Montiel;2422;1203;1219
02;Albacete;058;Paterna del Madera;375;205;170
02;Albacete;060;Peñas de San Pedro;1428;830;598
02;Albacete;059;Peñascosa;333;176;157
02;Albacete;061;Pétrola;713;371;342
02;Albacete;062;Povedilla;463;248;215
02;Albacete;901;Pozo Cañada;2800;1405;1395
02;Albacete;063;Pozohondo;1698;888;810
02;Albacete;064;Pozo-Lorente;409;208;201
02;Albacete;065;Pozuelo;531;282;249
02;Albacete;066;Recueja, La;279;144;135
02;Albacete;067;Riópar;1410;718;692
02;Albacete;068;Robledo;390;210;180
02;Albacete;069;Roda, La;15748;7966;7782
02;Albacete;070;Salobre;523;270;253
02;Albacete;071;San Pedro;1232;627;605
02;Albacete;072;Socovos;1819;932;887
02;Albacete;073;Tarazona de la Mancha;6460;3277;3183
02;Albacete;074;Tobarra;7822;3979;3843
02;Albacete;075;Valdeganga;1976;1008;968
02;Albacete;076;Vianos;368;189;179
02;Albacete;077;Villa de Ves;63;35;28
02;Albacete;078;Villalgordo del Júcar;1128;590;538
02;Albacete;079;Villamalea;4082;2049;2033
02;Albacete;080;Villapalacios;628;324;304
02;Albacete;081;Villarrobledo;25589;12695;12894
02;Albacete;082;Villatoya;110;66;44
02;Albacete;083;Villavaliente;234;136;98
02;Albacete;084;Villaverde de Guadalimar;359;192;167
02;Albacete;085;Viveros;337;175;162
02;Albacete;086;Yeste;2818;1448;1370
03;Alicante/Alacant;002;Agost;4729;2379;2350
03;Alicante/Alacant;003;Agres;565;306;259
03;Alicante/Alacant;004;Aigües;921;494;427
03;Alicante/Alacant;005;Albatera;11756;5979;5777
03;Alicante/Alacant;006;Alcalalí;1291;647;644
03;Alicante/Alacant;007;Alcocer de Planes;221;115;106
03;Alicante/Alacant;008;Alcoleja;194;101;93
03;Alicante/Alacant;009;Alcoy/Alcoi;59198;28804;30394
03;Alicante/Alacant;010;Alfafara;399;195;204
03;Alicante/Alacant;011;Alfàs del Pi, l';21494;10713;10781
03;Alicante/Alacant;012;Algorfa;3222;1626;1596
03;Alicante/Alacant;013;Algueña;1391;688;703
03;Alicante/Alacant;014;Alicante/Alacant;330525;160456;170069
03;Alicante/Alacant;015;Almoradí;20138;10188;9950
03;Alicante/Alacant;016;Almudaina;119;62;57
03;Alicante/Alacant;017;Alqueria d'Asnar, l';517;240;277
03;Alicante/Alacant;018;Altea;21739;10677;11062
03;Alicante/Alacant;019;Aspe;20482;10319;10163
03;Alicante/Alacant;001;Atzúbia, l';689;356;333
03;Alicante/Alacant;020;Balones;129;66;63
03;Alicante/Alacant;021;Banyeres de Mariola;7108;3554;3554
03;Alicante/Alacant;022;Benasau;158;74;84
03;Alicante/Alacant;023;Beneixama;1712;852;860
03;Alicante/Alacant;024;Benejúzar;5364;2682;2682
03;Alicante/Alacant;025;Benferri;1920;1008;912
03;Alicante/Alacant;026;Beniarbeig;1917;953;964
03;Alicante/Alacant;027;Beniardá;202;101;101
03;Alicante/Alacant;028;Beniarrés;1164;586;578
03;Alicante/Alacant;030;Benidoleig;1117;555;562
03;Alicante/Alacant;031;Benidorm;66642;33131;33511
03;Alicante/Alacant;032;Benifallim;114;64;50
03;Alicante/Alacant;033;Benifato;158;80;78
03;Alicante/Alacant;029;Benigembla;419;212;207
03;Alicante/Alacant;034;Benijófar;3163;1549;1614
03;Alicante/Alacant;035;Benilloba;769;391;378
03;Alicante/Alacant;036;Benillup;100;46;54
03;Alicante/Alacant;037;Benimantell;494;240;254
03;Alicante/Alacant;038;Benimarfull;427;217;210
03;Alicante/Alacant;039;Benimassot;99;55;44
03;Alicante/Alacant;040;Benimeli;384;179;205
03;Alicante/Alacant;041;Benissa;11000;5424;5576
03;Alicante/Alacant;042;Benitachell/Poble Nou de Benitatxell, el;4104;2051;2053
03;Alicante/Alacant;043;Biar;3647;1794;1853
03;Alicante/Alacant;044;Bigastro;6724;3411;3313
03;Alicante/Alacant;045;Bolulla;412;212;200
03;Alicante/Alacant;046;Busot;2975;1517;1458
03;Alicante/Alacant;049;Callosa de Segura;18497;9336;9161
03;Alicante/Alacant;048;Callosa d'en Sarrià;7146;3610;3536
03;Alicante/Alacant;047;Calp;19591;9889;9702
03;Alicante/Alacant;050;Campello, el;27384;13340;14044
03;Alicante/Alacant;051;Campo de Mirra/Camp de Mirra, el;440;230;210
03;Alicante/Alacant;052;Cañada;1245;623;622
03;Alicante/Alacant;053;Castalla;9859;4968;4891
03;Alicante/Alacant;054;Castell de Castells;449;225;224
03;Alicante/Alacant;075;Castell de Guadalest, el;220;113;107
03;Alicante/Alacant;055;Catral;8551;4315;4236
03;Alicante/Alacant;056;Cocentaina;11432;5782;5650
03;Alicante/Alacant;057;Confrides;207;119;88
03;Alicante/Alacant;058;Cox;7193;3687;3506
03;Alicante/Alacant;059;Crevillent;28691;14525;14166
03;Alicante/Alacant;061;Daya Nueva;1750;888;862
03;Alicante/Alacant;062;Daya Vieja;672;348;324
03;Alicante/Alacant;063;Dénia;41465;20237;21228
03;Alicante/Alacant;064;Dolores;7264;3631;3633
03;Alicante/Alacant;065;Elche/Elx;227659;112824;114835
03;Alicante/Alacant;066;Elda;52745;25736;27009
03;Alicante/Alacant;067;Facheca;107;56;51
03;Alicante/Alacant;068;Famorca;58;29;29
03;Alicante/Alacant;069;Finestrat;6090;3126;2964
03;Alicante/Alacant;077;Fondó de les Neus, el/Hondón de las Nieves;2493;1252;1241
03;Alicante/Alacant;070;Formentera del Segura;3995;2024;1971
03;Alicante/Alacant;072;Gaianes;452;234;218
03;Alicante/Alacant;071;Gata de Gorgos;5825;2937;2888
03;Alicante/Alacant;073;Gorga;267;149;118
03;Alicante/Alacant;074;Granja de Rocamora;2461;1286;1175
03;Alicante/Alacant;076;Guardamar del Segura;15386;7577;7809
03;Alicante/Alacant;078;Hondón de los Frailes;1165;605;560
03;Alicante/Alacant;079;Ibi;23365;11718;11647
03;Alicante/Alacant;080;Jacarilla;1939;980;959
03;Alicante/Alacant;082;Jávea/Xàbia;27225;13506;13719
03;Alicante/Alacant;083;Jijona/Xixona;7057;3431;3626
03;Alicante/Alacant;085;Llíber;1110;546;564
03;Alicante/Alacant;084;Lorcha/Orxa, l';627;310;317
03;Alicante/Alacant;086;Millena;221;116;105
03;Alicante/Alacant;088;Monforte del Cid;7500;3924;3576
03;Alicante/Alacant;089;Monóvar/Monòver;12272;6122;6150
03;Alicante/Alacant;903;Montesinos, Los;4912;2496;2416
03;Alicante/Alacant;091;Murla;486;225;261
03;Alicante/Alacant;092;Muro de Alcoy;9307;4615;4692
03;Alicante/Alacant;090;Mutxamel;24487;12203;12284
03;Alicante/Alacant;093;Novelda;26054;12933;13121
03;Alicante/Alacant;094;Nucia, la;19967;10110;9857
03;Alicante/Alacant;095;Ondara;6647;3322;3325
03;Alicante/Alacant;096;Onil;7494;3742;3752
03;Alicante/Alacant;097;Orba;2085;1030;1055
03;Alicante/Alacant;099;Orihuela;80359;40105;40254
03;Alicante/Alacant;098;Orxeta;778;396;382
03;Alicante/Alacant;100;Parcent;985;486;499
03;Alicante/Alacant;101;Pedreguer;7431;3692;3739
03;Alicante/Alacant;102;Pego;10158;5095;5063
03;Alicante/Alacant;103;Penàguila;328;173;155
03;Alicante/Alacant;104;Petrer;34533;17191;17342
03;Alicante/Alacant;902;Pilar de la Horadada;21348;11001;10347
03;Alicante/Alacant;105;Pinós, el/Pinoso;7627;3826;3801
03;Alicante/Alacant;106;Planes;725;383;342
03;Alicante/Alacant;901;Poblets, els;3246;1562;1684
03;Alicante/Alacant;107;Polop;4549;2347;2202
03;Alicante/Alacant;060;Quatretondeta;113;62;51
03;Alicante/Alacant;109;Rafal;4218;2111;2107
03;Alicante/Alacant;110;Ràfol d'Almúnia, el;630;317;313
03;Alicante/Alacant;111;Redován;7765;4025;3740
03;Alicante/Alacant;112;Relleu;1258;623;635
03;Alicante/Alacant;113;Rojales;17622;8932;8690
03;Alicante/Alacant;114;Romana, la;2411;1240;1171
03;Alicante/Alacant;115;Sagra;414;212;202
03;Alicante/Alacant;116;Salinas;1569;797;772
03;Alicante/Alacant;118;San Fulgencio;7384;3772;3612
03;Alicante/Alacant;904;San Isidro;1915;974;941
03;Alicante/Alacant;120;San Miguel de Salinas;6193;3097;3096
03;Alicante/Alacant;122;San Vicente del Raspeig/Sant Vicent del Raspeig;56715;28075;28640
03;Alicante/Alacant;117;Sanet y Negrals;649;327;322
03;Alicante/Alacant;119;Sant Joan d'Alacant;22897;11073;11824
03;Alicante/Alacant;121;Santa Pola;31309;15707;15602
03;Alicante/Alacant;123;Sax;9700;4903;4797
03;Alicante/Alacant;124;Sella;584;311;273
03;Alicante/Alacant;125;Senija;577;295;282
03;Alicante/Alacant;127;Tàrbena;636;329;307
03;Alicante/Alacant;128;Teulada;10654;5301;5353
03;Alicante/Alacant;129;Tibi;1634;862;772
03;Alicante/Alacant;130;Tollos;53;29;24
03;Alicante/Alacant;131;Tormos;323;160;163
03;Alicante/Alacant;132;Torremanzanas/Torre de les Maçanes, la;727;380;347
03;Alicante/Alacant;133;Torrevieja;84213;42302;41911
03;Alicante/Alacant;134;Vall d'Alcalà, la;171;93;78
03;Alicante/Alacant;136;Vall de Gallinera;582;314;268
03;Alicante/Alacant;137;Vall de Laguar, la;801;404;397
03;Alicante/Alacant;135;Vall d'Ebo, la;243;127;116
03;Alicante/Alacant;138;Verger, el;4515;2250;2265
03;Alicante/Alacant;139;Villajoyosa/Vila Joiosa, la;33580;16774;16806
03;Alicante/Alacant;140;Villena;34163;17047;17116
03;Alicante/Alacant;081;Xaló;2648;1312;1336
04;Almería;001;Abla;1294;664;630
04;Almería;002;Abrucena;1208;615;593
04;Almería;003;Adra;24713;12489;12224
04;Almería;004;Albánchez;796;406;390
04;Almería;005;Alboloduy;613;299;314
04;Almería;006;Albox;11144;5664;5480
04;Almería;007;Alcolea;815;428;387
04;Almería;008;Alcóntar;572;316;256
04;Almería;009;Alcudia de Monteagud;158;75;83
04;Almería;010;Alhabia;677;351;326
04;Almería;011;Alhama de Almería;3687;1851;1836
04;Almería;012;Alicún;217;110;107
04;Almería;013;Almería;194515;94530;99985
04;Almería;014;Almócita;172;83;89
04;Almería;015;Alsodux;134;75;59
04;Almería;016;Antas;3159;1576;1583
04;Almería;017;Arboleas;4538;2271;2267
04;Almería;018;Armuña de Almanzora;326;160;166
04;Almería;019;Bacares;272;140;132
04;Almería;904;Balanegra;2678;1380;1298
04;Almería;020;Bayárcal;323;178;145
04;Almería;021;Bayarque;220;112;108
04;Almería;022;Bédar;885;432;453
04;Almería;023;Beires;114;55;59
04;Almería;024;Benahadux;4185;2074;2111
04;Almería;026;Benitagla;69;40;29
04;Almería;027;Benizalón;280;148;132
04;Almería;028;Bentarique;252;144;108
04;Almería;029;Berja;12380;6228;6152
04;Almería;030;Canjáyar;1279;659;620
04;Almería;031;Cantoria;3371;1707;1664
04;Almería;032;Carboneras;7818;4016;3802
04;Almería;033;Castro de Filabres;139;66;73
04;Almería;036;Chercos;267;138;129
04;Almería;037;Chirivel;1601;812;789
04;Almería;034;Cóbdar;169;100;69
04;Almería;035;Cuevas del Almanzora;13362;6923;6439
04;Almería;038;Dalías;3978;1966;2012
04;Almería;902;Ejido, El;88752;47313;41439
04;Almería;041;Enix;433;237;196
04;Almería;043;Felix;658;374;284
04;Almería;044;Fines;2079;1082;997
04;Almería;045;Fiñana;2070;1047;1023
04;Almería;046;Fondón;1017;530;487
04;Almería;047;Gádor;3030;1566;1464
04;Almería;048;Gallardos, Los;2867;1457;1410
04;Almería;049;Garrucha;8655;4481;4174
04;Almería;050;Gérgal;1037;556;481
04;Almería;051;Huécija;513;248;265
04;Almería;052;Huércal de Almería;17068;8721;8347
04;Almería;053;Huércal-Overa;18589;9219;9370
04;Almería;054;Illar;386;205;181
04;Almería;055;Instinción;444;217;227
04;Almería;056;Laroya;176;100;76
04;Almería;057;Láujar de Andarax;1551;774;777
04;Almería;058;Líjar;411;215;196
04;Almería;059;Lubrín;1484;724;760
04;Almería;060;Lucainena de las Torres;569;304;265
04;Almería;061;Lúcar;754;373;381
04;Almería;062;Macael;5628;2884;2744
04;Almería;063;María;1294;662;632
04;Almería;064;Mojácar;6490;3227;3263
04;Almería;903;Mojonera, La;8740;4810;3930
04;Almería;065;Nacimiento;483;241;242
04;Almería;066;Níjar;28579;15469;13110
04;Almería;067;Ohanes;651;320;331
04;Almería;068;Olula de Castro;194;104;90
04;Almería;069;Olula del Río;6216;3203;3013
04;Almería;070;Oria;2330;1218;1112
04;Almería;071;Padules;449;230;219
04;Almería;072;Partaloa;915;449;466
04;Almería;073;Paterna del Río;372;216;156
04;Almería;074;Pechina;3900;1979;1921
04;Almería;075;Pulpí;8909;4593;4316
04;Almería;076;Purchena;1638;847;791
04;Almería;077;Rágol;316;169;147
04;Almería;078;Rioja;1356;683;673
04;Almería;079;Roquetas de Mar;91965;47218;44747
04;Almería;080;Santa Cruz de Marchena;241;125;116
04;Almería;081;Santa Fe de Mondújar;431;215;216
04;Almería;082;Senés;322;170;152
04;Almería;083;Serón;2135;1085;1050
04;Almería;084;Sierro;401;214;187
04;Almería;085;Somontín;477;235;242
04;Almería;086;Sorbas;2541;1329;1212
04;Almería;087;Suflí;235;130;105
04;Almería;088;Tabernas;3654;1882;1772
04;Almería;089;Taberno;972;473;499
04;Almería;090;Tahal;362;187;175
04;Almería;091;Terque;395;197;198
04;Almería;092;Tíjola;3676;1818;1858
04;Almería;901;Tres Villas, Las;625;326;299
04;Almería;093;Turre;3351;1706;1645
04;Almería;094;Turrillas;238;136;102
04;Almería;095;Uleila del Campo;871;432;439
04;Almería;096;Urrácal;327;163;164
04;Almería;097;Velefique;256;138;118
04;Almería;098;Vélez-Blanco;1984;1027;957
04;Almería;099;Vélez-Rubio;6692;3252;3440
04;Almería;100;Vera;15168;7744;7424
04;Almería;101;Viator;5699;2948;2751
04;Almería;102;Vícar;24957;13281;11676
04;Almería;103;Zurgena;2939;1464;1475
01;Araba/Álava;001;Alegría-Dulantzi;2856;1467;1389
01;Araba/Álava;002;Amurrio;10260;5095;5165
01;Araba/Álava;049;Añana;159;88;71
01;Araba/Álava;003;Aramaio;1502;792;710
01;Araba/Álava;006;Armiñón;234;121;113
01;Araba/Álava;037;Arraia-Maeztu;722;409;313
01;Araba/Álava;008;Arratzua-Ubarrundia;979;531;448
01;Araba/Álava;004;Artziniega;1840;911;929
01;Araba/Álava;009;Asparrena;1630;821;809
01;Araba/Álava;010;Ayala/Aiara;2946;1500;1446
01;Araba/Álava;011;Baños de Ebro/Mañueta;308;168;140
01;Araba/Álava;013;Barrundia;903;503;400
01;Araba/Álava;014;Berantevilla;449;231;218
01;Araba/Álava;016;Bernedo;499;299;200
01;Araba/Álava;017;Campezo/Kanpezu;1059;558;501
01;Araba/Álava;021;Elburgo/Burgelu;612;326;286
01;Araba/Álava;022;Elciego;1005;492;513
01;Araba/Álava;023;Elvillar/Bilar;355;176;179
01;Araba/Álava;046;Erriberagoitia/Ribera Alta;745;427;318
01;Araba/Álava;056;Harana/Valle de Arana;237;137;100
01;Araba/Álava;901;Iruña Oka/Iruña de Oca;3270;1686;1584
01;Araba/Álava;027;Iruraiz-Gauna;514;280;234
01;Araba/Álava;019;Kripan;186;100;86
01;Araba/Álava;020;Kuartango;368;212;156
01;Araba/Álava;028;Labastida/Bastida;1460;756;704
01;Araba/Álava;030;Lagrán;168;92;76
01;Araba/Álava;031;Laguardia;1478;766;712
01;Araba/Álava;032;Lanciego/Lantziego;681;347;334
01;Araba/Álava;902;Lantarón;888;498;390
01;Araba/Álava;033;Lapuebla de Labarca;852;449;403
01;Araba/Álava;036;Laudio/Llodio;18212;8996;9216
01;Araba/Álava;058;Legutio;1747;925;822
01;Araba/Álava;034;Leza;212;103;109
01;Araba/Álava;039;Moreda de Álava/Moreda Araba;229;115;114
01;Araba/Álava;041;Navaridas;226;137;89
01;Araba/Álava;042;Okondo;1171;616;555
01;Araba/Álava;043;Oyón-Oion;3326;1680;1646
01;Araba/Álava;044;Peñacerrada-Urizaharra;269;161;108
01;Araba/Álava;047;Ribera Baja/Erribera Beitia;1353;738;615
01;Araba/Álava;051;Salvatierra/Agurain;4985;2474;2511
01;Araba/Álava;052;Samaniego;303;155;148
01;Araba/Álava;053;San Millán/Donemiliaga;717;404;313
01;Araba/Álava;054;Urkabustaiz;1339;707;632
01;Araba/Álava;055;Valdegovía/Gaubea;1015;563;452
01;Araba/Álava;057;Villabuena de Álava/Eskuernaga;292;148;144
01;Araba/Álava;059;Vitoria-Gasteiz;244634;119462;125172
01;Araba/Álava;060;Yécora/Iekora;269;139;130
01;Araba/Álava;061;Zalduondo;188;105;83
01;Araba/Álava;062;Zambrana;398;217;181
01;Araba/Álava;018;Zigoitia;1727;937;790
01;Araba/Álava;063;Zuia;2349;1220;1129
33;Asturias;001;Allande;1766;882;884
33;Asturias;002;Aller;11286;5555;5731
33;Asturias;003;Amieva;712;385;327
33;Asturias;004;Avilés;80114;37921;42193
33;Asturias;005;Belmonte de Miranda;1597;822;775
33;Asturias;006;Bimenes;1745;836;909
33;Asturias;007;Boal;1632;818;814
33;Asturias;008;Cabrales;2033;1028;1005
33;Asturias;009;Cabranes;1052;535;517
33;Asturias;010;Candamo;2049;1011;1038
33;Asturias;012;Cangas de Onís;6368;3103;3265
33;Asturias;011;Cangas del Narcea;13213;6556;6657
33;Asturias;013;Caravia;489;250;239
33;Asturias;014;Carreño;10636;5138;5498
33;Asturias;015;Caso;1624;919;705
33;Asturias;016;Castrillón;22626;10974;11652
33;Asturias;017;Castropol;3575;1741;1834
33;Asturias;018;Coaña;3401;1663;1738
33;Asturias;019;Colunga;3487;1705;1782
33;Asturias;020;Corvera de Asturias;15968;7855;8113
33;Asturias;021;Cudillero;5248;2597;2651
33;Asturias;022;Degaña;1039;542;497
33;Asturias;023;Franco, El;3835;1887;1948
33;Asturias;024;Gijón;273422;128955;144467
33;Asturias;025;Gozón;10534;5129;5405
33;Asturias;026;Grado;10127;4881;5246
33;Asturias;027;Grandas de Salime;899;458;441
33;Asturias;028;Ibias;1412;791;621
33;Asturias;029;Illano;372;187;185
33;Asturias;030;Illas;1026;517;509
33;Asturias;031;Langreo;41199;19588;21611
33;Asturias;032;Laviana;13402;6455;6947
33;Asturias;033;Lena;11430;5508;5922
33;Asturias;035;Llanera;13846;6864;6982
33;Asturias;036;Llanes;13841;6706;7135
33;Asturias;037;Mieres;39505;18764;20741
33;Asturias;038;Morcín;2707;1353;1354
33;Asturias;039;Muros de Nalón;1868;879;989
33;Asturias;040;Nava;5346;2627;2719
33;Asturias;041;Navia;8509;4103;4406
33;Asturias;042;Noreña;5260;2535;2725
33;Asturias;043;Onís;752;401;351
33;Asturias;044;Oviedo;220567;102292;118275
33;Asturias;045;Parres;5479;2685;2794
33;Asturias;046;Peñamellera Alta;533;272;261
33;Asturias;047;Peñamellera Baja;1253;613;640
33;Asturias;048;Pesoz;170;89;81
33;Asturias;049;Piloña;7311;3605;3706
33;Asturias;050;Ponga;643;381;262
33;Asturias;051;Pravia;8502;4112;4390
33;Asturias;052;Proaza;774;442;332
33;Asturias;053;Quirós;1235;701;534
33;Asturias;054;Regueras, Las;1909;979;930
33;Asturias;055;Ribadedeva;1791;860;931
33;Asturias;056;Ribadesella;5848;2798;3050
33;Asturias;057;Ribera de Arriba;1906;971;935
33;Asturias;058;Riosa;2040;1027;1013
33;Asturias;059;Salas;5260;2611;2649
33;Asturias;061;San Martín de Oscos;410;205;205
33;Asturias;060;San Martín del Rey Aurelio;16850;8069;8781
33;Asturias;063;San Tirso de Abres;473;231;242
33;Asturias;062;Santa Eulalia de Oscos;469;246;223
33;Asturias;064;Santo Adriano;270;129;141
33;Asturias;065;Sariego;1260;619;641
33;Asturias;066;Siero;51969;25310;26659
33;Asturias;067;Sobrescobio;859;458;401
33;Asturias;068;Somiedo;1190;693;497
33;Asturias;069;Soto del Barco;3940;1943;1997
33;Asturias;070;Tapia de Casariego;3877;1883;1994
33;Asturias;071;Taramundi;670;321;349
33;Asturias;072;Teverga;1721;910;811
33;Asturias;073;Tineo;9904;4979;4925
33;Asturias;034;Valdés;12243;5977;6266
33;Asturias;074;Vegadeo;3911;1870;2041
33;Asturias;075;Villanueva de Oscos;307;153;154
33;Asturias;076;Villaviciosa;14642;7220;7422
33;Asturias;077;Villayón;1315;686;629
33;Asturias;078;Yernes y Tameza;155;88;67
05;Ávila;001;Adanero;220;117;103
05;Ávila;002;Adrada, La;2619;1354;1265
05;Ávila;005;Albornos;206;110;96
05;Ávila;007;Aldeanueva de Santa Cruz;119;62;57
05;Ávila;008;Aldeaseca;262;129;133
05;Ávila;010;Aldehuela, La;167;84;83
05;Ávila;012;Amavida;144;70;74
05;Ávila;013;Arenal, El;998;507;491
05;Ávila;014;Arenas de San Pedro;6615;3220;3395
05;Ávila;015;Arevalillo;86;43;43
05;Ávila;016;Arévalo;8123;3951;4172
05;Ávila;017;Aveinte;84;46;38
05;Ávila;018;Avellaneda;32;19;13
05;Ávila;019;Ávila;58083;27770;30313
05;Ávila;021;Barco de Ávila, El;2474;1202;1272
05;Ávila;022;Barraco, El;1923;1001;922
05;Ávila;023;Barromán;184;100;84
05;Ávila;024;Becedas;230;122;108
05;Ávila;025;Becedillas;99;54;45
05;Ávila;026;Bercial de Zapardiel;211;115;96
05;Ávila;027;Berlanas, Las;328;169;159
05;Ávila;029;Bernuy-Zapardiel;130;74;56
05;Ávila;030;Berrocalejo de Aragona;48;25;23
05;Ávila;033;Blascomillán;201;104;97
05;Ávila;034;Blasconuño de Matacabras;14;8;6
05;Ávila;035;Blascosancho;109;54;55
05;Ávila;036;Bohodón, El;130;70;60
05;Ávila;037;Bohoyo;283;157;126
05;Ávila;038;Bonilla de la Sierra;123;73;50
05;Ávila;039;Brabos;49;30;19
05;Ávila;040;Bularros;69;44;25
05;Ávila;041;Burgohondo;1208;632;576
05;Ávila;042;Cabezas de Alambre;165;83;82
05;Ávila;043;Cabezas del Pozo;84;47;37
05;Ávila;044;Cabezas del Villar;283;158;125
05;Ávila;045;Cabizuela;96;49;47
05;Ávila;046;Canales;52;29;23
05;Ávila;047;Candeleda;5034;2566;2468
05;Ávila;048;Cantiveros;120;66;54
05;Ávila;049;Cardeñosa;450;237;213
05;Ávila;051;Carrera, La;192;104;88
05;Ávila;052;Casas del Puerto;98;52;46
05;Ávila;053;Casasola;74;38;36
05;Ávila;054;Casavieja;1479;769;710
05;Ávila;055;Casillas;672;363;309
05;Ávila;056;Castellanos de Zapardiel;97;55;42
05;Ávila;057;Cebreros;3188;1638;1550
05;Ávila;058;Cepeda la Mora;82;45;37
05;Ávila;067;Chamartín;88;52;36
05;Ávila;059;Cillán;112;65;47
05;Ávila;060;Cisla;115;60;55
05;Ávila;061;Colilla, La;321;165;156
05;Ávila;062;Collado de Contreras;183;96;87
05;Ávila;063;Collado del Mirón;33;20;13
05;Ávila;064;Constanzana;112;68;44
05;Ávila;065;Crespos;515;276;239
05;Ávila;066;Cuevas del Valle;507;275;232
05;Ávila;903;Diego del Carpio;154;86;68
05;Ávila;069;Donjimeno;80;48;32
05;Ávila;070;Donvidas;36;20;16
05;Ávila;072;Espinosa de los Caballeros;97;53;44
05;Ávila;073;Flores de Ávila;314;172;142
05;Ávila;074;Fontiveros;758;396;362
05;Ávila;075;Fresnedilla;122;51;71
05;Ávila;076;Fresno, El;597;309;288
05;Ávila;077;Fuente el Saúz;173;94;79
05;Ávila;078;Fuentes de Año;117;64;53
05;Ávila;079;Gallegos de Altamiros;69;41;28
05;Ávila;080;Gallegos de Sobrinos;55;24;31
05;Ávila;081;Garganta del Villar;41;30;11
05;Ávila;082;Gavilanes;615;325;290
05;Ávila;083;Gemuño;161;83;78
05;Ávila;085;Gil García;41;20;21
05;Ávila;084;Gilbuena;74;43;31
05;Ávila;086;Gimialcón;82;51;31
05;Ávila;087;Gotarrendura;162;57;105
05;Ávila;088;Grandes y San Martín;28;12;16
05;Ávila;089;Guisando;534;262;272
05;Ávila;090;Gutierre-Muñoz;83;41;42
05;Ávila;092;Hernansancho;171;95;76
05;Ávila;093;Herradón de Pinares;524;297;227
05;Ávila;094;Herreros de Suso;135;75;60
05;Ávila;095;Higuera de las Dueñas;297;162;135
05;Ávila;096;Hija de Dios, La;81;45;36
05;Ávila;097;Horcajada, La;511;262;249
05;Ávila;099;Horcajo de las Torres;541;304;237
05;Ávila;100;Hornillo, El;311;168;143
05;Ávila;102;Hoyo de Pinares, El;2267;1173;1094
05;Ávila;101;Hoyocasero;310;176;134
05;Ávila;103;Hoyorredondo;75;41;34
05;Ávila;106;Hoyos de Miguel Muñoz;34;18;16
05;Ávila;104;Hoyos del Collado;37;22;15
05;Ávila;105;Hoyos del Espino;391;214;177
05;Ávila;107;Hurtumpascual;58;35;23
05;Ávila;108;Junciana;49;25;24
05;Ávila;109;Langa;505;261;244
05;Ávila;110;Lanzahíta;885;458;427
05;Ávila;113;Llanos de Tormes, Los;72;33;39
05;Ávila;112;Losar del Barco, El;109;54;55
05;Ávila;114;Madrigal de las Altas Torres;1503;767;736
05;Ávila;115;Maello;627;329;298
05;Ávila;116;Malpartida de Corneja;113;57;56
05;Ávila;117;Mamblas;215;120;95
05;Ávila;118;Mancera de Arriba;87;49;38
05;Ávila;119;Manjabálago y Ortigosa de Rioalmar;32;20;12
05;Ávila;120;Marlín;39;26;13
05;Ávila;121;Martiherrero;306;160;146
05;Ávila;122;Martínez;132;71;61
05;Ávila;123;Mediana de Voltoya;106;53;53
05;Ávila;124;Medinilla;106;50;56
05;Ávila;125;Mengamuñoz;63;31;32
05;Ávila;126;Mesegar de Corneja;70;39;31
05;Ávila;127;Mijares;755;411;344
05;Ávila;128;Mingorría;400;206;194
05;Ávila;129;Mirón, El;128;78;50
05;Ávila;130;Mironcillo;97;52;45
05;Ávila;131;Mirueña de los Infanzones;100;55;45
05;Ávila;132;Mombeltrán;1111;578;533
05;Ávila;133;Monsalupe;73;37;36
05;Ávila;134;Moraleja de Matacabras;52;30;22
05;Ávila;135;Muñana;426;226;200
05;Ávila;136;Muñico;112;55;57
05;Ávila;138;Muñogalindo;369;188;181
05;Ávila;139;Muñogrande;69;38;31
05;Ávila;140;Muñomer del Peco;128;67;61
05;Ávila;141;Muñopepe;110;63;47
05;Ávila;142;Muñosancho;103;48;55
05;Ávila;143;Muñotello;62;32;30
05;Ávila;144;Narrillos del Álamo;83;44;39
05;Ávila;145;Narrillos del Rebollar;52;28;24
05;Ávila;149;Narros de Saldueña;104;58;46
05;Ávila;147;Narros del Castillo;171;96;75
05;Ávila;148;Narros del Puerto;26;12;14
05;Ávila;152;Nava de Arévalo;775;408;367
05;Ávila;153;Nava del Barco;105;57;48
05;Ávila;151;Navacepedilla de Corneja;104;55;49
05;Ávila;154;Navadijos;41;30;11
05;Ávila;155;Navaescurial;57;34;23
05;Ávila;156;Navahondilla;324;188;136
05;Ávila;157;Navalacruz;251;130;121
05;Ávila;158;Navalmoral;355;185;170
05;Ávila;159;Navalonguilla;256;130;126
05;Ávila;160;Navalosa;332;185;147
05;Ávila;161;Navalperal de Pinares;818;416;402
05;Ávila;162;Navalperal de Tormes;93;49;44
05;Ávila;163;Navaluenga;1967;972;995
05;Ávila;164;Navaquesera;24;10;14
05;Ávila;165;Navarredonda de Gredos;458;226;232
05;Ávila;166;Navarredondilla;195;102;93
05;Ávila;167;Navarrevisca;292;162;130
05;Ávila;168;Navas del Marqués, Las;5272;2666;2606
05;Ávila;169;Navatalgordo;237;128;109
05;Ávila;170;Navatejares;57;27;30
05;Ávila;171;Neila de San Miguel;73;37;36
05;Ávila;172;Niharra;178;95;83
05;Ávila;173;Ojos-Albos;67;41;26
05;Ávila;174;Orbita;78;41;37
05;Ávila;175;Oso, El;173;100;73
05;Ávila;176;Padiernos;291;155;136
05;Ávila;177;Pajares de Adaja;186;95;91
05;Ávila;178;Palacios de Goda;423;220;203
05;Ávila;179;Papatrigo;252;124;128
05;Ávila;180;Parral, El;74;41;33
05;Ávila;181;Pascualcobo;50;30;20
05;Ávila;182;Pedro Bernardo;892;470;422
05;Ávila;183;Pedro-Rodríguez;151;79;72
05;Ávila;184;Peguerinos;308;172;136
05;Ávila;185;Peñalba de Ávila;108;60;48
05;Ávila;186;Piedrahíta;1848;872;976
05;Ávila;187;Piedralaves;2130;1070;1060
05;Ávila;188;Poveda;47;30;17
05;Ávila;189;Poyales del Hoyo;556;299;257
05;Ávila;190;Pozanco;50;29;21
05;Ávila;191;Pradosegar;132;69;63
05;Ávila;192;Puerto Castilla;116;73;43
05;Ávila;193;Rasueros;201;116;85
05;Ávila;194;Riocabado;150;86;64
05;Ávila;195;Riofrío;224;133;91
05;Ávila;196;Rivilla de Barajas;58;25;33
05;Ávila;197;Salobral;107;56;51
05;Ávila;198;Salvadiós;77;38;39
05;Ávila;199;San Bartolomé de Béjar;41;21;20
05;Ávila;200;San Bartolomé de Corneja;48;25;23
05;Ávila;201;San Bartolomé de Pinares;581;313;268
05;Ávila;206;San Esteban de los Patos;36;20;16
05;Ávila;208;San Esteban de Zapardiel;40;24;16
05;Ávila;207;San Esteban del Valle;791;419;372
05;Ávila;209;San García de Ingelmos;85;49;36
05;Ávila;901;San Juan de Gredos;269;144;125
05;Ávila;210;San Juan de la Encinilla;89;44;45
05;Ávila;211;San Juan de la Nava;512;268;244
05;Ávila;212;San Juan del Molinillo;216;123;93
05;Ávila;213;San Juan del Olmo;104;63;41
05;Ávila;214;San Lorenzo de Tormes;41;23;18
05;Ávila;215;San Martín de la Vega del Alberche;177;104;73
05;Ávila;216;San Martín del Pimpollar;177;103;74
05;Ávila;217;San Miguel de Corneja;57;31;26
05;Ávila;218;San Miguel de Serrezuela;132;69;63
05;Ávila;219;San Pascual;43;28;15
05;Ávila;220;San Pedro del Arroyo;441;231;210
05;Ávila;231;San Vicente de Arévalo;185;104;81
05;Ávila;204;Sanchidrián;748;380;368
05;Ávila;205;Sanchorreja;85;42;43
05;Ávila;222;Santa Cruz de Pinares;147;80;67
05;Ávila;221;Santa Cruz del Valle;379;195;184
05;Ávila;226;Santa María de los Caballeros;79;46;33
05;Ávila;224;Santa María del Arroyo;111;58;53
05;Ávila;225;Santa María del Berrocal;382;204;178
05;Ávila;902;Santa María del Cubillo;313;179;134
05;Ávila;227;Santa María del Tiétar;483;251;232
05;Ávila;228;Santiago del Collado;179;110;69
05;Ávila;904;Santiago del Tormes;136;75;61
05;Ávila;229;Santo Domingo de las Posadas;88;48;40
05;Ávila;230;Santo Tomé de Zabarcos;69;38;31
05;Ávila;232;Serrada, La;117;62;55
05;Ávila;233;Serranillos;250;139;111
05;Ávila;234;Sigeres;46;23;23
05;Ávila;235;Sinlabajos;124;66;58
05;Ávila;236;Solana de Ávila;126;71;55
05;Ávila;237;Solana de Rioalmar;174;98;76
05;Ávila;238;Solosancho;885;468;417
05;Ávila;239;Sotalbo;232;121;111
05;Ávila;240;Sotillo de la Adrada;4621;2306;2315
05;Ávila;241;Tiemblo, El;4190;2130;2060
05;Ávila;242;Tiñosillos;797;415;382
05;Ávila;243;Tolbaños;86;47;39
05;Ávila;244;Tormellas;50;29;21
05;Ávila;245;Tornadizos de Ávila;435;217;218
05;Ávila;247;Torre, La;261;143;118
05;Ávila;246;Tórtoles;63;33;30
05;Ávila;249;Umbrías;113;59;54
05;Ávila;251;Vadillo de la Sierra;63;39;24
05;Ávila;252;Valdecasa;72;42;30
05;Ávila;253;Vega de Santa María;89;46;43
05;Ávila;254;Velayos;224;110;114
05;Ávila;256;Villaflor;122;61;61
05;Ávila;257;Villafranca de la Sierra;128;71;57
05;Ávila;905;Villanueva de Ávila;226;113;113
05;Ávila;258;Villanueva de Gómez;140;79;61
05;Ávila;259;Villanueva del Aceral;138;69;69
05;Ávila;260;Villanueva del Campillo;100;59;41
05;Ávila;261;Villar de Corneja;40;24;16
05;Ávila;262;Villarejo del Valle;391;206;185
05;Ávila;263;Villatoro;181;100;81
05;Ávila;264;Viñegra de Moraña;48;26;22
05;Ávila;265;Vita;84;50;34
05;Ávila;266;Zapardiel de la Cañada;98;54;44
05;Ávila;267;Zapardiel de la Ribera;114;60;54
06;Badajoz;001;Acedera;823;425;398
06;Badajoz;002;Aceuchal;5485;2715;2770
06;Badajoz;003;Ahillones;934;466;468
06;Badajoz;004;Alange;1915;967;948
06;Badajoz;005;Albuera, La;2031;1048;983
06;Badajoz;006;Alburquerque;5436;2742;2694
06;Badajoz;007;Alconchel;1750;869;881
06;Badajoz;008;Alconera;756;371;385
06;Badajoz;009;Aljucén;249;137;112
06;Badajoz;010;Almendral;1282;626;656
06;Badajoz;011;Almendralejo;34543;17238;17305
06;Badajoz;012;Arroyo de San Serván;4159;2118;2041
06;Badajoz;013;Atalaya;298;156;142
06;Badajoz;014;Azuaga;8008;3965;4043
06;Badajoz;015;Badajoz;149946;72764;77182
06;Badajoz;016;Barcarrota;3621;1849;1772
06;Badajoz;017;Baterno;310;166;144
06;Badajoz;018;Benquerencia de la Serena;865;426;439
06;Badajoz;019;Berlanga;2412;1210;1202
06;Badajoz;020;Bienvenida;2211;1145;1066
06;Badajoz;021;Bodonal de la Sierra;1070;554;516
06;Badajoz;022;Burguillos del Cerro;3132;1548;1584
06;Badajoz;023;Cabeza del Buey;5065;2516;2549
06;Badajoz;024;Cabeza la Vaca;1366;699;667
06;Badajoz;025;Calamonte;6255;3098;3157
06;Badajoz;026;Calera de León;1003;507;496
06;Badajoz;027;Calzadilla de los Barros;823;414;409
06;Badajoz;028;Campanario;5083;2503;2580
06;Badajoz;029;Campillo de Llerena;1406;710;696
06;Badajoz;030;Capilla;188;96;92
06;Badajoz;031;Carmonita;562;278;284
06;Badajoz;032;Carrascalejo, El;74;36;38
06;Badajoz;033;Casas de Don Pedro;1544;791;753
06;Badajoz;034;Casas de Reina;194;90;104
06;Badajoz;035;Castilblanco;1040;529;511
06;Badajoz;036;Castuera;6115;3026;3089
06;Badajoz;042;Cheles;1227;583;644
06;Badajoz;037;Codosera, La;2186;1153;1033
06;Badajoz;038;Cordobilla de Lácara;945;486;459
06;Badajoz;039;Coronada, La;2200;1083;1117
06;Badajoz;040;Corte de Peleas;1282;628;654
06;Badajoz;041;Cristina;560;287;273
06;Badajoz;043;Don Álvaro;762;392;370
06;Badajoz;044;Don Benito;36975;18250;18725
06;Badajoz;045;Entrín Bajo;583;293;290
06;Badajoz;046;Esparragalejo;1488;732;756
06;Badajoz;047;Esparragosa de la Serena;1043;535;508
06;Badajoz;048;Esparragosa de Lares;954;464;490
06;Badajoz;049;Feria;1197;584;613
06;Badajoz;050;Fregenal de la Sierra;4914;2411;2503
06;Badajoz;051;Fuenlabrada de los Montes;1911;942;969
06;Badajoz;052;Fuente de Cantos;4903;2412;2491
06;Badajoz;053;Fuente del Arco;702;355;347
06;Badajoz;054;Fuente del Maestre;6867;3393;3474
06;Badajoz;055;Fuentes de León;2388;1174;1214
06;Badajoz;056;Garbayuela;530;281;249
06;Badajoz;057;Garlitos;631;330;301
06;Badajoz;058;Garrovilla, La;2410;1217;1193
06;Badajoz;059;Granja de Torrehermosa;2122;1048;1074
06;Badajoz;903;Guadiana del Caudillo;2544;1256;1288
06;Badajoz;060;Guareña;7097;3581;3516
06;Badajoz;061;Haba, La;1275;639;636
06;Badajoz;062;Helechosa de los Montes;684;384;300
06;Badajoz;063;Herrera del Duque;3614;1829;1785
06;Badajoz;064;Higuera de la Serena;943;498;445
06;Badajoz;065;Higuera de Llerena;358;181;177
06;Badajoz;066;Higuera de Vargas;2011;1006;1005
06;Badajoz;067;Higuera la Real;2327;1172;1155
06;Badajoz;068;Hinojosa del Valle;503;251;252
06;Badajoz;069;Hornachos;3709;1858;1851
06;Badajoz;070;Jerez de los Caballeros;9531;4746;4785
06;Badajoz;071;Lapa, La;288;149;139
06;Badajoz;073;Llera;870;449;421
06;Badajoz;074;Llerena;5877;2941;2936
06;Badajoz;072;Lobón;2825;1456;1369
06;Badajoz;075;Magacela;533;279;254
06;Badajoz;076;Maguilla;999;494;505
06;Badajoz;077;Malcocinado;379;209;170
06;Badajoz;078;Malpartida de la Serena;593;305;288
06;Badajoz;079;Manchita;770;394;376
06;Badajoz;080;Medellín;2300;1158;1142
06;Badajoz;081;Medina de las Torres;1256;646;610
06;Badajoz;082;Mengabril;471;251;220
06;Badajoz;083;Mérida;59174;28886;30288
06;Badajoz;084;Mirandilla;1344;682;662
06;Badajoz;085;Monesterio;4292;2189;2103
06;Badajoz;086;Montemolín;1421;686;735
06;Badajoz;087;Monterrubio de la Serena;2472;1196;1276
06;Badajoz;088;Montijo;15674;7767;7907
06;Badajoz;089;Morera, La;727;369;358
06;Badajoz;090;Nava de Santiago, La;997;502;495
06;Badajoz;091;Navalvillar de Pela;4604;2329;2275
06;Badajoz;092;Nogales;699;348;351
06;Badajoz;093;Oliva de la Frontera;5340;2690;2650
06;Badajoz;094;Oliva de Mérida;1786;916;870
06;Badajoz;095;Olivenza;12032;5994;6038
06;Badajoz;096;Orellana de la Sierra;243;132;111
06;Badajoz;097;Orellana la Vieja;2796;1458;1338
06;Badajoz;098;Palomas;700;348;352
06;Badajoz;099;Parra, La;1364;697;667
06;Badajoz;100;Peñalsordo;1024;490;534
06;Badajoz;101;Peraleda del Zaucejo;555;282;273
06;Badajoz;102;Puebla de Alcocer;1239;609;630
06;Badajoz;103;Puebla de la Calzada;5952;2984;2968
06;Badajoz;104;Puebla de la Reina;781;388;393
06;Badajoz;107;Puebla de Obando;1872;941;931
06;Badajoz;108;Puebla de Sancho Pérez;2758;1392;1366
06;Badajoz;105;Puebla del Maestre;731;372;359
06;Badajoz;106;Puebla del Prior;496;257;239
06;Badajoz;902;Pueblonuevo del Guadiana;2036;1035;1001
06;Badajoz;109;Quintana de la Serena;4762;2417;2345
06;Badajoz;110;Reina;166;80;86
06;Badajoz;111;Rena;648;329;319
06;Badajoz;112;Retamal de Llerena;454;235;219
06;Badajoz;113;Ribera del Fresno;3449;1713;1736
06;Badajoz;114;Risco;152;75;77
06;Badajoz;115;Roca de la Sierra, La;1512;740;772
06;Badajoz;116;Salvaleón;1865;933;932
06;Badajoz;117;Salvatierra de los Barros;1701;837;864
06;Badajoz;119;San Pedro de Mérida;860;442;418
06;Badajoz;123;San Vicente de Alcántara;5620;2827;2793
06;Badajoz;118;Sancti-Spíritus;214;119;95
06;Badajoz;120;Santa Amalia;4108;2077;2031
06;Badajoz;121;Santa Marta;4293;2155;2138
06;Badajoz;122;Santos de Maimona, Los;8218;4153;4065
06;Badajoz;124;Segura de León;1991;984;1007
06;Badajoz;125;Siruela;1981;984;997
06;Badajoz;126;Solana de los Barros;2700;1343;1357
06;Badajoz;127;Talarrubias;3529;1759;1770
06;Badajoz;128;Talavera la Real;5453;2742;2711
06;Badajoz;129;Táliga;708;354;354
06;Badajoz;130;Tamurejo;230;119;111
06;Badajoz;131;Torre de Miguel Sesmero;1259;639;620
06;Badajoz;132;Torremayor;1013;486;527
06;Badajoz;133;Torremejía;2261;1164;1097
06;Badajoz;134;Trasierra;656;349;307
06;Badajoz;135;Trujillanos;1418;742;676
06;Badajoz;136;Usagre;1822;895;927
06;Badajoz;137;Valdecaballeros;1116;576;540
06;Badajoz;901;Valdelacalzada;2782;1424;1358
06;Badajoz;138;Valdetorres;1221;606;615
06;Badajoz;139;Valencia de las Torres;623;334;289
06;Badajoz;140;Valencia del Mombuey;756;384;372
06;Badajoz;141;Valencia del Ventoso;2045;1021;1024
06;Badajoz;146;Valle de la Serena;1265;643;622
06;Badajoz;147;Valle de Matamoros;379;191;188
06;Badajoz;148;Valle de Santa Ana;1163;571;592
06;Badajoz;142;Valverde de Burguillos;292;152;140
06;Badajoz;143;Valverde de Leganés;4202;2113;2089
06;Badajoz;144;Valverde de Llerena;642;318;324
06;Badajoz;145;Valverde de Mérida;1078;550;528
06;Badajoz;149;Villafranca de los Barros;13224;6534;6690
06;Badajoz;150;Villagarcía de la Torre;942;491;451
06;Badajoz;151;Villagonzalo;1261;616;645
06;Badajoz;152;Villalba de los Barros;1570;798;772
06;Badajoz;153;Villanueva de la Serena;25992;12739;13253
06;Badajoz;154;Villanueva del Fresno;3464;1731;1733
06;Badajoz;156;Villar de Rena;1411;731;680
06;Badajoz;155;Villar del Rey;2241;1197;1044
06;Badajoz;157;Villarta de los Montes;503;254;249
06;Badajoz;158;Zafra;16855;8158;8697
06;Badajoz;159;Zahínos;2803;1381;1422
06;Badajoz;160;Zalamea de la Serena;3751;1886;1865
06;Badajoz;162;Zarza, La;3542;1790;1752
06;Badajoz;161;Zarza-Capilla;347;171;176
07;Balears, Illes;002;Alaior;8959;4492;4467
07;Balears, Illes;001;Alaró;5282;2577;2705
07;Balears, Illes;003;Alcúdia;19296;9758;9538
07;Balears, Illes;004;Algaida;5394;2751;2643
07;Balears, Illes;005;Andratx;10873;5415;5458
07;Balears, Illes;901;Ariany;859;450;409
07;Balears, Illes;006;Artà;7448;3730;3718
07;Balears, Illes;007;Banyalbufar;522;289;233
07;Balears, Illes;008;Binissalem;7966;3929;4037
07;Balears, Illes;009;Búger;1050;539;511
07;Balears, Illes;010;Bunyola;6669;3284;3385
07;Balears, Illes;011;Calvià;49580;24736;24844
07;Balears, Illes;012;Campanet;2507;1240;1267
07;Balears, Illes;013;Campos;10164;5066;5098
07;Balears, Illes;014;Capdepera;11356;5800;5556
07;Balears, Illes;064;Castell, Es;7455;3779;3676
07;Balears, Illes;015;Ciutadella de Menorca;28641;14230;14411
07;Balears, Illes;016;Consell;3869;1956;1913
07;Balears, Illes;017;Costitx;1246;621;625
07;Balears, Illes;018;Deià;642;311;331
07;Balears, Illes;026;Eivissa;49549;24996;24553
07;Balears, Illes;019;Escorca;230;135;95
07;Balears, Illes;020;Esporles;4959;2456;2503
07;Balears, Illes;021;Estellencs;323;173;150
07;Balears, Illes;022;Felanitx;17319;8710;8609
07;Balears, Illes;023;Ferreries;4617;2318;2299
07;Balears, Illes;024;Formentera;12124;6356;5768
07;Balears, Illes;025;Fornalutx;687;342;345
07;Balears, Illes;027;Inca;30944;15552;15392
07;Balears, Illes;028;Lloret de Vistalegre;1257;643;614
07;Balears, Illes;029;Lloseta;5710;2888;2822
07;Balears, Illes;030;Llubí;2157;1076;1081
07;Balears, Illes;031;Llucmajor;35057;17708;17349
07;Balears, Illes;033;Manacor;40279;20069;20210
07;Balears, Illes;034;Mancor de la Vall;1383;691;692
07;Balears, Illes;032;Maó-Mahón;28099;13769;14330
07;Balears, Illes;035;Maria de la Salut;2073;1067;1006
07;Balears, Illes;036;Marratxí;36001;18124;17877
07;Balears, Illes;037;Mercadal, Es;5098;2570;2528
07;Balears, Illes;902;Migjorn Gran, Es;1419;707;712
07;Balears, Illes;038;Montuïri;2884;1446;1438
07;Balears, Illes;039;Muro;6729;3371;3358
07;Balears, Illes;040;Palma de Mallorca;402949;196220;206729
07;Balears, Illes;041;Petra;2774;1375;1399
07;Balears, Illes;044;Pobla, Sa;12714;6465;6249
07;Balears, Illes;042;Pollença;16222;8083;8139
07;Balears, Illes;043;Porreres;5197;2662;2535
07;Balears, Illes;045;Puigpunyent;2021;1013;1008
07;Balears, Illes;059;Salines, Ses;4895;2470;2425
07;Balears, Illes;046;Sant Antoni de Portmany;24478;12773;11705
07;Balears, Illes;049;Sant Joan;2042;1005;1037
07;Balears, Illes;050;Sant Joan de Labritja;6070;3108;2962
07;Balears, Illes;048;Sant Josep de sa Talaia;25849;13399;12450
07;Balears, Illes;051;Sant Llorenç des Cardassar;8138;4029;4109
07;Balears, Illes;052;Sant Lluís;7313;3684;3629
07;Balears, Illes;053;Santa Eugènia;1636;825;811
07;Balears, Illes;054;Santa Eulària des Riu;36119;18300;17819
07;Balears, Illes;055;Santa Margalida;11632;5902;5730
07;Balears, Illes;056;Santa María del Camí;6832;3403;3429
07;Balears, Illes;057;Santanyí;11220;5584;5636
07;Balears, Illes;058;Selva;3864;1930;1934
07;Balears, Illes;047;Sencelles;3096;1562;1534
07;Balears, Illes;060;Sineu;3629;1813;1816
07;Balears, Illes;061;Sóller;13791;6928;6863
07;Balears, Illes;062;Son Servera;11119;5552;5567
07;Balears, Illes;063;Valldemossa;2003;1010;993
07;Balears, Illes;065;Vilafranca de Bonany;2941;1467;1474
08;Barcelona;001;Abrera;12216;6215;6001
08;Barcelona;002;Aguilar de Segarra;253;133;120
08;Barcelona;014;Aiguafreda;2467;1172;1295
08;Barcelona;003;Alella;9632;4690;4942
08;Barcelona;004;Alpens;294;153;141
08;Barcelona;005;Ametlla del Vallès, L';8337;4199;4138
08;Barcelona;006;Arenys de Mar;15253;7463;7790
08;Barcelona;007;Arenys de Munt;8638;4353;4285
08;Barcelona;008;Argençola;227;120;107
08;Barcelona;009;Argentona;12051;5916;6135
08;Barcelona;010;Artés;5596;2823;2773
08;Barcelona;011;Avià;2257;1113;1144
08;Barcelona;012;Avinyó;2212;1102;1110
08;Barcelona;013;Avinyonet del Penedès;1665;885;780
08;Barcelona;015;Badalona;215634;106301;109333
08;Barcelona;904;Badia del Vallès;13482;6588;6894
08;Barcelona;016;Bagà;2162;1076;1086
08;Barcelona;017;Balenyà;3705;1861;1844
08;Barcelona;018;Balsareny;3285;1629;1656
08;Barcelona;252;Barberà del Vallès;32832;16229;16603
08;Barcelona;019;Barcelona;1608746;761487;847259
08;Barcelona;020;Begues;6736;3324;3412
08;Barcelona;021;Bellprat;75;46;29
08;Barcelona;022;Berga;16175;7950;8225
08;Barcelona;023;Bigues i Riells;8915;4546;4369
08;Barcelona;024;Borredà;495;274;221
08;Barcelona;025;Bruc, El;2014;1081;933
08;Barcelona;026;Brull, El;263;142;121
08;Barcelona;027;Cabanyes, Les;943;483;460
08;Barcelona;028;Cabrera d'Anoia;1351;712;639
08;Barcelona;029;Cabrera de Mar;4553;2299;2254
08;Barcelona;030;Cabrils;7287;3603;3684
08;Barcelona;031;Calaf;3424;1752;1672
08;Barcelona;034;Calders;953;494;459
08;Barcelona;033;Caldes de Montbui;17137;8523;8614
08;Barcelona;032;Caldes d'Estrac;2766;1341;1425
08;Barcelona;035;Calella;18317;8979;9338
08;Barcelona;037;Calldetenes;2418;1233;1185
08;Barcelona;038;Callús;2057;1008;1049
08;Barcelona;036;Calonge de Segarra;191;96;95
08;Barcelona;039;Campins;470;246;224
08;Barcelona;040;Canet de Mar;14284;6936;7348
08;Barcelona;041;Canovelles;15937;8250;7687
08;Barcelona;042;Cànoves i Samalús;2873;1452;1421
08;Barcelona;043;Canyelles;4407;2246;2161
08;Barcelona;044;Capellades;5227;2572;2655
08;Barcelona;045;Capolat;93;45;48
08;Barcelona;046;Cardedeu;18158;8958;9200
08;Barcelona;047;Cardona;4775;2351;2424
08;Barcelona;048;Carme;791;411;380
08;Barcelona;049;Casserres;1528;760;768
08;Barcelona;057;Castell de l'Areny;69;40;29
08;Barcelona;052;Castellar de n'Hug;157;83;74
08;Barcelona;050;Castellar del Riu;176;97;79
08;Barcelona;051;Castellar del Vallès;23633;11639;11994
08;Barcelona;053;Castellbell i el Vilar;3584;1820;1764
08;Barcelona;054;Castellbisbal;12277;6206;6071
08;Barcelona;055;Castellcir;726;367;359
08;Barcelona;056;Castelldefels;64892;32034;32858
08;Barcelona;058;Castellet i la Gornal;2193;1104;1089
08;Barcelona;060;Castellfollit de Riubregós;165;96;69
08;Barcelona;059;Castellfollit del Boix;448;225;223
08;Barcelona;061;Castellgalí;1995;1039;956
08;Barcelona;062;Castellnou de Bages;1287;647;640
08;Barcelona;063;Castellolí;573;277;296
08;Barcelona;064;Castellterçol;2351;1181;1170
08;Barcelona;065;Castellví de la Marca;1545;772;773
08;Barcelona;066;Castellví de Rosanes;1807;882;925
08;Barcelona;067;Centelles;7410;3632;3778
08;Barcelona;268;Cercs;1183;591;592
08;Barcelona;266;Cerdanyola del Vallès;57543;28184;29359
08;Barcelona;068;Cervelló;8861;4453;4408
08;Barcelona;069;Collbató;4396;2259;2137
08;Barcelona;070;Collsuspina;349;185;164
08;Barcelona;071;Copons;300;152;148
08;Barcelona;072;Corbera de Llobregat;14168;7089;7079
08;Barcelona;073;Cornellà de Llobregat;86072;41878;44194
08;Barcelona;074;Cubelles;14608;7390;7218
08;Barcelona;075;Dosrius;5154;2614;2540
08;Barcelona;076;Esparreguera;21766;11021;10745
08;Barcelona;077;Esplugues de Llobregat;45733;21979;23754
08;Barcelona;078;Espunyola, L';247;126;121
08;Barcelona;254;Esquirol, L';2168;1097;1071
08;Barcelona;079;Estany, L';404;200;204
08;Barcelona;134;Figaró-Montmany;1092;538;554
08;Barcelona;080;Fígols;40;23;17
08;Barcelona;082;Fogars de la Selva;1452;752;700
08;Barcelona;081;Fogars de Montclús;462;245;217
08;Barcelona;083;Folgueroles;2298;1158;1140
08;Barcelona;084;Fonollosa;1401;732;669
08;Barcelona;085;Font-rubí;1363;697;666
08;Barcelona;086;Franqueses del Vallès, Les;19417;9855;9562
08;Barcelona;090;Gaià;160;88;72
08;Barcelona;087;Gallifa;187;99;88
08;Barcelona;088;Garriga, La;15912;7728;8184
08;Barcelona;089;Gavà;46266;22757;23509
08;Barcelona;091;Gelida;7238;3640;3598
08;Barcelona;092;Gironella;4829;2361;2468
08;Barcelona;093;Gisclareny;29;17;12
08;Barcelona;094;Granada, La;2091;1065;1026
08;Barcelona;095;Granera;79;53;26
08;Barcelona;096;Granollers;60174;29668;30506
08;Barcelona;097;Gualba;1426;718;708
08;Barcelona;099;Guardiola de Berguedà;897;474;423
08;Barcelona;100;Gurb;2559;1311;1248
08;Barcelona;101;Hospitalet de Llobregat, L';254804;123505;131299
08;Barcelona;162;Hostalets de Pierola, Els;2891;1494;1397
08;Barcelona;102;Igualada;38987;19046;19941
08;Barcelona;103;Jorba;831;406;425
08;Barcelona;104;Llacuna, La;872;474;398
08;Barcelona;105;Llagosta, La;13247;6528;6719
08;Barcelona;107;Lliçà d'Amunt;14759;7557;7202
08;Barcelona;108;Lliçà de Vall;6370;3239;3131
08;Barcelona;106;Llinars del Vallès;9717;4821;4896
08;Barcelona;109;Lluçà;280;135;145
08;Barcelona;110;Malgrat de Mar;18295;9118;9177
08;Barcelona;111;Malla;267;135;132
08;Barcelona;112;Manlleu;20104;10033;10071
08;Barcelona;113;Manresa;74752;36545;38207
08;Barcelona;242;Marganell;277;136;141
08;Barcelona;114;Martorell;27645;14073;13572
08;Barcelona;115;Martorelles;4725;2356;2369
08;Barcelona;116;Masies de Roda, Les;714;360;354
08;Barcelona;117;Masies de Voltregà, Les;3170;1564;1606
08;Barcelona;118;Masnou, El;23119;11131;11988
08;Barcelona;119;Masquefa;8386;4220;4166
08;Barcelona;120;Matadepera;8984;4508;4476
08;Barcelona;121;Mataró;125517;62355;63162
08;Barcelona;122;Mediona;2282;1143;1139
08;Barcelona;138;Moià;5957;2995;2962
08;Barcelona;123;Molins de Rei;25359;12342;13017
08;Barcelona;124;Mollet del Vallès;51491;25498;25993
08;Barcelona;128;Monistrol de Calders;699;363;336
08;Barcelona;127;Monistrol de Montserrat;2867;1456;1411
08;Barcelona;125;Montcada i Reixac;34802;17170;17632
08;Barcelona;130;Montclar;119;58;61
08;Barcelona;131;Montesquiu;931;465;466
08;Barcelona;126;Montgat;11621;5759;5862
08;Barcelona;132;Montmajor;471;234;237
08;Barcelona;133;Montmaneu;151;78;73
08;Barcelona;135;Montmeló;8784;4299;4485
08;Barcelona;136;Montornès del Vallès;16218;8220;7998
08;Barcelona;137;Montseny;320;166;154
08;Barcelona;129;Muntanyola;604;312;292
08;Barcelona;139;Mura;219;118;101
08;Barcelona;140;Navarcles;5988;2915;3073
08;Barcelona;141;Navàs;6045;3017;3028
08;Barcelona;142;Nou de Berguedà, La;151;75;76
08;Barcelona;143;Òdena;3607;1842;1765
08;Barcelona;145;Olèrdola;3529;1824;1705
08;Barcelona;146;Olesa de Bonesvalls;1723;898;825
08;Barcelona;147;Olesa de Montserrat;23645;11844;11801
08;Barcelona;148;Olivella;3569;1897;1672
08;Barcelona;149;Olost;1185;599;586
08;Barcelona;144;Olvan;855;419;436
08;Barcelona;150;Orís;310;157;153
08;Barcelona;151;Oristà;547;267;280
08;Barcelona;152;Orpí;139;76;63
08;Barcelona;153;Òrrius;702;370;332
08;Barcelona;154;Pacs del Penedès;894;457;437
08;Barcelona;155;Palafolls;9133;4605;4528
08;Barcelona;156;Palau-solità i Plegamans;14494;7135;7359
08;Barcelona;157;Pallejà;11348;5656;5692
08;Barcelona;905;Palma de Cervelló, La;3000;1494;1506
08;Barcelona;158;Papiol, El;4075;2021;2054
08;Barcelona;159;Parets del Vallès;18837;9477;9360
08;Barcelona;160;Perafita;411;207;204
08;Barcelona;161;Piera;15001;7648;7353
08;Barcelona;163;Pineda de Mar;26240;13107;13133
08;Barcelona;164;Pla del Penedès, El;1253;623;630
08;Barcelona;165;Pobla de Claramunt, La;2159;1091;1068
08;Barcelona;166;Pobla de Lillet, La;1110;542;568
08;Barcelona;167;Polinyà;8300;4210;4090
08;Barcelona;182;Pont de Vilomara i Rocafort, El;3724;1919;1805
08;Barcelona;168;Pontons;453;259;194
08;Barcelona;169;Prat de Llobregat, El;63457;31163;32294
08;Barcelona;171;Prats de Lluçanès;2565;1286;1279
08;Barcelona;170;Prats de Rei, Els;535;284;251
08;Barcelona;230;Premià de Dalt;10446;5260;5186
08;Barcelona;172;Premià de Mar;27866;13617;14249
08;Barcelona;174;Puigdàlber;512;253;259
08;Barcelona;175;Puig-reig;4123;2001;2122
08;Barcelona;176;Pujalt;198;107;91
08;Barcelona;177;Quar, La;54;28;26
08;Barcelona;178;Rajadell;533;269;264
08;Barcelona;179;Rellinars;723;374;349
08;Barcelona;180;Ripollet;37648;18646;19002
08;Barcelona;181;Roca del Vallès, La;10599;5307;5292
08;Barcelona;183;Roda de Ter;6116;3001;3115
08;Barcelona;184;Rubí;75167;37221;37946
08;Barcelona;185;Rubió;231;126;105
08;Barcelona;901;Rupit i Pruit;277;142;135
08;Barcelona;187;Sabadell;208246;101341;106905
08;Barcelona;188;Sagàs;152;83;69
08;Barcelona;190;Saldes;276;159;117
08;Barcelona;191;Sallent;6592;3170;3422
08;Barcelona;194;Sant Adrià de Besòs;36496;18029;18467
08;Barcelona;195;Sant Agustí de Lluçanès;92;46;46
08;Barcelona;196;Sant Andreu de la Barca;27434;13694;13740
08;Barcelona;197;Sant Andreu de Llavaneres;10663;5274;5389
08;Barcelona;198;Sant Antoni de Vilamajor;5862;2932;2930
08;Barcelona;199;Sant Bartomeu del Grau;850;444;406
08;Barcelona;200;Sant Boi de Llobregat;82402;40369;42033
08;Barcelona;201;Sant Boi de Lluçanès;527;263;264
08;Barcelona;203;Sant Cebrià de Vallalta;3329;1732;1597
08;Barcelona;202;Sant Celoni;17540;8719;8821
08;Barcelona;204;Sant Climent de Llobregat;4024;2022;2002
08;Barcelona;205;Sant Cugat del Vallès;88921;43254;45667
08;Barcelona;206;Sant Cugat Sesgarrigues;973;475;498
08;Barcelona;207;Sant Esteve de Palautordera;2599;1277;1322
08;Barcelona;208;Sant Esteve Sesrovires;7644;3820;3824
08;Barcelona;210;Sant Feliu de Codines;5968;3008;2960
08;Barcelona;211;Sant Feliu de Llobregat;44086;21405;22681
08;Barcelona;212;Sant Feliu Sasserra;612;323;289
08;Barcelona;209;Sant Fost de Campsentelles;8650;4316;4334
08;Barcelona;213;Sant Fruitós de Bages;8387;4161;4226
08;Barcelona;215;Sant Hipòlit de Voltregà;3462;1701;1761
08;Barcelona;193;Sant Iscle de Vallalta;1292;669;623
08;Barcelona;216;Sant Jaume de Frontanyà;27;18;9
08;Barcelona;218;Sant Joan de Vilatorrada;10759;5390;5369
08;Barcelona;217;Sant Joan Despí;33502;16356;17146
08;Barcelona;903;Sant Julià de Cerdanyola;251;139;112
08;Barcelona;220;Sant Julià de Vilatorta;3113;1523;1590
08;Barcelona;221;Sant Just Desvern;16927;8123;8804
08;Barcelona;222;Sant Llorenç d'Hortons;2562;1302;1260
08;Barcelona;223;Sant Llorenç Savall;2375;1208;1167
08;Barcelona;225;Sant Martí d'Albars;108;54;54
08;Barcelona;224;Sant Martí de Centelles;1122;581;541
08;Barcelona;226;Sant Martí de Tous;1190;603;587
08;Barcelona;227;Sant Martí Sarroca;3099;1516;1583
08;Barcelona;228;Sant Martí Sesgueioles;371;190;181
08;Barcelona;229;Sant Mateu de Bages;618;311;307
08;Barcelona;231;Sant Pere de Ribes;29842;14928;14914
08;Barcelona;232;Sant Pere de Riudebitlles;2369;1187;1182
08;Barcelona;233;Sant Pere de Torelló;2427;1246;1181
08;Barcelona;234;Sant Pere de Vilamajor;4257;2133;2124
08;Barcelona;189;Sant Pere Sallavinera;158;86;72
08;Barcelona;235;Sant Pol de Mar;4951;2450;2501
08;Barcelona;236;Sant Quintí de Mediona;2121;1079;1042
08;Barcelona;237;Sant Quirze de Besora;2125;1052;1073
08;Barcelona;238;Sant Quirze del Vallès;19664;9687;9977
08;Barcelona;239;Sant Quirze Safaja;637;339;298
08;Barcelona;240;Sant Sadurní d'Anoia;12654;6221;6433
08;Barcelona;241;Sant Sadurní d'Osormort;80;49;31
08;Barcelona;098;Sant Salvador de Guardiola;3141;1590;1551
08;Barcelona;262;Sant Vicenç de Castellet;9235;4586;4649
08;Barcelona;264;Sant Vicenç de Montalt;6182;3073;3109
08;Barcelona;265;Sant Vicenç de Torelló;1996;982;1014
08;Barcelona;263;Sant Vicenç dels Horts;27961;13936;14025
08;Barcelona;243;Santa Cecília de Voltregà;183;96;87
08;Barcelona;244;Santa Coloma de Cervelló;8073;3960;4113
08;Barcelona;245;Santa Coloma de Gramenet;117153;58288;58865
08;Barcelona;246;Santa Eugènia de Berga;2246;1148;1098
08;Barcelona;247;Santa Eulàlia de Riuprimer;1266;641;625
08;Barcelona;248;Santa Eulàlia de Ronçana;7049;3544;3505
08;Barcelona;249;Santa Fe del Penedès;374;191;183
08;Barcelona;250;Santa Margarida de Montbui;9611;4800;4811
08;Barcelona;251;Santa Margarida i els Monjos;7360;3769;3591
08;Barcelona;253;Santa Maria de Besora;148;75;73
08;Barcelona;256;Santa Maria de Martorelles;861;436;425
08;Barcelona;255;Santa Maria de Merlès;178;87;91
08;Barcelona;257;Santa Maria de Miralles;132;71;61
08;Barcelona;259;Santa Maria de Palautordera;9194;4633;4561
08;Barcelona;258;Santa Maria d'Oló;1054;542;512
08;Barcelona;260;Santa Perpètua de Mogoda;25556;12920;12636
08;Barcelona;261;Santa Susanna;3323;1698;1625
08;Barcelona;192;Santpedor;7520;3732;3788
08;Barcelona;267;Sentmenat;8700;4391;4309
08;Barcelona;269;Seva;3446;1734;1712
08;Barcelona;270;Sitges;28478;14232;14246
08;Barcelona;271;Sobremunt;83;33;50
08;Barcelona;272;Sora;189;106;83
08;Barcelona;273;Subirats;2997;1554;1443
08;Barcelona;274;Súria;5873;2841;3032
08;Barcelona;276;Tagamanent;316;170;146
08;Barcelona;277;Talamanca;186;106;80
08;Barcelona;278;Taradell;6321;3138;3183
08;Barcelona;275;Tavèrnoles;318;161;157
08;Barcelona;280;Tavertet;112;62;50
08;Barcelona;281;Teià;6254;3073;3181
08;Barcelona;279;Terrassa;215121;105879;109242
08;Barcelona;282;Tiana;8553;4082;4471
08;Barcelona;283;Tona;7951;3930;4021
08;Barcelona;284;Tordera;16453;8343;8110
08;Barcelona;285;Torelló;13877;6826;7051
08;Barcelona;286;Torre de Claramunt, La;3722;1898;1824
08;Barcelona;287;Torrelavit;1413;737;676
08;Barcelona;288;Torrelles de Foix;2201;1171;1030
08;Barcelona;289;Torrelles de Llobregat;5933;2934;2999
08;Barcelona;290;Ullastrell;2039;1023;1016
08;Barcelona;291;Vacarisses;6192;3189;3003
08;Barcelona;292;Vallbona d'Anoia;1412;742;670
08;Barcelona;293;Vallcebre;254;143;111
08;Barcelona;294;Vallgorguina;2772;1409;1363
08;Barcelona;295;Vallirana;14676;7331;7345
08;Barcelona;296;Vallromanes;2525;1296;1229
08;Barcelona;297;Veciana;173;95;78
08;Barcelona;298;Vic;43287;21590;21697
08;Barcelona;299;Vilada;430;228;202
08;Barcelona;301;Viladecans;65779;32673;33106
08;Barcelona;300;Viladecavalls;7354;3663;3691
08;Barcelona;305;Vilafranca del Penedès;39365;19255;20110
08;Barcelona;306;Vilalba Sasserra;684;341;343
08;Barcelona;303;Vilanova de Sau;309;153;156
08;Barcelona;302;Vilanova del Camí;12409;6218;6191
08;Barcelona;902;Vilanova del Vallès;5217;2637;2580
08;Barcelona;307;Vilanova i la Geltrú;65972;31973;33999
08;Barcelona;214;Vilassar de Dalt;8953;4411;4542
08;Barcelona;219;Vilassar de Mar;20678;9970;10708
08;Barcelona;304;Vilobí del Penedès;1103;579;524
08;Barcelona;308;Viver i Serrateix;162;86;76
48;Bizkaia;001;Abadiño;7533;3770;3763
48;Bizkaia;002;Abanto y Ciérvana-Abanto Zierbena;9577;4733;4844
48;Bizkaia;911;Ajangiz;469;242;227
48;Bizkaia;912;Alonsotegi;2857;1392;1465
48;Bizkaia;003;Amorebieta-Etxano;18859;9302;9557
48;Bizkaia;004;Amoroto;425;217;208
48;Bizkaia;005;Arakaldo;157;76;81
48;Bizkaia;006;Arantzazu;377;185;192
48;Bizkaia;093;Areatza;1214;583;631
48;Bizkaia;009;Arrankudiaga;986;485;501
48;Bizkaia;914;Arratzu;409;197;212
48;Bizkaia;010;Arrieta;562;290;272
48;Bizkaia;011;Arrigorriaga;12260;5978;6282
48;Bizkaia;023;Artea;747;370;377
48;Bizkaia;008;Artzentales;743;397;346
48;Bizkaia;091;Atxondo;1374;694;680
48;Bizkaia;070;Aulesti;658;328;330
48;Bizkaia;012;Bakio;2604;1320;1284
48;Bizkaia;090;Balmaseda;7655;3753;3902
48;Bizkaia;013;Barakaldo;100025;48277;51748
48;Bizkaia;014;Barrika;1522;752;770
48;Bizkaia;015;Basauri;40983;19903;21080
48;Bizkaia;092;Bedia;1027;490;537
48;Bizkaia;016;Berango;6972;3415;3557
48;Bizkaia;017;Bermeo;16861;8332;8529
48;Bizkaia;018;Berriatua;1214;656;558
48;Bizkaia;019;Berriz;4707;2352;2355
48;Bizkaia;020;Bilbao;345122;162732;182390
48;Bizkaia;021;Busturia;1659;829;830
48;Bizkaia;901;Derio;6154;2999;3155
48;Bizkaia;026;Dima;1458;741;717
48;Bizkaia;027;Durango;29031;14196;14835
48;Bizkaia;028;Ea;845;427;418
48;Bizkaia;031;Elantxobe;373;183;190
48;Bizkaia;032;Elorrio;7303;3631;3672
48;Bizkaia;902;Erandio;24240;11860;12380
48;Bizkaia;033;Ereño;255;140;115
48;Bizkaia;034;Ermua;16028;8021;8007
48;Bizkaia;079;Errigoiti;513;284;229
48;Bizkaia;029;Etxebarri;11017;5502;5515
48;Bizkaia;030;Etxebarria;775;390;385
48;Bizkaia;906;Forua;934;466;468
48;Bizkaia;035;Fruiz;540;274;266
48;Bizkaia;036;Galdakao;29315;14435;14880
48;Bizkaia;037;Galdames;812;425;387
48;Bizkaia;038;Gamiz-Fika;1365;674;691
48;Bizkaia;039;Garai;309;152;157
48;Bizkaia;040;Gatika;1656;827;829
48;Bizkaia;041;Gautegiz Arteaga;851;427;424
48;Bizkaia;046;Gernika-Lumo;16869;8139;8730
48;Bizkaia;044;Getxo;78554;36898;41656
48;Bizkaia;047;Gizaburuaga;208;112;96
48;Bizkaia;042;Gordexola;1698;867;831
48;Bizkaia;043;Gorliz;5669;2800;2869
48;Bizkaia;045;Güeñes;6658;3244;3414
48;Bizkaia;048;Ibarrangelu;641;327;314
48;Bizkaia;094;Igorre;4194;2043;2151
48;Bizkaia;049;Ispaster;721;388;333
48;Bizkaia;910;Iurreta;3724;1852;1872
48;Bizkaia;050;Izurtza;238;138;100
48;Bizkaia;022;Karrantza Harana/Valle de Carranza;2729;1416;1313
48;Bizkaia;907;Kortezubi;449;222;227
48;Bizkaia;051;Lanestosa;266;139;127
48;Bizkaia;052;Larrabetzu;2050;991;1059
48;Bizkaia;053;Laukiz;1180;592;588
48;Bizkaia;054;Leioa;30857;15012;15845
48;Bizkaia;057;Lekeitio;7182;3560;3622
48;Bizkaia;055;Lemoa;3523;1772;1751
48;Bizkaia;056;Lemoiz;1219;651;568
48;Bizkaia;081;Lezama;2394;1194;1200
48;Bizkaia;903;Loiu;2360;1158;1202
48;Bizkaia;058;Mallabia;1173;593;580
48;Bizkaia;059;Mañaria;523;269;254
48;Bizkaia;060;Markina-Xemein;4970;2533;2437
48;Bizkaia;061;Maruri-Jatabe;954;486;468
48;Bizkaia;062;Mendata;390;202;188
48;Bizkaia;063;Mendexa;460;235;225
48;Bizkaia;064;Meñaka;741;384;357
48;Bizkaia;066;Morga;417;215;202
48;Bizkaia;068;Mundaka;1875;897;978
48;Bizkaia;069;Mungia;17298;8422;8876
48;Bizkaia;007;Munitibar-Arbatzegi Gerrikaitz;461;248;213
48;Bizkaia;908;Murueta;309;160;149
48;Bizkaia;071;Muskiz;7582;3760;3822
48;Bizkaia;067;Muxika;1436;730;706
48;Bizkaia;909;Nabarniz;259;132;127
48;Bizkaia;073;Ondarroa;8495;4298;4197
48;Bizkaia;075;Orozko;2606;1284;1322
48;Bizkaia;083;Ortuella;8370;4101;4269
48;Bizkaia;072;Otxandio;1295;653;642
48;Bizkaia;077;Plentzia;4304;2097;2207
48;Bizkaia;078;Portugalete;46375;22207;24168
48;Bizkaia;082;Santurtzi;46043;22254;23789
48;Bizkaia;084;Sestao;27841;13539;14302
48;Bizkaia;904;Sondika;4519;2180;2339
48;Bizkaia;085;Sopela;13407;6594;6813
48;Bizkaia;086;Sopuerta;2595;1300;1295
48;Bizkaia;076;Sukarrieta;368;189;179
48;Bizkaia;087;Trucios-Turtzioz;510;269;241
48;Bizkaia;088;Ubide;178;92;86
48;Bizkaia;065;Ugao-Miraballes;4113;2066;2047
48;Bizkaia;089;Urduliz;4146;2072;2074
48;Bizkaia;074;Urduña/Orduña;4163;2119;2044
48;Bizkaia;080;Valle de Trápaga-Trapagaran;12030;5854;6176
48;Bizkaia;095;Zaldibar;3087;1551;1536
48;Bizkaia;096;Zalla;8440;4147;4293
48;Bizkaia;905;Zamudio;3267;1598;1669
48;Bizkaia;097;Zaratamo;1601;789;812
48;Bizkaia;024;Zeanuri;1252;642;610
48;Bizkaia;025;Zeberio;1087;548;539
48;Bizkaia;913;Zierbena;1489;783;706
48;Bizkaia;915;Ziortza-Bolibar;432;231;201
09;Burgos;001;Abajas;29;19;10
09;Burgos;003;Adrada de Haza;222;114;108
09;Burgos;006;Aguas Cándidas;58;35;23
09;Burgos;007;Aguilar de Bureba;64;35;29
09;Burgos;009;Albillos;213;115;98
09;Burgos;010;Alcocero de Mola;29;21;8
09;Burgos;011;Alfoz de Bricia;72;44;28
09;Burgos;907;Alfoz de Quintanadueñas;1976;1069;907
09;Burgos;012;Alfoz de Santa Gadea;97;56;41
09;Burgos;013;Altable;51;28;23
09;Burgos;014;Altos, Los;202;120;82
09;Burgos;016;Ameyugo;105;61;44
09;Burgos;017;Anguix;137;75;62
09;Burgos;018;Aranda de Duero;32621;15904;16717
09;Burgos;019;Arandilla;167;98;69
09;Burgos;020;Arauzo de Miel;333;175;158
09;Burgos;021;Arauzo de Salce;61;36;25
09;Burgos;022;Arauzo de Torre;76;44;32
09;Burgos;023;Arcos;1594;863;731
09;Burgos;024;Arenillas de Riopisuerga;184;105;79
09;Burgos;025;Arija;138;74;64
09;Burgos;026;Arlanzón;423;255;168
09;Burgos;027;Arraya de Oca;43;26;17
09;Burgos;029;Atapuerca;187;103;84
09;Burgos;030;Ausines, Los;125;77;48
09;Burgos;032;Avellanosa de Muñó;115;60;55
09;Burgos;033;Bahabón de Esgueva;84;53;31
09;Burgos;034;Balbases, Los;308;170;138
09;Burgos;035;Baños de Valdearados;361;213;148
09;Burgos;036;Bañuelos de Bureba;38;23;15
09;Burgos;037;Barbadillo de Herreros;112;69;43
09;Burgos;038;Barbadillo del Mercado;130;72;58
09;Burgos;039;Barbadillo del Pez;69;43;26
09;Burgos;041;Barrio de Muñó;33;18;15
09;Burgos;043;Barrios de Bureba, Los;207;122;85
09;Burgos;044;Barrios de Colina;50;25;25
09;Burgos;045;Basconcillos del Tozo;296;167;129
09;Burgos;046;Bascuñana;30;18;12
09;Burgos;047;Belbimbre;68;35;33
09;Burgos;048;Belorado;1911;980;931
09;Burgos;050;Berberana;66;34;32
09;Burgos;051;Berlangas de Roa;192;99;93
09;Burgos;052;Berzosa de Bureba;30;21;9
09;Burgos;054;Bozoó;105;60;45
09;Burgos;055;Brazacorta;66;35;31
09;Burgos;056;Briviesca;6942;3490;3452
09;Burgos;057;Bugedo;179;116;63
09;Burgos;058;Buniel;554;306;248
09;Burgos;059;Burgos;176608;84097;92511
09;Burgos;060;Busto de Bureba;157;87;70
09;Burgos;061;Cabañes de Esgueva;181;94;87
09;Burgos;062;Cabezón de la Sierra;62;27;35
09;Burgos;064;Caleruega;475;239;236
09;Burgos;065;Campillo de Aranda;173;101;72
09;Burgos;066;Campolara;70;49;21
09;Burgos;067;Canicosa de la Sierra;489;261;228
09;Burgos;068;Cantabrana;31;18;13
09;Burgos;070;Carazo;35;25;10
09;Burgos;071;Carcedo de Bureba;45;26;19
09;Burgos;072;Carcedo de Burgos;398;220;178
09;Burgos;073;Cardeñadijo;1307;720;587
09;Burgos;074;Cardeñajimeno;1037;553;484
09;Burgos;075;Cardeñuela Riopico;128;73;55
09;Burgos;076;Carrias;25;21;4
09;Burgos;077;Cascajares de Bureba;34;17;17
09;Burgos;078;Cascajares de la Sierra;38;20;18
09;Burgos;079;Castellanos de Castro;50;31;19
09;Burgos;083;Castil de Peones;37;20;17
09;Burgos;082;Castildelgado;40;23;17
09;Burgos;084;Castrillo de la Reina;202;128;74
09;Burgos;085;Castrillo de la Vega;637;343;294
09;Burgos;088;Castrillo de Riopisuerga;61;37;24
09;Burgos;086;Castrillo del Val;812;479;333
09;Burgos;090;Castrillo Mota de Judíos;56;32;24
09;Burgos;091;Castrojeriz;819;421;398
09;Burgos;063;Cavia;233;140;93
09;Burgos;093;Cayuela;174;93;81
09;Burgos;094;Cebrecos;48;28;20
09;Burgos;095;Celada del Camino;95;48;47
09;Burgos;098;Cerezo de Río Tirón;588;314;274
09;Burgos;100;Cerratón de Juarros;53;36;17
09;Burgos;101;Ciadoncha;77;45;32
09;Burgos;102;Cillaperlata;35;24;11
09;Burgos;103;Cilleruelo de Abajo;235;129;106
09;Burgos;104;Cilleruelo de Arriba;53;29;24
09;Burgos;105;Ciruelos de Cervera;112;65;47
09;Burgos;108;Cogollos;489;267;222
09;Burgos;109;Condado de Treviño;1338;764;574
09;Burgos;110;Contreras;82;50;32
09;Burgos;112;Coruña del Conde;119;73;46
09;Burgos;113;Covarrubias;578;307;271
09;Burgos;114;Cubillo del Campo;104;55;49
09;Burgos;115;Cubo de Bureba;102;59;43
09;Burgos;117;Cueva de Roa, La;90;47;43
09;Burgos;119;Cuevas de San Clemente;47;15;32
09;Burgos;120;Encío;44;24;20
09;Burgos;122;Espinosa de Cervera;100;61;39
09;Burgos;124;Espinosa de los Monteros;1782;941;841
09;Burgos;123;Espinosa del Camino;43;26;17
09;Burgos;125;Estépar;643;382;261
09;Burgos;127;Fontioso;62;35;27
09;Burgos;128;Frandovínez;92;54;38
09;Burgos;129;Fresneda de la Sierra Tirón;111;74;37
09;Burgos;130;Fresneña;81;45;36
09;Burgos;131;Fresnillo de las Dueñas;637;333;304
09;Burgos;132;Fresno de Río Tirón;189;108;81
09;Burgos;133;Fresno de Rodilla;48;27;21
09;Burgos;134;Frías;258;139;119
09;Burgos;135;Fuentebureba;52;25;27
09;Burgos;136;Fuentecén;236;132;104
09;Burgos;137;Fuentelcésped;222;112;110
09;Burgos;138;Fuentelisendo;90;52;38
09;Burgos;139;Fuentemolinos;105;66;39
09;Burgos;140;Fuentenebro;133;81;52
09;Burgos;141;Fuentespina;778;401;377
09;Burgos;143;Galbarros;31;20;11
09;Burgos;144;Gallega, La;53;32;21
09;Burgos;148;Grijalba;106;54;52
09;Burgos;149;Grisaleña;40;30;10
09;Burgos;151;Gumiel de Izán;557;317;240
09;Burgos;152;Gumiel de Mercado;358;194;164
09;Burgos;154;Hacinas;162;92;70
09;Burgos;155;Haza;27;16;11
09;Burgos;159;Hontanas;66;41;25
09;Burgos;160;Hontangas;101;63;38
09;Burgos;162;Hontoria de la Cantera;158;86;72
09;Burgos;164;Hontoria de Valdearados;195;118;77
09;Burgos;163;Hontoria del Pinar;648;360;288
09;Burgos;166;Hormazas, Las;103;60;43
09;Burgos;167;Hornillos del Camino;56;32;24
09;Burgos;168;Horra, La;357;188;169
09;Burgos;169;Hortigüela;101;63;38
09;Burgos;170;Hoyales de Roa;234;119;115
09;Burgos;172;Huérmeces;135;67;68
09;Burgos;173;Huerta de Arriba;128;73;55
09;Burgos;174;Huerta de Rey;955;512;443
09;Burgos;175;Humada;128;82;46
09;Burgos;176;Hurones;74;45;29
09;Burgos;177;Ibeas de Juarros;1372;766;606
09;Burgos;178;Ibrillos;49;30;19
09;Burgos;179;Iglesiarrubia;42;23;19
09;Burgos;180;Iglesias;143;78;65
09;Burgos;181;Isar;318;166;152
09;Burgos;182;Itero del Castillo;80;44;36
09;Burgos;183;Jaramillo de la Fuente;52;32;20
09;Burgos;184;Jaramillo Quemado;5;3;2
09;Burgos;189;Junta de Traslaloma;133;72;61
09;Burgos;190;Junta de Villalba de Losa;87;47;40
09;Burgos;191;Jurisdicción de Lara;41;22;19
09;Burgos;192;Jurisdicción de San Zadornil;52;28;24
09;Burgos;194;Lerma;2652;1331;1321
09;Burgos;195;Llano de Bureba;61;38;23
09;Burgos;196;Madrigal del Monte;160;96;64
09;Burgos;197;Madrigalejo del Monte;172;108;64
09;Burgos;198;Mahamud;116;67;49
09;Burgos;199;Mambrilla de Castrejón;101;57;44
09;Burgos;200;Mambrillas de Lara;50;29;21
09;Burgos;201;Mamolar;29;21;8
09;Burgos;202;Manciles;19;12;7
09;Burgos;206;Mazuela;64;36;28
09;Burgos;208;Mecerreyes;234;124;110
09;Burgos;209;Medina de Pomar;5865;2971;2894
09;Burgos;211;Melgar de Fernamental;1695;919;776
09;Burgos;213;Merindad de Cuesta-Urria;352;193;159
09;Burgos;214;Merindad de Montija;780;466;314
09;Burgos;906;Merindad de Río Ubierna;1461;801;660
09;Burgos;215;Merindad de Sotoscueva;419;235;184
09;Burgos;216;Merindad de Valdeporres;437;219;218
09;Burgos;217;Merindad de Valdivielso;393;227;166
09;Burgos;218;Milagros;466;249;217
09;Burgos;219;Miranda de Ebro;35922;17674;18248
09;Burgos;220;Miraveche;80;53;27
09;Burgos;221;Modúbar de la Emparedada;621;345;276
09;Burgos;223;Monasterio de la Sierra;46;30;16
09;Burgos;224;Monasterio de Rodilla;177;94;83
09;Burgos;225;Moncalvillo;86;51;35
09;Burgos;226;Monterrubio de la Demanda;64;38;26
09;Burgos;227;Montorio;156;81;75
09;Burgos;228;Moradillo de Roa;188;97;91
09;Burgos;229;Nava de Roa;218;114;104
09;Burgos;230;Navas de Bureba;35;15;20
09;Burgos;231;Nebreda;68;48;20
09;Burgos;232;Neila;171;102;69
09;Burgos;235;Olmedillo de Roa;193;113;80
09;Burgos;236;Olmillos de Muñó;39;22;17
09;Burgos;238;Oña;1075;573;502
09;Burgos;239;Oquillas;59;35;24
09;Burgos;241;Orbaneja Riopico;261;135;126
09;Burgos;242;Padilla de Abajo;86;49;37
09;Burgos;243;Padilla de Arriba;78;49;29
09;Burgos;244;Padrones de Bureba;52;25;27
09;Burgos;246;Palacios de la Sierra;734;372;362
09;Burgos;247;Palacios de Riopisuerga;26;13;13
09;Burgos;248;Palazuelos de la Sierra;81;47;34
09;Burgos;249;Palazuelos de Muñó;52;29;23
09;Burgos;250;Pampliega;312;168;144
09;Burgos;251;Pancorbo;451;249;202
09;Burgos;253;Pardilla;127;73;54
09;Burgos;255;Partido de la Sierra en Tobalina;90;52;38
09;Burgos;256;Pedrosa de Duero;444;253;191
09;Burgos;259;Pedrosa de Río Úrbel;245;147;98
09;Burgos;257;Pedrosa del Páramo;105;61;44
09;Burgos;258;Pedrosa del Príncipe;170;89;81
09;Burgos;261;Peñaranda de Duero;540;270;270
09;Burgos;262;Peral de Arlanza;166;88;78
09;Burgos;265;Piérnigas;40;25;15
09;Burgos;266;Pineda de la Sierra;102;63;39
09;Burgos;267;Pineda Trasmonte;114;70;44
09;Burgos;268;Pinilla de los Barruecos;107;62;45
09;Burgos;269;Pinilla de los Moros;39;25;14
09;Burgos;270;Pinilla Trasmonte;171;100;71
09;Burgos;272;Poza de la Sal;317;169;148
09;Burgos;273;Prádanos de Bureba;58;36;22
09;Burgos;274;Pradoluengo;1233;616;617
09;Burgos;275;Presencio;178;104;74
09;Burgos;276;Puebla de Arganzón, La;489;270;219
09;Burgos;277;Puentedura;130;87;43
09;Burgos;279;Quemada;235;137;98
09;Burgos;281;Quintana del Pidio;157;79;78
09;Burgos;280;Quintanabureba;30;19;11
09;Burgos;283;Quintanaélez;48;25;23
09;Burgos;287;Quintanaortuño;279;157;122
09;Burgos;288;Quintanapalla;105;62;43
09;Burgos;289;Quintanar de la Sierra;1819;955;864
09;Burgos;292;Quintanavides;86;51;35
09;Burgos;294;Quintanilla de la Mata;126;77;49
09;Burgos;901;Quintanilla del Agua y Tordueles;411;212;199
09;Burgos;295;Quintanilla del Coco;60;30;30
09;Burgos;298;Quintanilla San García;90;49;41
09;Burgos;301;Quintanilla Vivar;784;419;365
09;Burgos;297;Quintanillas, Las;391;223;168
09;Burgos;302;Rabanera del Pinar;115;70;45
09;Burgos;303;Rábanos;94;56;38
09;Burgos;304;Rabé de las Calzadas;223;118;105
09;Burgos;306;Rebolledo de la Torre;116;61;55
09;Burgos;307;Redecilla del Camino;121;74;47
09;Burgos;308;Redecilla del Campo;72;43;29
09;Burgos;309;Regumiel de la Sierra;359;188;171
09;Burgos;310;Reinoso;12;9;3
09;Burgos;311;Retuerta;62;40;22
09;Burgos;314;Revilla del Campo;92;61;31
09;Burgos;316;Revilla Vallejera;110;72;38
09;Burgos;312;Revilla y Ahedo, La;112;60;52
09;Burgos;315;Revillarruz;509;261;248
09;Burgos;317;Rezmondo;20;8;12
09;Burgos;318;Riocavado de la Sierra;62;38;24
09;Burgos;321;Roa;2273;1162;1111
09;Burgos;323;Rojas;70;46;24
09;Burgos;325;Royuela de Río Franco;205;122;83
09;Burgos;326;Rubena;164;98;66
09;Burgos;327;Rublacedo de Abajo;29;16;13
09;Burgos;328;Rucandio;73;35;38
09;Burgos;329;Salas de Bureba;138;83;55
09;Burgos;330;Salas de los Infantes;2017;1029;988
09;Burgos;332;Saldaña de Burgos;188;98;90
09;Burgos;334;Salinillas de Bureba;50;41;9
09;Burgos;335;San Adrián de Juarros;90;54;36
09;Burgos;337;San Juan del Monte;136;79;57
09;Burgos;338;San Mamés de Burgos;287;164;123
09;Burgos;339;San Martín de Rubiales;138;77;61
09;Burgos;340;San Millán de Lara;79;55;24
09;Burgos;360;San Vicente del Valle;29;19;10
09;Burgos;343;Santa Cecilia;102;62;40
09;Burgos;345;Santa Cruz de la Salceda;139;80;59
09;Burgos;346;Santa Cruz del Valle Urbión;98;59;39
09;Burgos;347;Santa Gadea del Cid;150;80;70
09;Burgos;348;Santa Inés;154;80;74
09;Burgos;350;Santa María del Campo;584;314;270
09;Burgos;351;Santa María del Invierno;65;45;20
09;Burgos;352;Santa María del Mercadillo;109;66;43
09;Burgos;353;Santa María Rivarredonda;93;58;35
09;Burgos;354;Santa Olalla de Bureba;36;25;11
09;Burgos;355;Santibáñez de Esgueva;93;48;45
09;Burgos;356;Santibáñez del Val;47;28;19
09;Burgos;358;Santo Domingo de Silos;297;182;115
09;Burgos;361;Sargentes de la Lora;118;64;54
09;Burgos;362;Sarracín;234;133;101
09;Burgos;363;Sasamón;1053;594;459
09;Burgos;365;Sequera de Haza, La;35;23;12
09;Burgos;366;Solarana;88;45;43
09;Burgos;368;Sordillos;23;14;9
09;Burgos;369;Sotillo de la Ribera;513;272;241
09;Burgos;372;Sotragero;286;154;132
09;Burgos;373;Sotresgudo;460;262;198
09;Burgos;374;Susinos del Páramo;103;66;37
09;Burgos;375;Tamarón;41;22;19
09;Burgos;377;Tardajos;794;417;377
09;Burgos;378;Tejada;29;21;8
09;Burgos;380;Terradillos de Esgueva;82;37;45
09;Burgos;381;Tinieblas de la Sierra;38;21;17
09;Burgos;382;Tobar;27;16;11
09;Burgos;384;Tordómar;349;193;156
09;Burgos;386;Torrecilla del Monte;64;35;29
09;Burgos;387;Torregalindo;137;85;52
09;Burgos;388;Torrelara;36;19;17
09;Burgos;389;Torrepadre;73;42;31
09;Burgos;390;Torresandino;678;367;311
09;Burgos;391;Tórtoles de Esgueva;472;248;224
09;Burgos;392;Tosantos;56;31;25
09;Burgos;394;Trespaderne;862;450;412
09;Burgos;395;Tubilla del Agua;149;91;58
09;Burgos;396;Tubilla del Lago;157;82;75
09;Burgos;398;Úrbel del Castillo;77;52;25
09;Burgos;400;Vadocondes;371;202;169
09;Burgos;403;Valdeande;96;62;34
09;Burgos;405;Valdezate;142;76;66
09;Burgos;406;Valdorros;327;189;138
09;Burgos;408;Vallarta de Bureba;42;26;16
09;Burgos;904;Valle de las Navas;523;302;221
09;Burgos;908;Valle de Losa;519;305;214
09;Burgos;409;Valle de Manzanedo;124;64;60
09;Burgos;410;Valle de Mena;3806;1960;1846
09;Burgos;411;Valle de Oca;156;97;59
09;Burgos;902;Valle de Santibáñez;494;281;213
09;Burgos;905;Valle de Sedano;453;254;199
09;Burgos;412;Valle de Tobalina;997;543;454
09;Burgos;413;Valle de Valdebezana;511;269;242
09;Burgos;414;Valle de Valdelaguna;199;112;87
09;Burgos;415;Valle de Valdelucio;306;161;145
09;Burgos;416;Valle de Zamanzas;60;32;28
09;Burgos;417;Vallejera;41;24;17
09;Burgos;418;Valles de Palenzuela;87;44;43
09;Burgos;419;Valluércanes;79;53;26
09;Burgos;407;Valmala;29;16;13
09;Burgos;422;Vid de Bureba, La;17;9;8
09;Burgos;421;Vid y Barrios, La;250;147;103
09;Burgos;423;Vileña;27;17;10
09;Burgos;427;Villadiego;1577;868;709
09;Burgos;428;Villaescusa de Roa;110;63;47
09;Burgos;429;Villaescusa la Sombría;72;51;21
09;Burgos;430;Villaespasa;26;15;11
09;Burgos;431;Villafranca Montes de Oca;125;77;48
09;Burgos;432;Villafruela;197;111;86
09;Burgos;433;Villagalijo;65;42;23
09;Burgos;434;Villagonzalo Pedernales;1764;923;841
09;Burgos;437;Villahoz;304;163;141
09;Burgos;438;Villalba de Duero;674;355;319
09;Burgos;439;Villalbilla de Burgos;1332;711;621
09;Burgos;440;Villalbilla de Gumiel;88;53;35
09;Burgos;441;Villaldemiro;73;42;31
09;Burgos;442;Villalmanzo;442;239;203
09;Burgos;443;Villamayor de los Montes;196;100;96
09;Burgos;444;Villamayor de Treviño;72;35;37
09;Burgos;445;Villambistia;44;31;13
09;Burgos;446;Villamedianilla;11;6;5
09;Burgos;447;Villamiel de la Sierra;46;28;18
09;Burgos;448;Villangómez;235;145;90
09;Burgos;449;Villanueva de Argaño;104;61;43
09;Burgos;450;Villanueva de Carazo;31;21;10
09;Burgos;451;Villanueva de Gumiel;287;147;140
09;Burgos;454;Villanueva de Teba;48;29;19
09;Burgos;455;Villaquirán de la Puebla;52;31;21
09;Burgos;456;Villaquirán de los Infantes;144;76;68
09;Burgos;903;Villarcayo de Merindad de Castilla la Vieja;4279;2204;2075
09;Burgos;458;Villariezo;617;345;272
09;Burgos;460;Villasandino;189;113;76
09;Burgos;463;Villasur de Herreros;288;170;118
09;Burgos;464;Villatuelda;40;22;18
09;Burgos;466;Villaverde del Monte;132;74;58
09;Burgos;467;Villaverde-Mogina;80;51;29
09;Burgos;471;Villayerno Morquillas;200;104;96
09;Burgos;472;Villazopeque;59;36;23
09;Burgos;473;Villegas;90;50;40
09;Burgos;476;Villoruebo;81;50;31
09;Burgos;424;Viloria de Rioja;37;22;15
09;Burgos;425;Vilviestre del Pinar;596;327;269
09;Burgos;478;Vizcaínos;44;28;16
09;Burgos;480;Zael;114;58;56
09;Burgos;482;Zarzosa de Río Pisuerga;30;19;11
09;Burgos;483;Zazuar;234;123;111
09;Burgos;485;Zuñeda;56;35;21
10;Cáceres;001;Abadía;334;189;145
10;Cáceres;002;Abertura;423;218;205
10;Cáceres;003;Acebo;590;301;289
10;Cáceres;004;Acehúche;820;405;415
10;Cáceres;005;Aceituna;627;329;298
10;Cáceres;006;Ahigal;1409;733;676
10;Cáceres;903;Alagón del Río;940;475;465
10;Cáceres;007;Albalá;712;356;356
10;Cáceres;008;Alcántara;1518;759;759
10;Cáceres;009;Alcollarín;249;120;129
10;Cáceres;010;Alcuéscar;2727;1412;1315
10;Cáceres;012;Aldea del Cano;651;304;347
10;Cáceres;013;Aldea del Obispo, La;309;163;146
10;Cáceres;011;Aldeacentenera;634;318;316
10;Cáceres;014;Aldeanueva de la Vera;2150;1052;1098
10;Cáceres;015;Aldeanueva del Camino;791;375;416
10;Cáceres;016;Aldehuela de Jerte;374;201;173
10;Cáceres;017;Alía;891;446;445
10;Cáceres;018;Aliseda;1935;975;960
10;Cáceres;019;Almaraz;1685;860;825
10;Cáceres;020;Almoharín;1899;933;966
10;Cáceres;021;Arroyo de la Luz;5966;2971;2995
10;Cáceres;023;Arroyomolinos;808;426;382
10;Cáceres;022;Arroyomolinos de la Vera;464;233;231
10;Cáceres;024;Baños de Montemayor;779;370;409
10;Cáceres;025;Barrado;428;222;206
10;Cáceres;026;Belvís de Monroy;642;336;306
10;Cáceres;027;Benquerencia;79;44;35
10;Cáceres;028;Berrocalejo;113;60;53
10;Cáceres;029;Berzocana;452;236;216
10;Cáceres;030;Bohonal de Ibor;494;250;244
10;Cáceres;031;Botija;185;101;84
10;Cáceres;032;Brozas;1927;967;960
10;Cáceres;033;Cabañas del Castillo;454;247;207
10;Cáceres;034;Cabezabellosa;364;184;180
10;Cáceres;035;Cabezuela del Valle;2335;1191;1144
10;Cáceres;036;Cabrero;359;198;161
10;Cáceres;037;Cáceres;95814;45979;49835
10;Cáceres;038;Cachorrilla;90;49;41
10;Cáceres;039;Cadalso;458;228;230
10;Cáceres;040;Calzadilla;493;252;241
10;Cáceres;041;Caminomorisco;1228;648;580
10;Cáceres;042;Campillo de Deleitosa;51;21;30
10;Cáceres;043;Campo Lugar;906;454;452
10;Cáceres;044;Cañamero;1676;882;794
10;Cáceres;045;Cañaveral;1043;510;533
10;Cáceres;046;Carbajo;217;111;106
10;Cáceres;047;Carcaboso;1123;565;558
10;Cáceres;048;Carrascalejo;254;130;124
10;Cáceres;049;Casar de Cáceres;4604;2279;2325
10;Cáceres;050;Casar de Palomero;1192;602;590
10;Cáceres;051;Casares de las Hurdes;413;211;202
10;Cáceres;052;Casas de Don Antonio;198;98;100
10;Cáceres;053;Casas de Don Gómez;294;156;138
10;Cáceres;056;Casas de Millán;634;317;317
10;Cáceres;057;Casas de Miravete;144;90;54
10;Cáceres;054;Casas del Castañar;602;292;310
10;Cáceres;055;Casas del Monte;827;419;408
10;Cáceres;058;Casatejada;1413;729;684
10;Cáceres;059;Casillas de Coria;400;197;203
10;Cáceres;060;Castañar de Ibor;1094;562;532
10;Cáceres;061;Ceclavín;1897;970;927
10;Cáceres;062;Cedillo;465;244;221
10;Cáceres;063;Cerezo;177;86;91
10;Cáceres;064;Cilleros;1716;872;844
10;Cáceres;065;Collado de la Vera;200;112;88
10;Cáceres;066;Conquista de la Sierra;187;109;78
10;Cáceres;067;Coria;12886;6334;6552
10;Cáceres;068;Cuacos de Yuste;849;438;411
10;Cáceres;069;Cumbre, La;902;451;451
10;Cáceres;070;Deleitosa;762;379;383
10;Cáceres;071;Descargamaría;138;80;58
10;Cáceres;072;Eljas;940;480;460
10;Cáceres;073;Escurial;820;430;390
10;Cáceres;075;Fresnedoso de Ibor;284;149;135
10;Cáceres;076;Galisteo;1009;504;505
10;Cáceres;077;Garciaz;773;398;375
10;Cáceres;079;Garganta la Olla;1010;535;475
10;Cáceres;078;Garganta, La;428;227;201
10;Cáceres;080;Gargantilla;403;208;195
10;Cáceres;081;Gargüera;136;77;59
10;Cáceres;082;Garrovillas de Alconétar;2145;1057;1088
10;Cáceres;083;Garvín;91;51;40
10;Cáceres;084;Gata;1556;807;749
10;Cáceres;085;Gordo, El;388;195;193
10;Cáceres;086;Granja, La;352;187;165
10;Cáceres;087;Guadalupe;1999;990;1009
10;Cáceres;088;Guijo de Coria;214;113;101
10;Cáceres;089;Guijo de Galisteo;1559;789;770
10;Cáceres;090;Guijo de Granadilla;557;295;262
10;Cáceres;091;Guijo de Santa Bárbara;416;217;199
10;Cáceres;092;Herguijuela;322;166;156
10;Cáceres;093;Hernán-Pérez;469;235;234
10;Cáceres;094;Herrera de Alcántara;273;143;130
10;Cáceres;095;Herreruela;369;187;182
10;Cáceres;096;Hervás;4120;2035;2085
10;Cáceres;097;Higuera;106;64;42
10;Cáceres;098;Hinojal;408;207;201
10;Cáceres;099;Holguera;673;331;342
10;Cáceres;100;Hoyos;923;451;472
10;Cáceres;101;Huélaga;223;115;108
10;Cáceres;102;Ibahernando;584;288;296
10;Cáceres;103;Jaraicejo;502;244;258
10;Cáceres;104;Jaraíz de la Vera;6492;3238;3254
10;Cáceres;105;Jarandilla de la Vera;2944;1469;1475
10;Cáceres;106;Jarilla;139;73;66
10;Cáceres;107;Jerte;1269;646;623
10;Cáceres;108;Ladrillar;217;115;102
10;Cáceres;109;Logrosán;2045;1030;1015
10;Cáceres;110;Losar de la Vera;2813;1443;1370
10;Cáceres;111;Madrigal de la Vera;1614;849;765
10;Cáceres;112;Madrigalejo;1842;916;926
10;Cáceres;113;Madroñera;2680;1334;1346
10;Cáceres;114;Majadas;1341;672;669
10;Cáceres;115;Malpartida de Cáceres;4268;2143;2125
10;Cáceres;116;Malpartida de Plasencia;4673;2335;2338
10;Cáceres;117;Marchagaz;213;109;104
10;Cáceres;118;Mata de Alcántara;314;162;152
10;Cáceres;119;Membrío;678;334;344
10;Cáceres;120;Mesas de Ibor;186;98;88
10;Cáceres;121;Miajadas;9879;4916;4963
10;Cáceres;122;Millanes;238;125;113
10;Cáceres;123;Mirabel;681;340;341
10;Cáceres;124;Mohedas de Granadilla;844;418;426
10;Cáceres;125;Monroy;1004;501;503
10;Cáceres;126;Montánchez;1809;904;905
10;Cáceres;127;Montehermoso;5817;2965;2852
10;Cáceres;128;Moraleja;6912;3450;3462
10;Cáceres;129;Morcillo;407;192;215
10;Cáceres;130;Navaconcejo;2003;1019;984
10;Cáceres;131;Navalmoral de la Mata;17247;8317;8930
10;Cáceres;132;Navalvillar de Ibor;443;223;220
10;Cáceres;133;Navas del Madroño;1363;677;686
10;Cáceres;134;Navezuelas;671;347;324
10;Cáceres;135;Nuñomoral;1362;722;640
10;Cáceres;136;Oliva de Plasencia;316;173;143
10;Cáceres;137;Palomero;377;202;175
10;Cáceres;138;Pasarón de la Vera;657;318;339
10;Cáceres;139;Pedroso de Acim;101;54;47
10;Cáceres;140;Peraleda de la Mata;1399;701;698
10;Cáceres;141;Peraleda de San Román;291;148;143
10;Cáceres;142;Perales del Puerto;964;494;470
10;Cáceres;143;Pescueza;160;73;87
10;Cáceres;144;Pesga, La;1108;573;535
10;Cáceres;145;Piedras Albas;161;76;85
10;Cáceres;146;Pinofranqueado;1838;980;858
10;Cáceres;147;Piornal;1547;786;761
10;Cáceres;148;Plasencia;40663;19700;20963
10;Cáceres;149;Plasenzuela;481;238;243
10;Cáceres;150;Portaje;386;196;190
10;Cáceres;151;Portezuelo;232;123;109
10;Cáceres;152;Pozuelo de Zarzón;492;244;248
10;Cáceres;905;Pueblonuevo de Miramontes;830;424;406
10;Cáceres;153;Puerto de Santa Cruz;346;176;170
10;Cáceres;154;Rebollar;214;106;108
10;Cáceres;155;Riolobos;1301;678;623
10;Cáceres;156;Robledillo de Gata;95;50;45
10;Cáceres;157;Robledillo de la Vera;288;151;137
10;Cáceres;158;Robledillo de Trujillo;370;191;179
10;Cáceres;159;Robledollano;324;177;147
10;Cáceres;160;Romangordo;257;124;133
10;Cáceres;901;Rosalejo;1476;786;690
10;Cáceres;161;Ruanes;70;39;31
10;Cáceres;162;Salorino;629;330;299
10;Cáceres;163;Salvatierra de Santiago;236;122;114
10;Cáceres;164;San Martín de Trevejo;827;408;419
10;Cáceres;165;Santa Ana;265;145;120
10;Cáceres;166;Santa Cruz de la Sierra;326;162;164
10;Cáceres;167;Santa Cruz de Paniagua;330;182;148
10;Cáceres;168;Santa Marta de Magasca;300;150;150
10;Cáceres;169;Santiago de Alcántara;563;274;289
10;Cáceres;170;Santiago del Campo;280;144;136
10;Cáceres;171;Santibáñez el Alto;341;178;163
10;Cáceres;172;Santibáñez el Bajo;767;400;367
10;Cáceres;173;Saucedilla;890;469;421
10;Cáceres;174;Segura de Toro;191;89;102
10;Cáceres;175;Serradilla;1634;827;807
10;Cáceres;176;Serrejón;430;217;213
10;Cáceres;177;Sierra de Fuentes;2026;1025;1001
10;Cáceres;178;Talaván;866;442;424
10;Cáceres;179;Talaveruela de la Vera;334;180;154
10;Cáceres;180;Talayuela;7377;4013;3364
10;Cáceres;181;Tejeda de Tiétar;829;446;383
10;Cáceres;904;Tiétar;931;495;436
10;Cáceres;182;Toril;169;106;63
10;Cáceres;183;Tornavacas;1133;587;546
10;Cáceres;184;Torno, El;908;477;431
10;Cáceres;187;Torre de Don Miguel;509;272;237
10;Cáceres;188;Torre de Santa María;566;284;282
10;Cáceres;185;Torrecilla de los Ángeles;640;329;311
10;Cáceres;186;Torrecillas de la Tiesa;1122;561;561
10;Cáceres;190;Torrejón el Rubio;618;316;302
10;Cáceres;189;Torrejoncillo;3116;1525;1591
10;Cáceres;191;Torremenga;624;337;287
10;Cáceres;192;Torremocha;875;429;446
10;Cáceres;193;Torreorgaz;1678;807;871
10;Cáceres;194;Torrequemada;601;287;314
10;Cáceres;195;Trujillo;9436;4573;4863
10;Cáceres;196;Valdastillas;325;166;159
10;Cáceres;197;Valdecañas de Tajo;133;72;61
10;Cáceres;198;Valdefuentes;1277;630;647
10;Cáceres;199;Valdehúncar;182;95;87
10;Cáceres;200;Valdelacasa de Tajo;407;208;199
10;Cáceres;201;Valdemorales;197;98;99
10;Cáceres;202;Valdeobispo;680;335;345
10;Cáceres;203;Valencia de Alcántara;5646;2780;2866
10;Cáceres;204;Valverde de la Vera;503;254;249
10;Cáceres;205;Valverde del Fresno;2391;1211;1180
10;Cáceres;902;Vegaviana;858;439;419
10;Cáceres;206;Viandar de la Vera;246;126;120
10;Cáceres;207;Villa del Campo;527;254;273
10;Cáceres;208;Villa del Rey;130;65;65
10;Cáceres;209;Villamesías;285;141;144
10;Cáceres;210;Villamiel;505;254;251
10;Cáceres;211;Villanueva de la Sierra;449;220;229
10;Cáceres;212;Villanueva de la Vera;2092;1059;1033
10;Cáceres;214;Villar de Plasencia;232;124;108
10;Cáceres;213;Villar del Pedroso;636;329;307
10;Cáceres;215;Villasbuenas de Gata;370;192;178
10;Cáceres;216;Zarza de Granadilla;1827;930;897
10;Cáceres;217;Zarza de Montánchez;580;288;292
10;Cáceres;218;Zarza la Mayor;1306;647;659
10;Cáceres;219;Zorita;1446;726;720
11;Cádiz;001;Alcalá de los Gazules;5316;2736;2580
11;Cádiz;002;Alcalá del Valle;5174;2614;2560
11;Cádiz;003;Algar;1429;731;698
11;Cádiz;004;Algeciras;120601;59592;61009
11;Cádiz;005;Algodonales;5650;2870;2780
11;Cádiz;006;Arcos de la Frontera;31114;15583;15531
11;Cádiz;007;Barbate;22720;11390;11330
11;Cádiz;008;Barrios, Los;23316;11660;11656
11;Cádiz;901;Benalup-Casas Viejas;7003;3560;3443
11;Cádiz;009;Benaocaz;694;367;327
11;Cádiz;010;Bornos;7864;3926;3938
11;Cádiz;011;Bosque, El;2114;1064;1050
11;Cádiz;012;Cádiz;118919;56362;62557
11;Cádiz;013;Castellar de la Frontera;3050;1526;1524
11;Cádiz;015;Chiclana de la Frontera;82645;41549;41096
11;Cádiz;016;Chipiona;19095;9585;9510
11;Cádiz;014;Conil de la Frontera;22297;11253;11044
11;Cádiz;017;Espera;3912;1974;1938
11;Cádiz;018;Gastor, El;1783;931;852
11;Cádiz;019;Grazalema;2144;1068;1076
11;Cádiz;020;Jerez de la Frontera;212830;104197;108633
11;Cádiz;021;Jimena de la Frontera;9756;5021;4735
11;Cádiz;022;Línea de la Concepción, La;63278;31104;32174
11;Cádiz;023;Medina-Sidonia;11756;5997;5759
11;Cádiz;024;Olvera;8233;4067;4166
11;Cádiz;025;Paterna de Rivera;5570;2875;2695
11;Cádiz;026;Prado del Rey;5767;2886;2881
11;Cádiz;027;Puerto de Santa María, El;88184;43332;44852
11;Cádiz;028;Puerto Real;41467;20891;20576
11;Cádiz;029;Puerto Serrano;7111;3606;3505
11;Cádiz;030;Rota;29030;14459;14571
11;Cádiz;031;San Fernando;95949;46989;48960
11;Cádiz;902;San José del Valle;4442;2266;2176
11;Cádiz;033;San Roque;29575;14803;14772
11;Cádiz;032;Sanlúcar de Barrameda;67620;33687;33933
11;Cádiz;034;Setenil de las Bodegas;2809;1431;1378
11;Cádiz;035;Tarifa;18116;9172;8944
11;Cádiz;036;Torre Alháquime;795;399;396
11;Cádiz;037;Trebujena;7056;3527;3529
11;Cádiz;038;Ubrique;16766;8283;8483
11;Cádiz;039;Vejer de la Frontera;12788;6407;6381
11;Cádiz;040;Villaluenga del Rosario;457;243;214
11;Cádiz;041;Villamartín;12267;6151;6116
11;Cádiz;042;Zahara;1427;724;703
39;Cantabria;001;Alfoz de Lloredo;2466;1260;1206
39;Cantabria;002;Ampuero;4181;2150;2031
39;Cantabria;003;Anievas;314;162;152
39;Cantabria;004;Arenas de Iguña;1711;874;837
39;Cantabria;005;Argoños;1720;895;825
39;Cantabria;006;Arnuero;2091;1055;1036
39;Cantabria;007;Arredondo;480;275;205
39;Cantabria;008;Astillero, El;18134;8827;9307
39;Cantabria;009;Bárcena de Cicero;4124;2136;1988
39;Cantabria;010;Bárcena de Pie de Concha;710;354;356
39;Cantabria;011;Bareyo;1999;1016;983
39;Cantabria;012;Cabezón de la Sal;8345;4039;4306
39;Cantabria;013;Cabezón de Liébana;601;354;247
39;Cantabria;014;Cabuérniga;1012;556;456
39;Cantabria;015;Camaleño;977;533;444
39;Cantabria;016;Camargo;30611;15019;15592
39;Cantabria;027;Campoo de Enmedio;3778;1934;1844
39;Cantabria;017;Campoo de Yuso;696;368;328
39;Cantabria;018;Cartes;5733;2882;2851
39;Cantabria;019;Castañeda;2687;1378;1309
39;Cantabria;020;Castro-Urdiales;31901;15876;16025
39;Cantabria;021;Cieza;556;284;272
39;Cantabria;022;Cillorigo de Liébana;1310;704;606
39;Cantabria;023;Colindres;8331;4105;4226
39;Cantabria;024;Comillas;2228;1052;1176
39;Cantabria;025;Corrales de Buelna, Los;11003;5399;5604
39;Cantabria;026;Corvera de Toranzo;2074;1055;1019
39;Cantabria;028;Entrambasaguas;4943;2507;2436
39;Cantabria;029;Escalante;747;384;363
39;Cantabria;030;Guriezo;2359;1210;1149
39;Cantabria;031;Hazas de Cesto;1522;768;754
39;Cantabria;032;Hermandad de Campoo de Suso;1643;895;748
39;Cantabria;033;Herrerías;641;358;283
39;Cantabria;034;Lamasón;298;189;109
39;Cantabria;035;Laredo;11446;5471;5975
39;Cantabria;036;Liendo;1227;635;592
39;Cantabria;037;Liérganes;2372;1169;1203
39;Cantabria;038;Limpias;1813;898;915
39;Cantabria;039;Luena;615;335;280
39;Cantabria;040;Marina de Cudeyo;5174;2587;2587
39;Cantabria;041;Mazcuerras;2119;1085;1034
39;Cantabria;042;Medio Cudeyo;7482;3663;3819
39;Cantabria;043;Meruelo;1965;1004;961
39;Cantabria;044;Miengo;4741;2408;2333
39;Cantabria;045;Miera;395;213;182
39;Cantabria;046;Molledo;1589;788;801
39;Cantabria;047;Noja;2562;1272;1290
39;Cantabria;048;Penagos;2060;1056;1004
39;Cantabria;049;Peñarrubia;349;193;156
39;Cantabria;050;Pesaguero;311;181;130
39;Cantabria;051;Pesquera;71;43;28
39;Cantabria;052;Piélagos;24574;12193;12381
39;Cantabria;053;Polaciones;237;151;86
39;Cantabria;054;Polanco;5794;2923;2871
39;Cantabria;055;Potes;1360;668;692
39;Cantabria;056;Puente Viesgo;2877;1457;1420
39;Cantabria;057;Ramales de la Victoria;2827;1426;1401
39;Cantabria;058;Rasines;959;507;452
39;Cantabria;059;Reinosa;9496;4474;5022
39;Cantabria;060;Reocín;8318;4091;4227
39;Cantabria;061;Ribamontán al Mar;4422;2230;2192
39;Cantabria;062;Ribamontán al Monte;2231;1161;1070
39;Cantabria;063;Rionansa;1058;596;462
39;Cantabria;064;Riotuerto;1610;771;839
39;Cantabria;065;Rozas de Valdearroyo, Las;275;156;119
39;Cantabria;066;Ruente;1044;560;484
39;Cantabria;067;Ruesga;870;471;399
39;Cantabria;068;Ruiloba;765;399;366
39;Cantabria;069;San Felices de Buelna;2381;1193;1188
39;Cantabria;070;San Miguel de Aguayo;160;82;78
39;Cantabria;071;San Pedro del Romeral;453;250;203
39;Cantabria;072;San Roque de Riomiera;386;227;159
39;Cantabria;080;San Vicente de la Barquera;4196;2097;2099
39;Cantabria;073;Santa Cruz de Bezana;12679;6225;6454
39;Cantabria;074;Santa María de Cayón;9078;4573;4505
39;Cantabria;075;Santander;172656;79618;93038
39;Cantabria;076;Santillana del Mar;4184;2039;2145
39;Cantabria;077;Santiurde de Reinosa;265;153;112
39;Cantabria;078;Santiurde de Toranzo;1602;821;781
39;Cantabria;079;Santoña;11085;5414;5671
39;Cantabria;081;Saro;512;268;244
39;Cantabria;082;Selaya;1931;961;970
39;Cantabria;083;Soba;1249;681;568
39;Cantabria;084;Solórzano;1012;544;468
39;Cantabria;085;Suances;8579;4247;4332
39;Cantabria;086;Tojos, Los;399;236;163
39;Cantabria;087;Torrelavega;52819;25018;27801
39;Cantabria;088;Tresviso;71;48;23
39;Cantabria;089;Tudanca;147;106;41
39;Cantabria;090;Udías;903;459;444
39;Cantabria;095;Val de San Vicente;2763;1432;1331
39;Cantabria;091;Valdáliga;2272;1175;1097
39;Cantabria;092;Valdeolea;987;524;463
39;Cantabria;093;Valdeprado del Río;331;188;143
39;Cantabria;094;Valderredible;1001;566;435
39;Cantabria;101;Valle de Villaverde;327;166;161
39;Cantabria;096;Vega de Liébana;788;412;376
39;Cantabria;097;Vega de Pas;795;410;385
39;Cantabria;098;Villacarriedo;1636;859;777
39;Cantabria;099;Villaescusa;3883;1930;1953
39;Cantabria;100;Villafufre;1017;530;487
39;Cantabria;102;Voto;2725;1448;1277
12;Castellón/Castelló;002;Aín;122;66;56
12;Castellón/Castelló;003;Albocàsser;1303;638;665
12;Castellón/Castelló;004;Alcalà de Xivert;6893;3512;3381
12;Castellón/Castelló;005;Alcora, l';10535;5342;5193
12;Castellón/Castelló;006;Alcudia de Veo;201;107;94
12;Castellón/Castelló;007;Alfondeguilla;894;449;445
12;Castellón/Castelló;008;Algimia de Almonacid;265;150;115
12;Castellón/Castelló;009;Almazora/Almassora;25632;12875;12757
12;Castellón/Castelló;010;Almedíjar;281;146;135
12;Castellón/Castelló;011;Almenara;5949;2965;2984
12;Castellón/Castelló;901;Alqueries, les/Alquerías del Niño Perdido;4528;2240;2288
12;Castellón/Castelló;012;Altura;3621;1857;1764
12;Castellón/Castelló;013;Arañuel;160;80;80
12;Castellón/Castelló;014;Ares del Maestrat;202;114;88
12;Castellón/Castelló;015;Argelita;97;54;43
12;Castellón/Castelló;016;Artana;1979;1012;967
12;Castellón/Castelló;001;Atzeneta del Maestrat;1286;659;627
12;Castellón/Castelló;017;Ayódar;172;94;78
12;Castellón/Castelló;018;Azuébar;322;169;153
12;Castellón/Castelló;020;Barracas;179;96;83
12;Castellón/Castelló;022;Bejís;404;231;173
12;Castellón/Castelló;024;Benafer;164;87;77
12;Castellón/Castelló;025;Benafigos;160;90;70
12;Castellón/Castelló;026;Benassal;1130;576;554
12;Castellón/Castelló;027;Benicarló;26486;13202;13284
12;Castellón/Castelló;028;Benicasim/Benicàssim;17957;8976;8981
12;Castellón/Castelló;029;Benlloch;1095;548;547
12;Castellón/Castelló;021;Betxí;5780;2853;2927
12;Castellón/Castelló;032;Borriana/Burriana;34643;17140;17503
12;Castellón/Castelló;031;Borriol;5187;2623;2564
12;Castellón/Castelló;033;Cabanes;2966;1502;1464
12;Castellón/Castelló;034;Càlig;2020;1023;997
12;Castellón/Castelló;036;Canet lo Roig;724;353;371
12;Castellón/Castelló;037;Castell de Cabres;17;10;7
12;Castellón/Castelló;038;Castellfort;205;105;100
12;Castellón/Castelló;039;Castellnovo;981;498;483
12;Castellón/Castelló;040;Castellón de la Plana/Castelló de la Plana;170990;82982;88008
12;Castellón/Castelló;041;Castillo de Villamalefa;103;65;38
12;Castellón/Castelló;042;Catí;779;390;389
12;Castellón/Castelló;043;Caudiel;673;352;321
12;Castellón/Castelló;044;Cervera del Maestre;642;307;335
12;Castellón/Castelló;053;Chilches/Xilxes;2677;1407;1270
12;Castellón/Castelló;055;Chodos/Xodos;117;66;51
12;Castellón/Castelló;056;Chóvar;327;170;157
12;Castellón/Castelló;045;Cinctorres;418;201;217
12;Castellón/Castelló;046;Cirat;220;121;99
12;Castellón/Castelló;048;Cortes de Arenoso;300;164;136
12;Castellón/Castelló;049;Costur;543;285;258
12;Castellón/Castelló;050;Coves de Vinromà, les;1870;924;946
12;Castellón/Castelló;051;Culla;524;272;252
12;Castellón/Castelló;057;Eslida;805;405;400
12;Castellón/Castelló;058;Espadilla;83;46;37
12;Castellón/Castelló;059;Fanzara;281;144;137
12;Castellón/Castelló;060;Figueroles;542;277;265
12;Castellón/Castelló;061;Forcall;461;223;238
12;Castellón/Castelló;063;Fuente la Reina;46;28;18
12;Castellón/Castelló;064;Fuentes de Ayódar;114;59;55
12;Castellón/Castelló;065;Gaibiel;205;110;95
12;Castellón/Castelló;067;Geldo;646;328;318
12;Castellón/Castelló;068;Herbés;49;27;22
12;Castellón/Castelló;069;Higueras;76;42;34
12;Castellón/Castelló;070;Jana, la;700;350;350
12;Castellón/Castelló;071;Jérica;1574;811;763
12;Castellón/Castelló;074;Llosa, la;969;481;488
12;Castellón/Castelló;072;Lucena del Cid;1372;686;686
12;Castellón/Castelló;073;Ludiente;170;98;72
12;Castellón/Castelló;075;Mata de Morella, la;173;88;85
12;Castellón/Castelló;076;Matet;87;45;42
12;Castellón/Castelló;077;Moncofa;6181;3208;2973
12;Castellón/Castelló;078;Montán;383;185;198
12;Castellón/Castelló;079;Montanejos;539;273;266
12;Castellón/Castelló;080;Morella;2504;1245;1259
12;Castellón/Castelló;081;Navajas;745;389;356
12;Castellón/Castelló;082;Nules;13305;6618;6687
12;Castellón/Castelló;083;Olocau del Rey;118;66;52
12;Castellón/Castelló;084;Onda;24856;12505;12351
12;Castellón/Castelló;085;Oropesa del Mar/Orpesa;9245;4813;4432
12;Castellón/Castelló;087;Palanques;35;19;16
12;Castellón/Castelló;088;Pavías;69;41;28
12;Castellón/Castelló;089;Peníscola/Peñíscola;7421;3751;3670
12;Castellón/Castelló;090;Pina de Montalgrao;127;64;63
12;Castellón/Castelló;093;Pobla de Benifassà, la;209;113;96
12;Castellón/Castelló;094;Pobla Tornesa, la;1200;624;576
12;Castellón/Castelló;091;Portell de Morella;200;100;100
12;Castellón/Castelló;092;Puebla de Arenoso;143;74;69
12;Castellón/Castelló;095;Ribesalbes;1223;623;600
12;Castellón/Castelló;096;Rossell;1002;528;474
12;Castellón/Castelló;097;Sacañet;67;41;26
12;Castellón/Castelló;098;Salzadella, la;751;380;371
12;Castellón/Castelló;101;San Rafael del Río;483;239;244
12;Castellón/Castelló;902;Sant Joan de Moró;3043;1585;1458
12;Castellón/Castelló;099;Sant Jordi/San Jorge;970;498;472
12;Castellón/Castelló;100;Sant Mateu;1979;977;1002
12;Castellón/Castelló;102;Santa Magdalena de Pulpis;791;429;362
12;Castellón/Castelló;104;Segorbe;9005;4460;4545
12;Castellón/Castelló;103;Serratella, la;99;55;44
12;Castellón/Castelló;105;Sierra Engarcerán;1019;539;480
12;Castellón/Castelló;106;Soneja;1463;713;750
12;Castellón/Castelló;107;Sot de Ferrer;418;213;205
12;Castellón/Castelló;108;Sueras/Suera;551;283;268
12;Castellón/Castelló;109;Tales;812;405;407
12;Castellón/Castelló;110;Teresa;266;135;131
12;Castellón/Castelló;111;Tírig;465;239;226
12;Castellón/Castelló;112;Todolella;147;85;62
12;Castellón/Castelló;113;Toga;98;49;49
12;Castellón/Castelló;114;Torás;228;120;108
12;Castellón/Castelló;115;Toro, El;252;140;112
12;Castellón/Castelló;116;Torralba del Pinar;66;32;34
12;Castellón/Castelló;119;Torre d'En Besora, la;166;93;73
12;Castellón/Castelló;120;Torre d'en Doménec, la;212;107;105
12;Castellón/Castelló;117;Torreblanca;5398;2740;2658
12;Castellón/Castelló;118;Torrechiva;75;44;31
12;Castellón/Castelló;121;Traiguera;1502;751;751
12;Castellón/Castelló;122;Useras/Useres, les;994;519;475
12;Castellón/Castelló;124;Vall d'Alba;2809;1463;1346
12;Castellón/Castelló;125;Vall de Almonacid;261;136;125
12;Castellón/Castelló;126;Vall d'Uixó, la;31819;15756;16063
12;Castellón/Castelló;123;Vallat;54;25;29
12;Castellón/Castelló;127;Vallibona;81;45;36
12;Castellón/Castelló;128;Vilafamés;1851;979;872
12;Castellón/Castelló;132;Vilanova d'Alcolea;595;311;284
12;Castellón/Castelló;134;Vilar de Canes;179;95;84
12;Castellón/Castelló;135;Vila-real;50252;24866;25386
12;Castellón/Castelló;136;Vilavella, la;3243;1623;1620
12;Castellón/Castelló;129;Villafranca del Cid/Vilafranca;2289;1126;1163
12;Castellón/Castelló;130;Villahermosa del Río;487;269;218
12;Castellón/Castelló;131;Villamalur;68;40;28
12;Castellón/Castelló;133;Villanueva de Viver;60;33;27
12;Castellón/Castelló;137;Villores;38;20;18
12;Castellón/Castelló;138;Vinaròs;28290;13989;14301
12;Castellón/Castelló;139;Vistabella del Maestrat;364;197;167
12;Castellón/Castelló;140;Viver;1536;792;744
12;Castellón/Castelló;052;Xert;754;363;391
12;Castellón/Castelló;141;Zorita del Maestrazgo;124;63;61
12;Castellón/Castelló;142;Zucaina;190;105;85
13;Ciudad Real;001;Abenójar;1460;749;711
13;Ciudad Real;002;Agudo;1760;894;866
13;Ciudad Real;003;Alamillo;528;270;258
13;Ciudad Real;004;Albaladejo;1235;633;602
13;Ciudad Real;005;Alcázar de San Juan;30967;15074;15893
13;Ciudad Real;006;Alcoba;614;305;309
13;Ciudad Real;007;Alcolea de Calatrava;1443;732;711
13;Ciudad Real;008;Alcubillas;510;266;244
13;Ciudad Real;009;Aldea del Rey;1721;876;845
13;Ciudad Real;010;Alhambra;1022;524;498
13;Ciudad Real;011;Almadén;5657;2701;2956
13;Ciudad Real;012;Almadenejos;460;233;227
13;Ciudad Real;013;Almagro;8967;4416;4551
13;Ciudad Real;014;Almedina;555;290;265
13;Ciudad Real;015;Almodóvar del Campo;6360;3209;3151
13;Ciudad Real;016;Almuradiel;830;413;417
13;Ciudad Real;017;Anchuras;331;171;160
13;Ciudad Real;903;Arenales de San Gregorio;647;336;311
13;Ciudad Real;018;Arenas de San Juan;1045;525;520
13;Ciudad Real;019;Argamasilla de Alba;6972;3492;3480
13;Ciudad Real;020;Argamasilla de Calatrava;5987;3042;2945
13;Ciudad Real;021;Arroba de los Montes;467;246;221
13;Ciudad Real;022;Ballesteros de Calatrava;387;193;194
13;Ciudad Real;023;Bolaños de Calatrava;11994;6103;5891
13;Ciudad Real;024;Brazatortas;1033;541;492
13;Ciudad Real;025;Cabezarados;325;173;152
13;Ciudad Real;026;Cabezarrubias del Puerto;505;267;238
13;Ciudad Real;027;Calzada de Calatrava;4053;2023;2030
13;Ciudad Real;028;Campo de Criptana;13949;6991;6958
13;Ciudad Real;029;Cañada de Calatrava;99;56;43
13;Ciudad Real;030;Caracuel de Calatrava;160;93;67
13;Ciudad Real;031;Carrión de Calatrava;3068;1546;1522
13;Ciudad Real;032;Carrizosa;1299;655;644
13;Ciudad Real;033;Castellar de Santiago;2006;1010;996
13;Ciudad Real;038;Chillón;1901;927;974
13;Ciudad Real;034;Ciudad Real;74054;35052;39002
13;Ciudad Real;035;Corral de Calatrava;1134;557;577
13;Ciudad Real;036;Cortijos, Los;934;487;447
13;Ciudad Real;037;Cózar;1062;522;540
13;Ciudad Real;039;Daimiel;18396;9170;9226
13;Ciudad Real;040;Fernán Caballero;1057;531;526
13;Ciudad Real;041;Fontanarejo;263;146;117
13;Ciudad Real;042;Fuencaliente;1055;553;502
13;Ciudad Real;043;Fuenllana;253;132;121
13;Ciudad Real;044;Fuente el Fresno;3346;1737;1609
13;Ciudad Real;045;Granátula de Calatrava;794;389;405
13;Ciudad Real;046;Guadalmez;794;398;396
13;Ciudad Real;047;Herencia;8580;4365;4215
13;Ciudad Real;048;Hinojosas de Calatrava;500;257;243
13;Ciudad Real;049;Horcajo de los Montes;958;481;477
13;Ciudad Real;050;Labores, Las;613;308;305
13;Ciudad Real;904;Llanos del Caudillo;727;365;362
13;Ciudad Real;051;Luciana;394;208;186
13;Ciudad Real;052;Malagón;8153;4051;4102
13;Ciudad Real;053;Manzanares;18475;9173;9302
13;Ciudad Real;054;Membrilla;6134;3090;3044
13;Ciudad Real;055;Mestanza;730;359;371
13;Ciudad Real;056;Miguelturra;15133;7635;7498
13;Ciudad Real;057;Montiel;1400;738;662
13;Ciudad Real;058;Moral de Calatrava;5325;2682;2643
13;Ciudad Real;059;Navalpino;233;119;114
13;Ciudad Real;060;Navas de Estena;254;136;118
13;Ciudad Real;061;Pedro Muñoz;7576;3854;3722
13;Ciudad Real;062;Picón;685;360;325
13;Ciudad Real;063;Piedrabuena;4542;2311;2231
13;Ciudad Real;064;Poblete;2366;1232;1134
13;Ciudad Real;065;Porzuna;3661;1883;1778
13;Ciudad Real;066;Pozuelo de Calatrava;3362;1719;1643
13;Ciudad Real;067;Pozuelos de Calatrava, Los;400;210;190
13;Ciudad Real;068;Puebla de Don Rodrigo;1228;670;558
13;Ciudad Real;069;Puebla del Príncipe;752;381;371
13;Ciudad Real;070;Puerto Lápice;947;473;474
13;Ciudad Real;071;Puertollano;49166;23808;25358
13;Ciudad Real;072;Retuerta del Bullaque;1006;550;456
13;Ciudad Real;901;Robledo, El;1142;602;540
13;Ciudad Real;902;Ruidera;580;293;287
13;Ciudad Real;073;Saceruela;607;323;284
13;Ciudad Real;074;San Carlos del Valle;1170;610;560
13;Ciudad Real;075;San Lorenzo de Calatrava;219;116;103
13;Ciudad Real;076;Santa Cruz de los Cáñamos;550;274;276
13;Ciudad Real;077;Santa Cruz de Mudela;4239;2114;2125
13;Ciudad Real;078;Socuéllamos;12628;6425;6203
13;Ciudad Real;080;Solana del Pino;342;181;161
13;Ciudad Real;079;Solana, La;15792;7978;7814
13;Ciudad Real;081;Terrinches;748;387;361
13;Ciudad Real;082;Tomelloso;36746;18251;18495
13;Ciudad Real;083;Torralba de Calatrava;3025;1497;1528
13;Ciudad Real;084;Torre de Juan Abad;1081;532;549
13;Ciudad Real;085;Torrenueva;2820;1422;1398
13;Ciudad Real;086;Valdemanco del Esteras;196;102;94
13;Ciudad Real;087;Valdepeñas;30277;14834;15443
13;Ciudad Real;088;Valenzuela de Calatrava;708;331;377
13;Ciudad Real;089;Villahermosa;1961;937;1024
13;Ciudad Real;090;Villamanrique;1239;611;628
13;Ciudad Real;091;Villamayor de Calatrava;640;316;324
13;Ciudad Real;092;Villanueva de la Fuente;2267;1163;1104
13;Ciudad Real;093;Villanueva de los Infantes;5243;2570;2673
13;Ciudad Real;094;Villanueva de San Carlos;306;160;146
13;Ciudad Real;095;Villar del Pozo;93;50;43
13;Ciudad Real;096;Villarrubia de los Ojos;10156;5059;5097
13;Ciudad Real;097;Villarta de San Juan;2907;1456;1451
13;Ciudad Real;098;Viso del Marqués;2447;1186;1261
14;Córdoba;001;Adamuz;4270;2188;2082
14;Córdoba;002;Aguilar de la Frontera;13511;6811;6700
14;Córdoba;003;Alcaracejos;1495;718;777
14;Córdoba;004;Almedinilla;2431;1214;1217
14;Córdoba;005;Almodóvar del Río;7948;3983;3965
14;Córdoba;006;Añora;1558;769;789
14;Córdoba;007;Baena;19782;10117;9665
14;Córdoba;008;Belalcázar;3391;1639;1752
14;Córdoba;009;Belmez;3062;1487;1575
14;Córdoba;010;Benamejí;5035;2510;2525
14;Córdoba;011;Blázquez, Los;695;363;332
14;Córdoba;012;Bujalance;7638;3820;3818
14;Córdoba;013;Cabra;20704;10120;10584
14;Córdoba;014;Cañete de las Torres;2992;1534;1458
14;Córdoba;015;Carcabuey;2529;1286;1243
14;Córdoba;016;Cardeña;1552;779;773
14;Córdoba;017;Carlota, La;13936;7001;6935
14;Córdoba;018;Carpio, El;4500;2244;2256
14;Córdoba;019;Castro del Río;7917;3928;3989
14;Córdoba;020;Conquista;430;215;215
14;Córdoba;021;Córdoba;326609;156914;169695
14;Córdoba;022;Doña Mencía;4789;2331;2458
14;Córdoba;023;Dos Torres;2453;1216;1237
14;Córdoba;024;Encinas Reales;2324;1154;1170
14;Córdoba;025;Espejo;3410;1727;1683
14;Córdoba;026;Espiel;2487;1236;1251
14;Córdoba;027;Fernán-Núñez;9712;4866;4846
14;Córdoba;028;Fuente la Lancha;355;183;172
14;Córdoba;029;Fuente Obejuna;4796;2458;2338
14;Córdoba;030;Fuente Palmera;10893;5458;5435
14;Córdoba;031;Fuente-Tójar;711;338;373
14;Córdoba;032;Granjuela, La;486;245;241
14;Córdoba;033;Guadalcázar;1591;793;798
14;Córdoba;034;Guijo, El;365;191;174
14;Córdoba;035;Hinojosa del Duque;6989;3418;3571
14;Córdoba;036;Hornachuelos;4598;2308;2290
14;Córdoba;037;Iznájar;4461;2241;2220
14;Córdoba;038;Lucena;42615;21256;21359
14;Córdoba;039;Luque;3071;1543;1528
14;Córdoba;040;Montalbán de Córdoba;4473;2241;2232
14;Córdoba;041;Montemayor;3924;1971;1953
14;Córdoba;042;Montilla;23365;11573;11792
14;Córdoba;043;Montoro;9635;4725;4910
14;Córdoba;044;Monturque;1981;983;998
14;Córdoba;045;Moriles;3819;1907;1912
14;Córdoba;046;Nueva Carteya;5435;2751;2684
14;Córdoba;047;Obejo;2009;1051;958
14;Córdoba;048;Palenciana;1506;759;747
14;Córdoba;049;Palma del Río;21241;10584;10657
14;Córdoba;050;Pedro Abad;2903;1472;1431
14;Córdoba;051;Pedroche;1603;775;828
14;Córdoba;052;Peñarroya-Pueblonuevo;11160;5412;5748
14;Córdoba;053;Posadas;7468;3736;3732
14;Córdoba;054;Pozoblanco;17292;8463;8829
14;Córdoba;055;Priego de Córdoba;22855;11151;11704
14;Córdoba;056;Puente Genil;30072;14944;15128
14;Córdoba;057;Rambla, La;7576;3772;3804
14;Córdoba;058;Rute;10042;4979;5063
14;Córdoba;059;San Sebastián de los Ballesteros;811;406;405
14;Córdoba;061;Santa Eufemia;822;413;409
14;Córdoba;060;Santaella;6079;3082;2997
14;Córdoba;062;Torrecampo;1150;565;585
14;Córdoba;063;Valenzuela;1208;599;609
14;Córdoba;064;Valsequillo;373;178;195
14;Córdoba;065;Victoria, La;2353;1167;1186
14;Córdoba;066;Villa del Río;7301;3654;3647
14;Córdoba;067;Villafranca de Córdoba;4918;2514;2404
14;Córdoba;068;Villaharta;669;325;344
14;Córdoba;069;Villanueva de Córdoba;9005;4447;4558
14;Córdoba;070;Villanueva del Duque;1520;763;757
14;Córdoba;071;Villanueva del Rey;1088;540;548
14;Córdoba;072;Villaralto;1196;591;605
14;Córdoba;073;Villaviciosa de Córdoba;3374;1730;1644
14;Córdoba;074;Viso, El;2636;1308;1328
14;Córdoba;075;Zuheros;657;337;320
15;Coruña, A;001;Abegondo;5533;2735;2798
15;Coruña, A;002;Ames;30544;14710;15834
15;Coruña, A;003;Aranga;1982;1002;980
15;Coruña, A;004;Ares;5672;2788;2884
15;Coruña, A;005;Arteixo;31239;15593;15646
15;Coruña, A;006;Arzúa;6211;3092;3119
15;Coruña, A;007;Baña, A;3645;1749;1896
15;Coruña, A;008;Bergondo;6656;3249;3407
15;Coruña, A;009;Betanzos;12966;6148;6818
15;Coruña, A;010;Boimorto;2111;1082;1029
15;Coruña, A;011;Boiro;18871;9206;9665
15;Coruña, A;012;Boqueixón;4291;2113;2178
15;Coruña, A;013;Brión;7590;3670;3920
15;Coruña, A;014;Cabana de Bergantiños;4446;2172;2274
15;Coruña, A;015;Cabanas;3259;1608;1651
15;Coruña, A;016;Camariñas;5486;2651;2835
15;Coruña, A;017;Cambre;24141;11853;12288
15;Coruña, A;018;Capela, A;1318;652;666
15;Coruña, A;019;Carballo;31256;15289;15967
15;Coruña, A;901;Cariño;4072;2013;2059
15;Coruña, A;020;Carnota;4170;2007;2163
15;Coruña, A;021;Carral;6172;3039;3133
15;Coruña, A;022;Cedeira;6997;3502;3495
15;Coruña, A;023;Cee;7631;3663;3968
15;Coruña, A;024;Cerceda;5031;2470;2561
15;Coruña, A;025;Cerdido;1191;580;611
15;Coruña, A;027;Coirós;1789;890;899
15;Coruña, A;028;Corcubión;1606;774;832
15;Coruña, A;029;Coristanco;6426;3086;3340
15;Coruña, A;030;Coruña, A;243978;113248;130730
15;Coruña, A;031;Culleredo;29638;14421;15217
15;Coruña, A;032;Curtis;3980;1992;1988
15;Coruña, A;033;Dodro;2853;1383;1470
15;Coruña, A;034;Dumbría;3085;1468;1617
15;Coruña, A;035;Fene;13250;6340;6910
15;Coruña, A;036;Ferrol;68308;32070;36238
15;Coruña, A;037;Fisterra;4737;2399;2338
15;Coruña, A;038;Frades;2428;1212;1216
15;Coruña, A;039;Irixoa;1369;694;675
15;Coruña, A;041;Laracha, A;11295;5565;5730
15;Coruña, A;040;Laxe;3148;1583;1565
15;Coruña, A;042;Lousame;3429;1669;1760
15;Coruña, A;043;Malpica de Bergantiños;5616;2747;2869
15;Coruña, A;044;Mañón;1420;686;734
15;Coruña, A;045;Mazaricos;4087;1952;2135
15;Coruña, A;046;Melide;7488;3678;3810
15;Coruña, A;047;Mesía;2700;1342;1358
15;Coruña, A;048;Miño;5832;2901;2931
15;Coruña, A;049;Moeche;1220;565;655
15;Coruña, A;050;Monfero;2019;1030;989
15;Coruña, A;051;Mugardos;5335;2605;2730
15;Coruña, A;053;Muros;8834;4280;4554
15;Coruña, A;052;Muxía;4941;2404;2537
15;Coruña, A;054;Narón;39426;19093;20333
15;Coruña, A;055;Neda;5197;2538;2659
15;Coruña, A;056;Negreira;6911;3339;3572
15;Coruña, A;057;Noia;14337;6869;7468
15;Coruña, A;058;Oleiros;35013;16984;18029
15;Coruña, A;059;Ordes;12669;6183;6486
15;Coruña, A;060;Oroso;7420;3662;3758
15;Coruña, A;061;Ortigueira;6093;2938;3155
15;Coruña, A;062;Outes;6606;3156;3450
15;Coruña, A;902;Oza-Cesuras;5181;2623;2558
15;Coruña, A;064;Paderne;2445;1197;1248
15;Coruña, A;065;Padrón;8581;4131;4450
15;Coruña, A;066;Pino, O;4653;2329;2324
15;Coruña, A;067;Pobra do Caramiñal, A;9525;4646;4879
15;Coruña, A;068;Ponteceso;5703;2841;2862
15;Coruña, A;069;Pontedeume;8005;3839;4166
15;Coruña, A;070;Pontes de García Rodríguez, As;10399;5091;5308
15;Coruña, A;071;Porto do Son;9386;4672;4714
15;Coruña, A;072;Rianxo;11295;5516;5779
15;Coruña, A;073;Ribeira;27249;13444;13805
15;Coruña, A;074;Rois;4657;2216;2441
15;Coruña, A;075;Sada;15150;7444;7706
15;Coruña, A;076;San Sadurniño;2944;1461;1483
15;Coruña, A;077;Santa Comba;9556;4610;4946
15;Coruña, A;078;Santiago de Compostela;95966;44477;51489
15;Coruña, A;079;Santiso;1672;867;805
15;Coruña, A;080;Sobrado;1882;971;911
15;Coruña, A;081;Somozas, As;1160;589;571
15;Coruña, A;082;Teo;18510;9076;9434
15;Coruña, A;083;Toques;1196;625;571
15;Coruña, A;084;Tordoia;3522;1659;1863
15;Coruña, A;085;Touro;3703;1840;1863
15;Coruña, A;086;Trazo;3190;1569;1621
15;Coruña, A;088;Val do Dubra;3974;1904;2070
15;Coruña, A;087;Valdoviño;6650;3244;3406
15;Coruña, A;089;Vedra;5012;2462;2550
15;Coruña, A;091;Vilarmaior;1260;643;617
15;Coruña, A;090;Vilasantar;1275;675;600
15;Coruña, A;092;Vimianzo;7378;3542;3836
15;Coruña, A;093;Zas;4756;2293;2463
16;Cuenca;001;Abia de la Obispalía;77;48;29
16;Cuenca;002;Acebrón, El;236;114;122
16;Cuenca;003;Alarcón;148;66;82
16;Cuenca;004;Albaladejo del Cuende;276;139;137
16;Cuenca;005;Albalate de las Nogueras;276;145;131
16;Cuenca;006;Albendea;134;63;71
16;Cuenca;007;Alberca de Záncara, La;1651;845;806
16;Cuenca;008;Alcalá de la Vega;97;51;46
16;Cuenca;009;Alcantud;65;35;30
16;Cuenca;010;Alcázar del Rey;159;77;82
16;Cuenca;011;Alcohujate;32;18;14
16;Cuenca;012;Alconchel de la Estrella;106;60;46
16;Cuenca;013;Algarra;29;19;10
16;Cuenca;014;Aliaguilla;692;359;333
16;Cuenca;015;Almarcha, La;393;220;173
16;Cuenca;016;Almendros;262;152;110
16;Cuenca;017;Almodóvar del Pinar;430;232;198
16;Cuenca;018;Almonacid del Marquesado;451;233;218
16;Cuenca;019;Altarejos;226;118;108
16;Cuenca;020;Arandilla del Arroyo;14;7;7
16;Cuenca;905;Arcas;1643;826;817
16;Cuenca;022;Arcos de la Sierra;82;49;33
16;Cuenca;024;Arguisuelas;141;75;66
16;Cuenca;025;Arrancacepas;28;15;13
16;Cuenca;026;Atalaya del Cañavate;103;50;53
16;Cuenca;027;Barajas de Melo;926;491;435
16;Cuenca;029;Barchín del Hoyo;86;52;34
16;Cuenca;030;Bascuñana de San Pedro;22;14;8
16;Cuenca;031;Beamud;51;24;27
16;Cuenca;032;Belinchón;337;175;162
16;Cuenca;033;Belmonte;2009;995;1014
16;Cuenca;034;Belmontejo;188;105;83
16;Cuenca;035;Beteta;281;138;143
16;Cuenca;036;Boniches;148;68;80
16;Cuenca;038;Buciegas;48;29;19
16;Cuenca;039;Buenache de Alarcón;491;262;229
16;Cuenca;040;Buenache de la Sierra;98;58;40
16;Cuenca;041;Buendía;419;225;194
16;Cuenca;042;Campillo de Altobuey;1405;692;713
16;Cuenca;043;Campillos-Paravientos;118;62;56
16;Cuenca;044;Campillos-Sierra;33;13;20
16;Cuenca;901;Campos del Paraíso;807;411;396
16;Cuenca;045;Canalejas del Arroyo;261;142;119
16;Cuenca;046;Cañada del Hoyo;268;135;133
16;Cuenca;047;Cañada Juncosa;264;144;120
16;Cuenca;048;Cañamares;485;261;224
16;Cuenca;049;Cañavate, El;155;83;72
16;Cuenca;050;Cañaveras;299;145;154
16;Cuenca;051;Cañaveruelas;143;74;69
16;Cuenca;052;Cañete;759;399;360
16;Cuenca;053;Cañizares;488;266;222
16;Cuenca;055;Carboneras de Guadazaón;827;428;399
16;Cuenca;056;Cardenete;517;277;240
16;Cuenca;057;Carrascosa;80;50;30
16;Cuenca;058;Carrascosa de Haro;117;59;58
16;Cuenca;060;Casas de Benítez;883;430;453
16;Cuenca;061;Casas de Fernando Alonso;1258;661;597
16;Cuenca;062;Casas de Garcimolina;30;20;10
16;Cuenca;063;Casas de Guijarro;112;60;52
16;Cuenca;064;Casas de Haro;875;467;408
16;Cuenca;065;Casas de los Pinos;441;219;222
16;Cuenca;066;Casasimarro;3113;1627;1486
16;Cuenca;067;Castejón;140;76;64
16;Cuenca;068;Castillejo de Iniesta;175;98;77
16;Cuenca;070;Castillejo-Sierra;31;16;15
16;Cuenca;072;Castillo de Garcimuñoz;152;86;66
16;Cuenca;071;Castillo-Albaráñez;22;10;12
16;Cuenca;073;Cervera del Llano;226;115;111
16;Cuenca;023;Chillarón de Cuenca;557;306;251
16;Cuenca;081;Chumillas;58;31;27
16;Cuenca;074;Cierva, La;39;24;15
16;Cuenca;078;Cuenca;55102;26341;28761
16;Cuenca;079;Cueva del Hierro;32;22;10
16;Cuenca;082;Enguídanos;337;181;156
16;Cuenca;083;Fresneda de Altarejos;52;26;26
16;Cuenca;084;Fresneda de la Sierra;53;29;24
16;Cuenca;085;Frontera, La;158;81;77
16;Cuenca;086;Fuente de Pedro Naharro;1258;646;612
16;Cuenca;087;Fuentelespino de Haro;258;134;124
16;Cuenca;088;Fuentelespino de Moya;118;62;56
16;Cuenca;904;Fuentenava de Jábaga;561;300;261
16;Cuenca;089;Fuentes;453;239;214
16;Cuenca;091;Fuertescusa;74;39;35
16;Cuenca;092;Gabaldón;189;110;79
16;Cuenca;093;Garaballa;72;38;34
16;Cuenca;094;Gascueña;177;98;79
16;Cuenca;095;Graja de Campalbo;93;50;43
16;Cuenca;096;Graja de Iniesta;363;194;169
16;Cuenca;097;Henarejos;159;79;80
16;Cuenca;098;Herrumblar, El;708;363;345
16;Cuenca;099;Hinojosa, La;211;107;104
16;Cuenca;100;Hinojosos, Los;856;420;436
16;Cuenca;101;Hito, El;163;88;75
16;Cuenca;102;Honrubia;1623;812;811
16;Cuenca;103;Hontanaya;297;160;137
16;Cuenca;104;Hontecillas;52;28;24
16;Cuenca;106;Horcajo de Santiago;3597;1836;1761
16;Cuenca;107;Huélamo;105;62;43
16;Cuenca;108;Huelves;57;29;28
16;Cuenca;109;Huérguina;56;30;26
16;Cuenca;110;Huerta de la Obispalía;128;76;52
16;Cuenca;111;Huerta del Marquesado;211;124;87
16;Cuenca;112;Huete;1817;930;887
16;Cuenca;113;Iniesta;4330;2122;2208
16;Cuenca;115;Laguna del Marquesado;43;24;19
16;Cuenca;116;Lagunaseca;80;45;35
16;Cuenca;117;Landete;1271;642;629
16;Cuenca;118;Ledaña;1664;818;846
16;Cuenca;119;Leganiel;186;98;88
16;Cuenca;121;Majadas, Las;277;142;135
16;Cuenca;122;Mariana;288;147;141
16;Cuenca;123;Masegosa;78;46;32
16;Cuenca;124;Mesas, Las;2326;1197;1129
16;Cuenca;125;Minglanilla;2263;1157;1106
16;Cuenca;126;Mira;972;488;484
16;Cuenca;128;Monreal del Llano;69;36;33
16;Cuenca;129;Montalbanejo;109;60;49
16;Cuenca;130;Montalbo;671;360;311
16;Cuenca;131;Monteagudo de las Salinas;133;75;58
16;Cuenca;132;Mota de Altarejos;35;22;13
16;Cuenca;133;Mota del Cuervo;6045;3010;3035
16;Cuenca;134;Motilla del Palancar;5902;2945;2957
16;Cuenca;135;Moya;163;92;71
16;Cuenca;137;Narboneta;58;29;29
16;Cuenca;139;Olivares de Júcar;349;185;164
16;Cuenca;140;Olmeda de la Cuesta;34;19;15
16;Cuenca;141;Olmeda del Rey;138;68;70
16;Cuenca;142;Olmedilla de Alarcón;164;95;69
16;Cuenca;143;Olmedilla de Eliz;16;11;5
16;Cuenca;145;Osa de la Vega;522;274;248
16;Cuenca;146;Pajarón;84;41;43
16;Cuenca;147;Pajaroncillo;74;43;31
16;Cuenca;148;Palomares del Campo;654;333;321
16;Cuenca;149;Palomera;167;86;81
16;Cuenca;150;Paracuellos;100;49;51
16;Cuenca;151;Paredes;65;36;29
16;Cuenca;152;Parra de las Vegas, La;45;26;19
16;Cuenca;153;Pedernoso, El;1176;597;579
16;Cuenca;154;Pedroñeras, Las;6716;3436;3280
16;Cuenca;155;Peral, El;634;349;285
16;Cuenca;156;Peraleja, La;104;57;47
16;Cuenca;157;Pesquera, La;236;130;106
16;Cuenca;158;Picazo, El;688;346;342
16;Cuenca;159;Pinarejo;238;122;116
16;Cuenca;160;Pineda de Gigüela;61;32;29
16;Cuenca;161;Piqueras del Castillo;61;31;30
16;Cuenca;162;Portalrubio de Guadamejud;28;13;15
16;Cuenca;163;Portilla;74;39;35
16;Cuenca;165;Poyatos;63;32;31
16;Cuenca;166;Pozoamargo;316;168;148
16;Cuenca;908;Pozorrubielos de la Mancha;204;97;107
16;Cuenca;167;Pozorrubio de Santiago;341;163;178
16;Cuenca;169;Pozuelo, El;57;35;22
16;Cuenca;170;Priego;973;489;484
16;Cuenca;171;Provencio, El;2505;1236;1269
16;Cuenca;172;Puebla de Almenara;373;195;178
16;Cuenca;174;Puebla del Salvador;204;112;92
16;Cuenca;175;Quintanar del Rey;7447;3857;3590
16;Cuenca;176;Rada de Haro;47;22;25
16;Cuenca;177;Reíllo;95;53;42
16;Cuenca;181;Rozalén del Monte;71;33;38
16;Cuenca;185;Saceda-Trasierra;45;32;13
16;Cuenca;186;Saelices;547;281;266
16;Cuenca;187;Salinas del Manzano;90;49;41
16;Cuenca;188;Salmeroncillos;117;67;50
16;Cuenca;189;Salvacañete;313;164;149
16;Cuenca;190;San Clemente;7220;3687;3533
16;Cuenca;191;San Lorenzo de la Parrilla;1105;546;559
16;Cuenca;192;San Martín de Boniches;51;27;24
16;Cuenca;193;San Pedro Palmiches;65;38;27
16;Cuenca;194;Santa Cruz de Moya;248;130;118
16;Cuenca;196;Santa María de los Llanos;719;374;345
16;Cuenca;195;Santa María del Campo Rus;625;311;314
16;Cuenca;197;Santa María del Val;61;35;26
16;Cuenca;198;Sisante;1698;854;844
16;Cuenca;199;Solera de Gabaldón;28;12;16
16;Cuenca;909;Sotorribas;791;400;391
16;Cuenca;202;Talayuelas;910;483;427
16;Cuenca;203;Tarancón;14750;7326;7424
16;Cuenca;204;Tébar;306;162;144
16;Cuenca;205;Tejadillos;131;65;66
16;Cuenca;206;Tinajas;207;106;101
16;Cuenca;209;Torralba;121;71;50
16;Cuenca;211;Torrejoncillo del Rey;412;210;202
16;Cuenca;212;Torrubia del Campo;275;135;140
16;Cuenca;213;Torrubia del Castillo;38;24;14
16;Cuenca;215;Tragacete;267;148;119
16;Cuenca;216;Tresjuncos;332;178;154
16;Cuenca;217;Tribaldos;91;47;44
16;Cuenca;218;Uclés;225;117;108
16;Cuenca;219;Uña;97;47;50
16;Cuenca;906;Valdecolmenas, Los;82;50;32
16;Cuenca;224;Valdemeca;91;49;42
16;Cuenca;225;Valdemorillo de la Sierra;77;47;30
16;Cuenca;227;Valdemoro-Sierra;120;71;49
16;Cuenca;228;Valdeolivas;199;121;78
16;Cuenca;902;Valdetórtola;142;79;63
16;Cuenca;903;Valeras, Las;1590;835;755
16;Cuenca;231;Valhermoso de la Fuente;49;26;23
16;Cuenca;173;Valle de Altomira, El;232;128;104
16;Cuenca;234;Valsalobre;29;16;13
16;Cuenca;236;Valverde de Júcar;1173;588;585
16;Cuenca;237;Valverdejo;97;54;43
16;Cuenca;238;Vara de Rey;556;292;264
16;Cuenca;239;Vega del Codorno;151;91;60
16;Cuenca;240;Vellisca;108;58;50
16;Cuenca;242;Villaconejos de Trabaque;366;182;184
16;Cuenca;243;Villaescusa de Haro;508;254;254
16;Cuenca;244;Villagarcía del Llano;774;393;381
16;Cuenca;245;Villalba de la Sierra;505;243;262
16;Cuenca;246;Villalba del Rey;560;306;254
16;Cuenca;247;Villalgordo del Marquesado;87;47;40
16;Cuenca;248;Villalpardo;972;481;491
16;Cuenca;249;Villamayor de Santiago;2628;1334;1294
16;Cuenca;250;Villanueva de Guadamejud;75;46;29
16;Cuenca;251;Villanueva de la Jara;2269;1131;1138
16;Cuenca;253;Villar de Cañas;426;222;204
16;Cuenca;254;Villar de Domingo García;230;125;105
16;Cuenca;255;Villar de la Encina;164;88;76
16;Cuenca;263;Villar de Olalla;1234;665;569
16;Cuenca;258;Villar del Humo;218;126;92
16;Cuenca;259;Villar del Infantado;39;25;14
16;Cuenca;910;Villar y Velasco;92;51;41
16;Cuenca;264;Villarejo de Fuentes;485;249;236
16;Cuenca;265;Villarejo de la Peñuela;19;6;13
16;Cuenca;266;Villarejo-Periesteban;370;186;184
16;Cuenca;269;Villares del Saz;503;246;257
16;Cuenca;270;Villarrubio;202;109;93
16;Cuenca;271;Villarta;858;427;431
16;Cuenca;272;Villas de la Ventosa;249;142;107
16;Cuenca;273;Villaverde y Pasaconsol;351;188;163
16;Cuenca;274;Víllora;138;71;67
16;Cuenca;275;Vindel;11;6;5
16;Cuenca;276;Yémeda;22;16;6
16;Cuenca;277;Zafra de Záncara;133;73;60
16;Cuenca;278;Zafrilla;67;34;33
16;Cuenca;279;Zarza de Tajo;261;147;114
16;Cuenca;280;Zarzuela;204;109;95
20;Gipuzkoa;001;Abaltzisketa;324;177;147
20;Gipuzkoa;002;Aduna;470;257;213
20;Gipuzkoa;016;Aia;2046;1094;952
20;Gipuzkoa;003;Aizarnazabal;775;393;382
20;Gipuzkoa;004;Albiztur;330;174;156
20;Gipuzkoa;005;Alegia;1730;882;848
20;Gipuzkoa;006;Alkiza;358;180;178
20;Gipuzkoa;906;Altzaga;171;84;87
20;Gipuzkoa;007;Altzo;413;213;200
20;Gipuzkoa;008;Amezketa;938;507;431
20;Gipuzkoa;009;Andoain;14613;7240;7373
20;Gipuzkoa;010;Anoeta;1997;1040;957
20;Gipuzkoa;011;Antzuola;2176;1099;1077
20;Gipuzkoa;012;Arama;206;106;100
20;Gipuzkoa;013;Aretxabaleta;6993;3513;3480
20;Gipuzkoa;055;Arrasate/Mondragón;21987;10864;11123
20;Gipuzkoa;014;Asteasu;1505;783;722
20;Gipuzkoa;903;Astigarraga;5880;3007;2873
20;Gipuzkoa;015;Ataun;1701;891;810
20;Gipuzkoa;017;Azkoitia;11587;5780;5807
20;Gipuzkoa;018;Azpeitia;14666;7357;7309
20;Gipuzkoa;904;Baliarrain;145;80;65
20;Gipuzkoa;019;Beasain;13949;7037;6912
20;Gipuzkoa;020;Beizama;166;103;63
20;Gipuzkoa;021;Belauntza;241;127;114
20;Gipuzkoa;022;Berastegi;1078;561;517
20;Gipuzkoa;074;Bergara;14743;7308;7435
20;Gipuzkoa;023;Berrobi;575;303;272
20;Gipuzkoa;024;Bidania-Goiatz;515;278;237
20;Gipuzkoa;029;Deba;5480;2745;2735
20;Gipuzkoa;069;Donostia/San Sebastián;186064;87553;98511
20;Gipuzkoa;030;Eibar;27380;13262;14118
20;Gipuzkoa;031;Elduain;242;124;118
20;Gipuzkoa;033;Elgeta;1113;566;547
20;Gipuzkoa;032;Elgoibar;11594;5788;5806
20;Gipuzkoa;067;Errenteria;39381;19133;20248
20;Gipuzkoa;066;Errezil;599;317;282
20;Gipuzkoa;034;Eskoriatza;4080;2062;2018
20;Gipuzkoa;035;Ezkio-Itsaso;613;317;296
20;Gipuzkoa;038;Gabiria;487;258;229
20;Gipuzkoa;037;Gaintza;121;71;50
20;Gipuzkoa;907;Gaztelu;160;92;68
20;Gipuzkoa;039;Getaria;2818;1431;1387
20;Gipuzkoa;040;Hernani;19712;9623;10089
20;Gipuzkoa;041;Hernialde;321;164;157
20;Gipuzkoa;036;Hondarribia;16950;8439;8511
20;Gipuzkoa;042;Ibarra;4237;2108;2129
20;Gipuzkoa;043;Idiazabal;2304;1153;1151
20;Gipuzkoa;044;Ikaztegieta;487;250;237
20;Gipuzkoa;045;Irun;61608;30109;31499
20;Gipuzkoa;046;Irura;1785;930;855
20;Gipuzkoa;047;Itsasondo;658;328;330
20;Gipuzkoa;048;Larraul;245;135;110
20;Gipuzkoa;902;Lasarte-Oria;18152;8861;9291
20;Gipuzkoa;049;Lazkao;5539;2795;2744
20;Gipuzkoa;050;Leaburu;364;190;174
20;Gipuzkoa;051;Legazpi;8485;4321;4164
20;Gipuzkoa;052;Legorreta;1443;722;721
20;Gipuzkoa;068;Leintz-Gatzaga;235;127;108
20;Gipuzkoa;053;Lezo;5960;2956;3004
20;Gipuzkoa;054;Lizartza;602;316;286
20;Gipuzkoa;901;Mendaro;2031;1032;999
20;Gipuzkoa;057;Mutiloa;256;140;116
20;Gipuzkoa;056;Mutriku;5329;2682;2647
20;Gipuzkoa;063;Oiartzun;10175;5018;5157
20;Gipuzkoa;058;Olaberria;941;481;460
20;Gipuzkoa;059;Oñati;11348;5618;5730
20;Gipuzkoa;076;Ordizia;9875;4921;4954
20;Gipuzkoa;905;Orendain;200;105;95
20;Gipuzkoa;060;Orexa;125;67;58
20;Gipuzkoa;061;Orio;5851;2948;2903
20;Gipuzkoa;062;Ormaiztegi;1316;665;651
20;Gipuzkoa;064;Pasaia;16207;7809;8398
20;Gipuzkoa;070;Segura;1472;752;720
20;Gipuzkoa;065;Soraluze-Placencia de las Armas;3944;1988;1956
20;Gipuzkoa;071;Tolosa;19175;9241;9934
20;Gipuzkoa;072;Urnieta;6247;3128;3119
20;Gipuzkoa;077;Urretxu;6805;3384;3421
20;Gipuzkoa;073;Usurbil;6197;3139;3058
20;Gipuzkoa;075;Villabona;5891;2965;2926
20;Gipuzkoa;078;Zaldibia;1575;824;751
20;Gipuzkoa;079;Zarautz;23117;11296;11821
20;Gipuzkoa;025;Zegama;1514;783;731
20;Gipuzkoa;026;Zerain;255;117;138
20;Gipuzkoa;027;Zestoa;3734;1966;1768
20;Gipuzkoa;028;Zizurkil;2997;1499;1498
20;Gipuzkoa;081;Zumaia;9840;4873;4967
20;Gipuzkoa;080;Zumarraga;9918;4873;5045
17;Girona;001;Agullana;841;419;422
17;Girona;002;Aiguaviva;763;391;372
17;Girona;003;Albanyà;147;82;65
17;Girona;004;Albons;765;387;378
17;Girona;006;Alp;1536;800;736
17;Girona;007;Amer;2260;1107;1153
17;Girona;008;Anglès;5473;2709;2764
17;Girona;009;Arbúcies;6380;3298;3082
17;Girona;010;Argelaguer;415;218;197
17;Girona;011;Armentera, L';935;471;464
17;Girona;012;Avinyonet de Puigventós;1587;803;784
17;Girona;015;Banyoles;19239;9608;9631
17;Girona;016;Bàscara;980;514;466
17;Girona;013;Begur;3957;2000;1957
17;Girona;018;Bellcaire d'Empordà;647;317;330
17;Girona;019;Besalú;2438;1146;1292
17;Girona;020;Bescanó;4854;2432;2422
17;Girona;021;Beuda;199;112;87
17;Girona;022;Bisbal d'Empordà, La;10742;5346;5396
17;Girona;234;Biure;233;122;111
17;Girona;023;Blanes;39060;19491;19569
17;Girona;029;Boadella i les Escaules;266;138;128
17;Girona;024;Bolvir;375;198;177
17;Girona;025;Bordils;1680;836;844
17;Girona;026;Borrassà;711;369;342
17;Girona;027;Breda;3722;1849;1873
17;Girona;028;Brunyola;375;196;179
17;Girona;031;Cabanelles;257;146;111
17;Girona;030;Cabanes;915;494;421
17;Girona;032;Cadaqués;2837;1379;1458
17;Girona;033;Caldes de Malavella;7220;3611;3609
17;Girona;034;Calonge;10709;5368;5341
17;Girona;035;Camós;683;340;343
17;Girona;036;Campdevànol;3314;1630;1684
17;Girona;037;Campelles;137;70;67
17;Girona;038;Campllong;516;258;258
17;Girona;039;Camprodon;2221;1097;1124
17;Girona;040;Canet d'Adri;702;353;349
17;Girona;041;Cantallops;317;160;157
17;Girona;042;Capmany;596;306;290
17;Girona;044;Cassà de la Selva;10025;5101;4924
17;Girona;046;Castellfollit de la Roca;970;494;476
17;Girona;047;Castelló d'Empúries;10784;5441;5343
17;Girona;048;Castell-Platja d'Aro;10567;5215;5352
17;Girona;189;Cellera de Ter, La;2054;1023;1031
17;Girona;049;Celrà;5303;2665;2638
17;Girona;050;Cervià de Ter;916;462;454
17;Girona;051;Cistella;293;140;153
17;Girona;054;Colera;522;262;260
17;Girona;055;Colomers;188;94;94
17;Girona;057;Corçà;1249;631;618
17;Girona;056;Cornellà del Terri;2279;1171;1108
17;Girona;058;Crespià;267;136;131
17;Girona;901;Cruïlles, Monells i Sant Sadurní de l'Heura;1292;653;639
17;Girona;060;Darnius;550;279;271
17;Girona;061;Das;215;117;98
17;Girona;062;Escala, L';10400;5291;5109
17;Girona;063;Espinelves;201;93;108
17;Girona;064;Espolla;421;209;212
17;Girona;065;Esponellà;456;226;230
17;Girona;005;Far d'Empordà, El;553;277;276
17;Girona;066;Figueres;45726;22652;23074
17;Girona;067;Flaçà;1018;491;527
17;Girona;068;Foixà;309;159;150
17;Girona;069;Fontanals de Cerdanya;446;232;214
17;Girona;070;Fontanilles;140;77;63
17;Girona;071;Fontcoberta;1471;729;742
17;Girona;902;Forallac;1723;859;864
17;Girona;073;Fornells de la Selva;2547;1267;1280
17;Girona;074;Fortià;721;346;375
17;Girona;075;Garrigàs;435;228;207
17;Girona;076;Garrigoles;163;89;74
17;Girona;077;Garriguella;854;428;426
17;Girona;078;Ger;436;230;206
17;Girona;079;Girona;98255;47149;51106
17;Girona;080;Gombrèn;184;93;91
17;Girona;081;Gualta;376;201;175
17;Girona;082;Guils de Cerdanya;531;281;250
17;Girona;083;Hostalric;4058;2051;2007
17;Girona;084;Isòvol;276;153;123
17;Girona;085;Jafre;386;207;179
17;Girona;086;Jonquera, La;3231;1632;1599
17;Girona;087;Juià;327;170;157
17;Girona;088;Lladó;752;373;379
17;Girona;089;Llagostera;8266;4228;4038
17;Girona;090;Llambilles;723;366;357
17;Girona;091;Llanars;514;270;244
17;Girona;092;Llançà;4934;2453;2481
17;Girona;093;Llers;1210;605;605
17;Girona;094;Llívia;1467;792;675
17;Girona;095;Lloret de Mar;37042;18952;18090
17;Girona;096;Llosses, Les;213;119;94
17;Girona;102;Maçanet de Cabrenys;740;375;365
17;Girona;103;Maçanet de la Selva;6819;3507;3312
17;Girona;097;Madremanya;280;141;139
17;Girona;098;Maià de Montcal;433;228;205
17;Girona;100;Masarac;289;151;138
17;Girona;101;Massanes;742;400;342
17;Girona;099;Meranges;99;59;40
17;Girona;105;Mieres;317;161;156
17;Girona;106;Mollet de Peralada;180;98;82
17;Girona;107;Molló;335;163;172
17;Girona;109;Montagut i Oix;929;485;444
17;Girona;110;Mont-ras;1690;853;837
17;Girona;111;Navata;1329;652;677
17;Girona;112;Ogassa;225;132;93
17;Girona;114;Olot;34000;16892;17108
17;Girona;115;Ordis;377;200;177
17;Girona;116;Osor;434;221;213
17;Girona;117;Palafrugell;22868;11342;11526
17;Girona;118;Palamós;17677;8633;9044
17;Girona;119;Palau de Santa Eulàlia;90;54;36
17;Girona;121;Palau-sator;297;156;141
17;Girona;120;Palau-saverdera;1471;732;739
17;Girona;123;Palol de Revardit;470;236;234
17;Girona;124;Pals;2423;1227;1196
17;Girona;125;Pardines;158;85;73
17;Girona;126;Parlavà;392;208;184
17;Girona;128;Pau;551;280;271
17;Girona;129;Pedret i Marzà;180;98;82
17;Girona;130;Pera, La;441;208;233
17;Girona;132;Peralada;1835;916;919
17;Girona;133;Planes d'Hostoles, Les;1662;834;828
17;Girona;134;Planoles;299;163;136
17;Girona;135;Pont de Molins;517;255;262
17;Girona;136;Pontós;234;131;103
17;Girona;137;Porqueres;4530;2238;2292
17;Girona;140;Port de la Selva, El;994;522;472
17;Girona;138;Portbou;1170;576;594
17;Girona;139;Preses, Les;1781;889;892
17;Girona;141;Puigcerdà;8810;4407;4403
17;Girona;142;Quart;3478;1744;1734
17;Girona;043;Queralbs;174;99;75
17;Girona;143;Rabós;188;92;96
17;Girona;144;Regencós;279;143;136
17;Girona;145;Ribes de Freser;1785;882;903
17;Girona;146;Riells i Viabrea;3927;2023;1904
17;Girona;147;Ripoll;10583;5194;5389
17;Girona;148;Riudarenes;2120;1090;1030
17;Girona;149;Riudaura;466;222;244
17;Girona;150;Riudellots de la Selva;2024;1023;1001
17;Girona;151;Riumors;255;128;127
17;Girona;152;Roses;19438;9722;9716
17;Girona;153;Rupià;253;129;124
17;Girona;154;Sales de Llierca;137;71;66
17;Girona;155;Salt;29404;15438;13966
17;Girona;157;Sant Andreu Salou;155;82;73
17;Girona;183;Sant Aniol de Finestres;371;197;174
17;Girona;158;Sant Climent Sescebes;641;375;266
17;Girona;159;Sant Feliu de Buixalleu;799;417;382
17;Girona;160;Sant Feliu de Guíxols;21760;10763;10997
17;Girona;161;Sant Feliu de Pallerols;1317;645;672
17;Girona;162;Sant Ferriol;231;131;100
17;Girona;163;Sant Gregori;3553;1787;1766
17;Girona;164;Sant Hilari Sacalm;5570;2811;2759
17;Girona;165;Sant Jaume de Llierca;873;424;449
17;Girona;167;Sant Joan de les Abadesses;3342;1660;1682
17;Girona;168;Sant Joan de Mollet;495;237;258
17;Girona;185;Sant Joan les Fonts;2906;1454;1452
17;Girona;166;Sant Jordi Desvalls;700;347;353
17;Girona;169;Sant Julià de Ramis;3455;1747;1708
17;Girona;903;Sant Julià del Llor i Bonmatí;1282;663;619
17;Girona;171;Sant Llorenç de la Muga;247;126;121
17;Girona;172;Sant Martí de Llémena;618;324;294
17;Girona;173;Sant Martí Vell;250;128;122
17;Girona;174;Sant Miquel de Campmajor;226;119;107
17;Girona;175;Sant Miquel de Fluvià;742;387;355
17;Girona;176;Sant Mori;176;98;78
17;Girona;177;Sant Pau de Segúries;670;327;343
17;Girona;178;Sant Pere Pescador;2134;1153;981
17;Girona;180;Santa Coloma de Farners;12583;6361;6222
17;Girona;181;Santa Cristina d'Aro;5128;2571;2557
17;Girona;182;Santa Llogaia d'Àlguema;343;179;164
17;Girona;184;Santa Pau;1524;769;755
17;Girona;186;Sarrià de Ter;5035;2498;2537
17;Girona;187;Saus, Camallera i Llampaies;842;419;423
17;Girona;188;Selva de Mar, La;188;106;82
17;Girona;190;Serinyà;1132;580;552
17;Girona;191;Serra de Daró;209;116;93
17;Girona;192;Setcases;181;98;83
17;Girona;193;Sils;5910;3000;2910
17;Girona;052;Siurana;155;72;83
17;Girona;194;Susqueda;95;57;38
17;Girona;195;Tallada d'Empordà, La;451;233;218
17;Girona;196;Terrades;285;140;145
17;Girona;197;Torrent;163;91;72
17;Girona;198;Torroella de Fluvià;711;379;332
17;Girona;199;Torroella de Montgrí;11506;5823;5683
17;Girona;200;Tortellà;781;383;398
17;Girona;201;Toses;166;100;66
17;Girona;202;Tossa de Mar;5498;2788;2710
17;Girona;204;Ullà;1077;597;480
17;Girona;205;Ullastret;288;144;144
17;Girona;203;Ultramort;210;118;92
17;Girona;206;Urús;181;84;97
17;Girona;014;Vajol, La;83;48;35
17;Girona;208;Vall de Bianya, La;1266;635;631
17;Girona;207;Vall d'en Bas, La;2983;1505;1478
17;Girona;170;Vallfogona de Ripollès;200;111;89
17;Girona;209;Vall-llobrega;922;457;465
17;Girona;210;Ventalló;802;403;399
17;Girona;211;Verges;1150;559;591
17;Girona;212;Vidrà;176;91;85
17;Girona;213;Vidreres;7632;3949;3683
17;Girona;214;Vilabertran;919;467;452
17;Girona;215;Vilablareix;2636;1302;1334
17;Girona;217;Viladamat;466;238;228
17;Girona;216;Viladasens;224;114;110
17;Girona;218;Vilademuls;808;426;382
17;Girona;220;Viladrau;1030;518;512
17;Girona;221;Vilafant;5466;2689;2777
17;Girona;223;Vilajuïga;1155;570;585
17;Girona;224;Vilallonga de Ter;400;204;196
17;Girona;225;Vilamacolum;320;163;157
17;Girona;226;Vilamalla;1121;567;554
17;Girona;227;Vilamaniscle;202;109;93
17;Girona;228;Vilanant;405;206;199
17;Girona;230;Vila-sacra;713;341;372
17;Girona;222;Vilaür;156;79;77
17;Girona;233;Vilobí d'Onyar;3163;1635;1528
17;Girona;232;Vilopriu;201;108;93
18;Granada;001;Agrón;297;149;148
18;Granada;002;Alamedilla;611;314;297
18;Granada;003;Albolote;18497;9219;9278
18;Granada;004;Albondón;762;419;343
18;Granada;005;Albuñán;421;221;200
18;Granada;006;Albuñol;6971;3698;3273
18;Granada;007;Albuñuelas;876;442;434
18;Granada;010;Aldeire;639;343;296
18;Granada;011;Alfacar;5429;2779;2650
18;Granada;012;Algarinejo;2734;1405;1329
18;Granada;013;Alhama de Granada;6044;3238;2806
18;Granada;014;Alhendín;8740;4417;4323
18;Granada;015;Alicún de Ortega;511;261;250
18;Granada;016;Almegíjar;377;208;169
18;Granada;017;Almuñécar;27397;13589;13808
18;Granada;904;Alpujarra de la Sierra;1038;566;472
18;Granada;018;Alquife;703;351;352
18;Granada;020;Arenas del Rey;1231;627;604
18;Granada;021;Armilla;23901;12016;11885
18;Granada;022;Atarfe;18092;9011;9081
18;Granada;023;Baza;20656;10284;10372
18;Granada;024;Beas de Granada;1004;542;462
18;Granada;025;Beas de Guadix;354;177;177
18;Granada;027;Benalúa;3277;1631;1646
18;Granada;028;Benalúa de las Villas;1107;581;526
18;Granada;029;Benamaurel;2359;1203;1156
18;Granada;030;Bérchules;727;387;340
18;Granada;032;Bubión;294;148;146
18;Granada;033;Busquístar;276;146;130
18;Granada;034;Cacín;594;299;295
18;Granada;035;Cádiar;1528;803;725
18;Granada;036;Cájar;5025;2420;2605
18;Granada;114;Calahorra, La;700;350;350
18;Granada;037;Calicasas;619;308;311
18;Granada;038;Campotéjar;1286;665;621
18;Granada;039;Caniles;4279;2185;2094
18;Granada;040;Cáñar;379;205;174
18;Granada;042;Capileira;520;258;262
18;Granada;043;Carataunas;178;97;81
18;Granada;044;Cástaras;244;148;96
18;Granada;045;Castilléjar;1389;731;658
18;Granada;046;Castril;2236;1140;1096
18;Granada;047;Cenes de la Vega;7866;3968;3898
18;Granada;059;Chauchina;5421;2694;2727
18;Granada;061;Chimeneas;1355;714;641
18;Granada;062;Churriana de la Vega;14215;7048;7167
18;Granada;048;Cijuela;3201;1620;1581
18;Granada;049;Cogollos de Guadix;674;372;302
18;Granada;050;Cogollos de la Vega;2096;1042;1054
18;Granada;051;Colomera;1395;730;665
18;Granada;053;Cortes de Baza;1993;1001;992
18;Granada;054;Cortes y Graena;1020;524;496
18;Granada;912;Cuevas del Campo;1873;942;931
18;Granada;056;Cúllar;4296;2157;2139
18;Granada;057;Cúllar Vega;7198;3637;3561
18;Granada;063;Darro;1557;786;771
18;Granada;064;Dehesas de Guadix;426;218;208
18;Granada;065;Dehesas Viejas;727;374;353
18;Granada;066;Deifontes;2622;1317;1305
18;Granada;067;Diezma;785;403;382
18;Granada;068;Dílar;1910;960;950
18;Granada;069;Dólar;631;335;296
18;Granada;915;Domingo Pérez de Granada;907;475;432
18;Granada;070;Dúdar;347;187;160
18;Granada;071;Dúrcal;7050;3483;3567
18;Granada;072;Escúzar;787;403;384
18;Granada;074;Ferreira;303;155;148
18;Granada;076;Fonelas;1016;534;482
18;Granada;078;Freila;894;459;435
18;Granada;079;Fuente Vaqueros;4395;2209;2186
18;Granada;905;Gabias, Las;20012;10235;9777
18;Granada;082;Galera;1133;565;568
18;Granada;083;Gobernador;262;120;142
18;Granada;084;Gójar;5539;2823;2716
18;Granada;085;Gor;767;391;376
18;Granada;086;Gorafe;405;209;196
18;Granada;087;Granada;234758;108889;125869
18;Granada;088;Guadahortuna;1957;1001;956
18;Granada;089;Guadix;18796;9282;9514
18;Granada;906;Guájares, Los;1052;563;489
18;Granada;093;Gualchos;4943;2511;2432
18;Granada;094;Güéjar Sierra;2909;1545;1364
18;Granada;095;Güevéjar;2540;1344;1196
18;Granada;096;Huélago;406;209;197
18;Granada;097;Huéneja;1156;607;549
18;Granada;098;Huéscar;7609;3759;3850
18;Granada;099;Huétor de Santillán;1901;968;933
18;Granada;100;Huétor Tájar;10162;5119;5043
18;Granada;101;Huétor Vega;11777;5917;5860
18;Granada;102;Illora;10286;5144;5142
18;Granada;103;Ítrabo;1010;512;498
18;Granada;105;Iznalloz;5045;2574;2471
18;Granada;106;Játar;646;359;287
18;Granada;107;Jayena;1119;569;550
18;Granada;108;Jerez del Marquesado;1009;530;479
18;Granada;109;Jete;904;463;441
18;Granada;111;Jun;3692;1862;1830
18;Granada;112;Juviles;148;72;76
18;Granada;115;Láchar;3303;1701;1602
18;Granada;116;Lanjarón;3587;1788;1799
18;Granada;117;Lanteira;552;284;268
18;Granada;119;Lecrín;2098;1062;1036
18;Granada;120;Lentegí;338;180;158
18;Granada;121;Lobras;159;83;76
18;Granada;122;Loja;20641;10308;10333
18;Granada;123;Lugros;327;178;149
18;Granada;124;Lújar;487;264;223
18;Granada;126;Malahá, La;1821;907;914
18;Granada;127;Maracena;22059;10877;11182
18;Granada;128;Marchal;424;200;224
18;Granada;132;Moclín;3884;1930;1954
18;Granada;133;Molvízar;2881;1470;1411
18;Granada;134;Monachil;7681;3952;3729
18;Granada;135;Montefrío;5601;2814;2787
18;Granada;136;Montejícar;2204;1127;1077
18;Granada;137;Montillana;1272;669;603
18;Granada;138;Moraleda de Zafayona;3187;1619;1568
18;Granada;909;Morelábor;660;359;301
18;Granada;140;Motril;60368;29699;30669
18;Granada;141;Murtas;495;282;213
18;Granada;903;Nevada;1106;564;542
18;Granada;143;Nigüelas;1218;620;598
18;Granada;144;Nívar;930;474;456
18;Granada;145;Ogíjares;13718;6773;6945
18;Granada;146;Orce;1220;630;590
18;Granada;147;Órgiva;5543;2787;2756
18;Granada;148;Otívar;1082;540;542
18;Granada;150;Padul;8442;4267;4175
18;Granada;151;Pampaneira;318;160;158
18;Granada;152;Pedro Martínez;1150;562;588
18;Granada;153;Peligros;11242;5578;5664
18;Granada;154;Peza, La;1241;640;601
18;Granada;910;Pinar, El;962;505;457
18;Granada;157;Pinos Genil;1430;746;684
18;Granada;158;Pinos Puente;10519;5287;5232
18;Granada;159;Píñar;1154;630;524
18;Granada;161;Polícar;234;124;110
18;Granada;162;Polopos;1680;888;792
18;Granada;163;Pórtugos;401;208;193
18;Granada;164;Puebla de Don Fadrique;2306;1188;1118
18;Granada;165;Pulianas;5339;2656;2683
18;Granada;167;Purullena;2356;1187;1169
18;Granada;168;Quéntar;954;489;465
18;Granada;170;Rubite;377;216;161
18;Granada;171;Salar;2698;1364;1334
18;Granada;173;Salobreña;12399;6186;6213
18;Granada;174;Santa Cruz del Comercio;544;283;261
18;Granada;175;Santa Fe;15079;7450;7629
18;Granada;176;Soportújar;277;153;124
18;Granada;177;Sorvilán;555;288;267
18;Granada;901;Taha, La;655;338;317
18;Granada;178;Torre-Cardela;813;419;394
18;Granada;179;Torvizcón;682;359;323
18;Granada;180;Trevélez;776;403;373
18;Granada;181;Turón;254;151;103
18;Granada;182;Ugíjar;2512;1237;1275
18;Granada;914;Valderrubio;2094;1034;1060
18;Granada;907;Valle del Zalabí;2163;1107;1056
18;Granada;902;Valle, El;964;479;485
18;Granada;183;Válor;671;344;327
18;Granada;911;Vegas del Genil;10518;5358;5160
18;Granada;184;Vélez de Benaudalla;2875;1445;1430
18;Granada;185;Ventas de Huelma;640;345;295
18;Granada;149;Villa de Otura;6835;3468;3367
18;Granada;908;Villamena;989;493;496
18;Granada;187;Villanueva de las Torres;650;343;307
18;Granada;188;Villanueva Mesía;2030;1004;1026
18;Granada;189;Víznar;995;513;482
18;Granada;192;Zafarraya;2063;1104;959
18;Granada;913;Zagra;882;449;433
18;Granada;193;Zubia, La;18945;9317;9628
18;Granada;194;Zújar;2678;1372;1306
19;Guadalajara;001;Abánades;59;34;25
19;Guadalajara;002;Ablanque;73;43;30
19;Guadalajara;003;Adobes;42;23;19
19;Guadalajara;004;Alaminos;67;30;37
19;Guadalajara;005;Alarilla;115;71;44
19;Guadalajara;006;Albalate de Zorita;957;536;421
19;Guadalajara;007;Albares;559;292;267
19;Guadalajara;008;Albendiego;44;28;16
19;Guadalajara;009;Alcocer;337;177;160
19;Guadalajara;010;Alcolea de las Peñas;11;8;3
19;Guadalajara;011;Alcolea del Pinar;336;183;153
19;Guadalajara;013;Alcoroches;138;81;57
19;Guadalajara;015;Aldeanueva de Guadalajara;84;49;35
19;Guadalajara;016;Algar de Mesa;62;43;19
19;Guadalajara;017;Algora;78;48;30
19;Guadalajara;018;Alhóndiga;172;97;75
19;Guadalajara;019;Alique;20;8;12
19;Guadalajara;020;Almadrones;63;39;24
19;Guadalajara;021;Almoguera;1353;711;642
19;Guadalajara;022;Almonacid de Zorita;751;350;401
19;Guadalajara;023;Alocén;176;91;85
19;Guadalajara;024;Alovera;12407;6311;6096
19;Guadalajara;027;Alustante;157;91;66
19;Guadalajara;031;Angón;15;12;3
19;Guadalajara;032;Anguita;186;101;85
19;Guadalajara;033;Anquela del Ducado;64;35;29
19;Guadalajara;034;Anquela del Pedregal;22;17;5
19;Guadalajara;036;Aranzueque;415;214;201
19;Guadalajara;037;Arbancón;160;90;70
19;Guadalajara;038;Arbeteta;27;19;8
19;Guadalajara;039;Argecilla;66;44;22
19;Guadalajara;040;Armallones;51;32;19
19;Guadalajara;041;Armuña de Tajuña;251;131;120
19;Guadalajara;042;Arroyo de las Fraguas;26;16;10
19;Guadalajara;043;Atanzón;83;51;32
19;Guadalajara;044;Atienza;444;249;195
19;Guadalajara;045;Auñón;157;87;70
19;Guadalajara;046;Azuqueca de Henares;34703;17633;17070
19;Guadalajara;047;Baides;63;31;32
19;Guadalajara;048;Baños de Tajo;19;14;5
19;Guadalajara;049;Bañuelos;16;13;3
19;Guadalajara;050;Barriopedro;18;11;7
19;Guadalajara;051;Berninches;58;35;23
19;Guadalajara;052;Bodera, La;26;16;10
19;Guadalajara;053;Brihuega;2476;1300;1176
19;Guadalajara;054;Budia;223;125;98
19;Guadalajara;055;Bujalaro;64;35;29
19;Guadalajara;057;Bustares;85;51;34
19;Guadalajara;058;Cabanillas del Campo;9794;4956;4838
19;Guadalajara;059;Campillo de Dueñas;80;46;34
19;Guadalajara;060;Campillo de Ranas;163;104;59
19;Guadalajara;061;Campisábalos;68;48;20
19;Guadalajara;064;Canredondo;76;42;34
19;Guadalajara;065;Cantalojas;167;105;62
19;Guadalajara;066;Cañizar;63;35;28
19;Guadalajara;067;Cardoso de la Sierra, El;63;41;22
19;Guadalajara;070;Casa de Uceda;96;52;44
19;Guadalajara;071;Casar, El;11601;5935;5666
19;Guadalajara;073;Casas de San Galindo;23;16;7
19;Guadalajara;074;Caspueñas;96;55;41
19;Guadalajara;075;Castejón de Henares;67;40;27
19;Guadalajara;076;Castellar de la Muela;37;17;20
19;Guadalajara;078;Castilforte;59;38;21
19;Guadalajara;079;Castilnuevo;8;5;3
19;Guadalajara;080;Cendejas de Enmedio;75;38;37
19;Guadalajara;081;Cendejas de la Torre;27;16;11
19;Guadalajara;082;Centenera;101;56;45
19;Guadalajara;103;Checa;287;171;116
19;Guadalajara;104;Chequilla;16;9;7
19;Guadalajara;106;Chillarón del Rey;110;64;46
19;Guadalajara;105;Chiloeches;3305;1707;1598
19;Guadalajara;086;Cifuentes;1830;945;885
19;Guadalajara;087;Cincovillas;22;11;11
19;Guadalajara;088;Ciruelas;97;58;39
19;Guadalajara;089;Ciruelos del Pinar;31;18;13
19;Guadalajara;090;Cobeta;118;59;59
19;Guadalajara;091;Cogollor;27;16;11
19;Guadalajara;092;Cogolludo;595;340;255
19;Guadalajara;095;Condemios de Abajo;16;11;5
19;Guadalajara;096;Condemios de Arriba;126;68;58
19;Guadalajara;097;Congostrina;19;14;5
19;Guadalajara;098;Copernal;30;21;9
19;Guadalajara;099;Corduente;364;203;161
19;Guadalajara;102;Cubillo de Uceda, El;135;66;69
19;Guadalajara;107;Driebes;352;187;165
19;Guadalajara;108;Durón;120;61;59
19;Guadalajara;109;Embid;40;22;18
19;Guadalajara;110;Escamilla;67;33;34
19;Guadalajara;111;Escariche;176;107;69
19;Guadalajara;112;Escopete;69;31;38
19;Guadalajara;113;Espinosa de Henares;685;352;333
19;Guadalajara;114;Esplegares;43;28;15
19;Guadalajara;115;Establés;27;19;8
19;Guadalajara;116;Estriégana;17;12;5
19;Guadalajara;117;Fontanar;2328;1226;1102
19;Guadalajara;118;Fuembellida;10;6;4
19;Guadalajara;119;Fuencemillán;100;60;40
19;Guadalajara;120;Fuentelahiguera de Albatages;123;68;55
19;Guadalajara;121;Fuentelencina;303;171;132
19;Guadalajara;122;Fuentelsaz;104;56;48
19;Guadalajara;123;Fuentelviejo;57;29;28
19;Guadalajara;124;Fuentenovilla;533;295;238
19;Guadalajara;125;Gajanejos;45;29;16
19;Guadalajara;126;Galápagos;2395;1269;1126
19;Guadalajara;127;Galve de Sorbe;103;55;48
19;Guadalajara;129;Gascueña de Bornova;35;22;13
19;Guadalajara;130;Guadalajara;83633;40258;43375
19;Guadalajara;132;Henche;97;53;44
19;Guadalajara;133;Heras de Ayuso;231;134;97
19;Guadalajara;134;Herrería;24;15;9
19;Guadalajara;135;Hiendelaencina;121;70;51
19;Guadalajara;136;Hijes;22;13;9
19;Guadalajara;138;Hita;339;187;152
19;Guadalajara;139;Hombrados;36;19;17
19;Guadalajara;142;Hontoba;321;188;133
19;Guadalajara;143;Horche;2540;1299;1241
19;Guadalajara;145;Hortezuela de Océn;50;31;19
19;Guadalajara;146;Huerce, La;43;26;17
19;Guadalajara;147;Huérmeces del Cerro;39;25;14
19;Guadalajara;148;Huertahernando;60;37;23
19;Guadalajara;150;Hueva;149;89;60
19;Guadalajara;151;Humanes;1466;731;735
19;Guadalajara;152;Illana;702;399;303
19;Guadalajara;153;Iniéstola;24;15;9
19;Guadalajara;154;Inviernas, Las;68;46;22
19;Guadalajara;155;Irueste;72;47;25
19;Guadalajara;156;Jadraque;1497;759;738
19;Guadalajara;157;Jirueque;62;39;23
19;Guadalajara;159;Ledanca;110;56;54
19;Guadalajara;160;Loranca de Tajuña;1254;692;562
19;Guadalajara;161;Lupiana;257;127;130
19;Guadalajara;162;Luzaga;69;39;30
19;Guadalajara;163;Luzón;66;34;32
19;Guadalajara;165;Majaelrayo;60;33;27
19;Guadalajara;166;Málaga del Fresno;178;100;78
19;Guadalajara;167;Malaguilla;148;82;66
19;Guadalajara;168;Mandayona;326;168;158
19;Guadalajara;169;Mantiel;42;25;17
19;Guadalajara;170;Maranchón;246;133;113
19;Guadalajara;171;Marchamalo;6969;3513;3456
19;Guadalajara;172;Masegoso de Tajuña;60;34;26
19;Guadalajara;173;Matarrubia;49;33;16
19;Guadalajara;174;Matillas;134;66;68
19;Guadalajara;175;Mazarete;38;18;20
19;Guadalajara;176;Mazuecos;289;149;140
19;Guadalajara;177;Medranda;83;43;40
19;Guadalajara;178;Megina;39;26;13
19;Guadalajara;179;Membrillera;92;49;43
19;Guadalajara;181;Miedes de Atienza;64;36;28
19;Guadalajara;182;Mierla, La;39;27;12
19;Guadalajara;184;Millana;120;69;51
19;Guadalajara;183;Milmarcos;85;50;35
19;Guadalajara;185;Miñosa, La;33;22;11
19;Guadalajara;186;Mirabueno;85;50;35
19;Guadalajara;187;Miralrío;64;38;26
19;Guadalajara;188;Mochales;50;28;22
19;Guadalajara;189;Mohernando;175;97;78
19;Guadalajara;190;Molina de Aragón;3403;1702;1701
19;Guadalajara;191;Monasterio;13;4;9
19;Guadalajara;192;Mondéjar;2599;1336;1263
19;Guadalajara;193;Montarrón;26;14;12
19;Guadalajara;194;Moratilla de los Meleros;111;60;51
19;Guadalajara;195;Morenilla;44;27;17
19;Guadalajara;196;Muduex;112;59;53
19;Guadalajara;197;Navas de Jadraque, Las;28;19;9
19;Guadalajara;198;Negredo;15;8;7
19;Guadalajara;199;Ocentejo;19;14;5
19;Guadalajara;200;Olivar, El;77;46;31
19;Guadalajara;201;Olmeda de Cobeta;71;41;30
19;Guadalajara;202;Olmeda de Jadraque, La;12;7;5
19;Guadalajara;203;Ordial, El;29;17;12
19;Guadalajara;204;Orea;189;113;76
19;Guadalajara;208;Pálmaces de Jadraque;45;26;19
19;Guadalajara;209;Pardos;45;26;19
19;Guadalajara;210;Paredes de Sigüenza;21;12;9
19;Guadalajara;211;Pareja;422;247;175
19;Guadalajara;212;Pastrana;915;465;450
19;Guadalajara;213;Pedregal, El;78;48;30
19;Guadalajara;214;Peñalén;75;42;33
19;Guadalajara;215;Peñalver;178;115;63
19;Guadalajara;216;Peralejos de las Truchas;155;85;70
19;Guadalajara;217;Peralveche;60;41;19
19;Guadalajara;218;Pinilla de Jadraque;53;29;24
19;Guadalajara;219;Pinilla de Molina;16;11;5
19;Guadalajara;220;Pioz;3471;1840;1631
19;Guadalajara;221;Piqueras;65;43;22
19;Guadalajara;222;Pobo de Dueñas, El;126;66;60
19;Guadalajara;223;Poveda de la Sierra;130;68;62
19;Guadalajara;224;Pozo de Almoguera;97;52;45
19;Guadalajara;225;Pozo de Guadalajara;1249;661;588
19;Guadalajara;226;Prádena de Atienza;51;36;15
19;Guadalajara;227;Prados Redondos;70;43;27
19;Guadalajara;228;Puebla de Beleña;47;26;21
19;Guadalajara;229;Puebla de Valles;67;38;29
19;Guadalajara;230;Quer;748;402;346
19;Guadalajara;231;Rebollosa de Jadraque;12;9;3
19;Guadalajara;232;Recuenco, El;73;45;28
19;Guadalajara;233;Renera;97;54;43
19;Guadalajara;234;Retiendas;47;29;18
19;Guadalajara;235;Riba de Saelices;103;57;46
19;Guadalajara;237;Rillo de Gallo;52;29;23
19;Guadalajara;238;Riofrío del Llano;46;27;19
19;Guadalajara;239;Robledillo de Mohernando;115;60;55
19;Guadalajara;240;Robledo de Corpes;51;28;23
19;Guadalajara;241;Romanillos de Atienza;49;30;19
19;Guadalajara;242;Romanones;120;63;57
19;Guadalajara;243;Rueda de la Sierra;50;31;19
19;Guadalajara;244;Sacecorbo;100;56;44
19;Guadalajara;245;Sacedón;1572;835;737
19;Guadalajara;246;Saelices de la Sal;55;30;25
19;Guadalajara;247;Salmerón;171;93;78
19;Guadalajara;248;San Andrés del Congosto;82;49;33
19;Guadalajara;249;San Andrés del Rey;32;16;16
19;Guadalajara;250;Santiuste;20;12;8
19;Guadalajara;251;Saúca;59;30;29
19;Guadalajara;252;Sayatón;86;48;38
19;Guadalajara;254;Selas;61;29;32
19;Guadalajara;901;Semillas;40;24;16
19;Guadalajara;255;Setiles;83;50;33
19;Guadalajara;256;Sienes;54;32;22
19;Guadalajara;257;Sigüenza;4551;2266;2285
19;Guadalajara;258;Solanillos del Extremo;96;55;41
19;Guadalajara;259;Somolinos;33;16;17
19;Guadalajara;260;Sotillo, El;47;26;21
19;Guadalajara;261;Sotodosos;38;19;19
19;Guadalajara;262;Tamajón;131;69;62
19;Guadalajara;263;Taragudo;51;24;27
19;Guadalajara;264;Taravilla;34;22;12
19;Guadalajara;265;Tartanedo;140;80;60
19;Guadalajara;266;Tendilla;331;182;149
19;Guadalajara;267;Terzaga;19;11;8
19;Guadalajara;268;Tierzo;38;25;13
19;Guadalajara;269;Toba, La;108;59;49
19;Guadalajara;271;Tordellego;54;29;25
19;Guadalajara;270;Tordelrábano;20;12;8
19;Guadalajara;272;Tordesilos;102;56;46
19;Guadalajara;274;Torija;1373;711;662
19;Guadalajara;279;Torre del Burgo;281;150;131
19;Guadalajara;277;Torrecuadrada de Molina;21;13;8
19;Guadalajara;278;Torrecuadradilla;29;18;11
19;Guadalajara;280;Torrejón del Rey;5160;2662;2498
19;Guadalajara;281;Torremocha de Jadraque;25;17;8
19;Guadalajara;282;Torremocha del Campo;200;113;87
19;Guadalajara;283;Torremocha del Pinar;37;16;21
19;Guadalajara;284;Torremochuela;10;7;3
19;Guadalajara;285;Torrubia;23;13;10
19;Guadalajara;286;Tórtola de Henares;986;537;449
19;Guadalajara;287;Tortuera;213;112;101
19;Guadalajara;288;Tortuero;18;11;7
19;Guadalajara;289;Traíd;27;18;9
19;Guadalajara;290;Trijueque;1211;631;580
19;Guadalajara;291;Trillo;1392;733;659
19;Guadalajara;293;Uceda;2597;1345;1252
19;Guadalajara;294;Ujados;33;19;14
19;Guadalajara;296;Utande;34;23;11
19;Guadalajara;297;Valdarachas;34;18;16
19;Guadalajara;298;Valdearenas;87;56;31
19;Guadalajara;299;Valdeavellano;106;55;51
19;Guadalajara;300;Valdeaveruelo;1066;551;515
19;Guadalajara;301;Valdeconcha;40;22;18
19;Guadalajara;302;Valdegrudas;65;40;25
19;Guadalajara;303;Valdelcubo;55;33;22
19;Guadalajara;304;Valdenuño Fernández;272;155;117
19;Guadalajara;305;Valdepeñas de la Sierra;182;106;76
19;Guadalajara;306;Valderrebollo;28;15;13
19;Guadalajara;307;Valdesotos;26;16;10
19;Guadalajara;308;Valfermoso de Tajuña;58;38;20
19;Guadalajara;309;Valhermoso;30;16;14
19;Guadalajara;310;Valtablado del Río;9;6;3
19;Guadalajara;311;Valverde de los Arroyos;84;44;40
19;Guadalajara;314;Viana de Jadraque;53;35;18
19;Guadalajara;317;Villanueva de Alcorón;182;96;86
19;Guadalajara;318;Villanueva de Argecilla;29;20;9
19;Guadalajara;319;Villanueva de la Torre;6554;3318;3236
19;Guadalajara;321;Villares de Jadraque;53;34;19
19;Guadalajara;322;Villaseca de Henares;34;18;16
19;Guadalajara;323;Villaseca de Uceda;44;24;20
19;Guadalajara;324;Villel de Mesa;198;110;88
19;Guadalajara;325;Viñuelas;143;78;65
19;Guadalajara;326;Yebes;2881;1502;1379
19;Guadalajara;327;Yebra;492;255;237
19;Guadalajara;329;Yélamos de Abajo;64;35;29
19;Guadalajara;330;Yélamos de Arriba;93;55;38
19;Guadalajara;331;Yunquera de Henares;3835;1974;1861
19;Guadalajara;332;Yunta, La;101;56;45
19;Guadalajara;333;Zaorejas;131;88;43
19;Guadalajara;334;Zarzuela de Jadraque;37;21;16
19;Guadalajara;335;Zorita de los Canes;68;33;35
21;Huelva;001;Alájar;814;415;399
21;Huelva;002;Aljaraque;20745;10307;10438
21;Huelva;003;Almendro, El;838;440;398
21;Huelva;004;Almonaster la Real;1891;993;898
21;Huelva;005;Almonte;23223;11610;11613
21;Huelva;006;Alosno;3995;1955;2040
21;Huelva;007;Aracena;7929;3907;4022
21;Huelva;008;Aroche;3157;1586;1571
21;Huelva;009;Arroyomolinos de León;983;512;471
21;Huelva;010;Ayamonte;20629;10317;10312
21;Huelva;011;Beas;4272;2165;2107
21;Huelva;012;Berrocal;331;164;167
21;Huelva;013;Bollullos Par del Condado;14177;7067;7110
21;Huelva;014;Bonares;6021;3002;3019
21;Huelva;015;Cabezas Rubias;731;379;352
21;Huelva;016;Cala;1236;621;615
21;Huelva;017;Calañas;4225;2151;2074
21;Huelva;018;Campillo, El;2072;1018;1054
21;Huelva;019;Campofrío;708;354;354
21;Huelva;020;Cañaveral de León;410;203;207
21;Huelva;021;Cartaya;19094;9812;9282
21;Huelva;022;Castaño del Robledo;206;123;83
21;Huelva;023;Cerro de Andévalo, El;2454;1228;1226
21;Huelva;030;Chucena;2142;1086;1056
21;Huelva;024;Corteconcepción;547;267;280
21;Huelva;025;Cortegana;4853;2455;2398
21;Huelva;026;Cortelazor;302;151;151
21;Huelva;027;Cumbres de Enmedio;50;30;20
21;Huelva;028;Cumbres de San Bartolomé;404;198;206
21;Huelva;029;Cumbres Mayores;1827;910;917
21;Huelva;031;Encinasola;1365;697;668
21;Huelva;032;Escacena del Campo;2241;1103;1138
21;Huelva;033;Fuenteheridos;648;333;315
21;Huelva;034;Galaroza;1431;701;730
21;Huelva;035;Gibraleón;12523;6208;6315
21;Huelva;036;Granada de Río-Tinto, La;191;96;95
21;Huelva;037;Granado, El;525;276;249
21;Huelva;038;Higuera de la Sierra;1317;677;640
21;Huelva;039;Hinojales;317;158;159
21;Huelva;040;Hinojos;3893;1961;1932
21;Huelva;041;Huelva;145468;69868;75600
21;Huelva;042;Isla Cristina;21165;10540;10625
21;Huelva;043;Jabugo;2260;1137;1123
21;Huelva;044;Lepe;27409;13984;13425
21;Huelva;045;Linares de la Sierra;266;132;134
21;Huelva;046;Lucena del Puerto;3146;1635;1511
21;Huelva;047;Manzanilla;2094;1058;1036
21;Huelva;048;Marines, Los;384;206;178
21;Huelva;049;Minas de Riotinto;3974;1928;2046
21;Huelva;050;Moguer;21401;10704;10697
21;Huelva;051;Nava, La;292;144;148
21;Huelva;052;Nerva;5474;2657;2817
21;Huelva;053;Niebla;4098;2081;2017
21;Huelva;054;Palma del Condado, La;10624;5308;5316
21;Huelva;055;Palos de la Frontera;10785;5390;5395
21;Huelva;056;Paterna del Campo;3486;1762;1724
21;Huelva;057;Paymogo;1221;613;608
21;Huelva;058;Puebla de Guzmán;3138;1614;1524
21;Huelva;059;Puerto Moral;286;141;145
21;Huelva;060;Punta Umbría;15053;7663;7390
21;Huelva;061;Rociana del Condado;7735;3901;3834
21;Huelva;062;Rosal de la Frontera;1728;868;860
21;Huelva;063;San Bartolomé de la Torre;3618;1816;1802
21;Huelva;064;San Juan del Puerto;8949;4494;4455
21;Huelva;066;San Silvestre de Guzmán;604;322;282
21;Huelva;065;Sanlúcar de Guadiana;431;218;213
21;Huelva;067;Santa Ana la Real;498;235;263
21;Huelva;068;Santa Bárbara de Casa;1087;532;555
21;Huelva;069;Santa Olalla del Cala;2042;1047;995
21;Huelva;070;Trigueros;7628;3766;3862
21;Huelva;071;Valdelarco;233;111;122
21;Huelva;072;Valverde del Camino;12857;6318;6539
21;Huelva;073;Villablanca;2801;1398;1403
21;Huelva;074;Villalba del Alcor;3308;1632;1676
21;Huelva;075;Villanueva de las Cruces;385;187;198
21;Huelva;076;Villanueva de los Castillejos;2746;1377;1369
21;Huelva;077;Villarrasa;2167;1105;1062
21;Huelva;078;Zalamea la Real;3178;1604;1574
21;Huelva;079;Zufre;860;439;421
22;Huesca;001;Abiego;247;132;115
22;Huesca;002;Abizanda;142;73;69
22;Huesca;003;Adahuesca;166;81;85
22;Huesca;004;Agüero;141;83;58
22;Huesca;907;Aínsa-Sobrarbe;2173;1113;1060
22;Huesca;006;Aisa;345;187;158
22;Huesca;007;Albalate de Cinca;1147;608;539
22;Huesca;008;Albalatillo;196;109;87
22;Huesca;009;Albelda;735;381;354
22;Huesca;011;Albero Alto;114;68;46
22;Huesca;012;Albero Bajo;137;73;64
22;Huesca;013;Alberuela de Tubo;315;163;152
22;Huesca;014;Alcalá de Gurrea;266;139;127
22;Huesca;015;Alcalá del Obispo;340;187;153
22;Huesca;016;Alcampell;678;337;341
22;Huesca;017;Alcolea de Cinca;1158;612;546
22;Huesca;018;Alcubierre;385;207;178
22;Huesca;019;Alerre;205;106;99
22;Huesca;020;Alfántega;131;66;65
22;Huesca;021;Almudévar;2472;1269;1203
22;Huesca;022;Almunia de San Juan;672;349;323
22;Huesca;023;Almuniente;501;245;256
22;Huesca;024;Alquézar;299;165;134
22;Huesca;025;Altorricón;1466;780;686
22;Huesca;027;Angüés;390;206;184
22;Huesca;028;Ansó;412;210;202
22;Huesca;029;Antillón;155;80;75
22;Huesca;032;Aragüés del Puerto;115;63;52
22;Huesca;035;Arén;321;173;148
22;Huesca;036;Argavieso;101;58;43
22;Huesca;037;Arguis;122;69;53
22;Huesca;039;Ayerbe;1100;544;556
22;Huesca;040;Azanuy-Alins;168;85;83
22;Huesca;041;Azara;187;95;92
22;Huesca;042;Azlor;137;66;71
22;Huesca;043;Baélls;105;61;44
22;Huesca;044;Bailo;287;173;114
22;Huesca;045;Baldellou;91;53;38
22;Huesca;046;Ballobar;825;419;406
22;Huesca;047;Banastás;297;160;137
22;Huesca;048;Barbastro;16961;8253;8708
22;Huesca;049;Barbués;83;47;36
22;Huesca;050;Barbuñales;95;48;47
22;Huesca;051;Bárcabo;113;65;48
22;Huesca;052;Belver de Cinca;1294;732;562
22;Huesca;053;Benabarre;1111;569;542
22;Huesca;054;Benasque;2047;1096;951
22;Huesca;246;Beranuy;88;50;38
22;Huesca;055;Berbegal;363;191;172
22;Huesca;057;Bielsa;483;248;235
22;Huesca;058;Bierge;251;142;109
22;Huesca;059;Biescas;1470;774;696
22;Huesca;060;Binaced;1528;808;720
22;Huesca;061;Binéfar;9394;4880;4514
22;Huesca;062;Bisaurri;185;103;82
22;Huesca;063;Biscarrués;195;106;89
22;Huesca;064;Blecua y Torres;202;115;87
22;Huesca;066;Boltaña;959;517;442
22;Huesca;067;Bonansa;80;44;36
22;Huesca;068;Borau;91;57;34
22;Huesca;069;Broto;532;292;240
22;Huesca;072;Caldearenas;216;121;95
22;Huesca;074;Campo;365;193;172
22;Huesca;075;Camporrélls;138;74;64
22;Huesca;076;Canal de Berdún;361;196;165
22;Huesca;077;Candasnos;318;165;153
22;Huesca;078;Canfranc;543;301;242
22;Huesca;079;Capdesaso;168;72;96
22;Huesca;080;Capella;364;194;170
22;Huesca;081;Casbas de Huesca;293;155;138
22;Huesca;083;Castejón de Monegros;543;289;254
22;Huesca;084;Castejón de Sos;740;380;360
22;Huesca;082;Castejón del Puente;325;172;153
22;Huesca;085;Castelflorite;114;61;53
22;Huesca;086;Castiello de Jaca;255;140;115
22;Huesca;087;Castigaleu;89;51;38
22;Huesca;088;Castillazuelo;176;86;90
22;Huesca;089;Castillonroy;334;175;159
22;Huesca;094;Chalamera;108;56;52
22;Huesca;095;Chía;85;52;33
22;Huesca;096;Chimillas;371;189;182
22;Huesca;090;Colungo;128;70;58
22;Huesca;099;Esplús;612;304;308
22;Huesca;102;Estada;205;114;91
22;Huesca;103;Estadilla;808;394;414
22;Huesca;105;Estopiñán del Castillo;142;77;65
22;Huesca;106;Fago;22;13;9
22;Huesca;107;Fanlo;107;67;40
22;Huesca;109;Fiscal;338;179;159
22;Huesca;110;Fonz;918;458;460
22;Huesca;111;Foradada del Toscar;183;96;87
22;Huesca;112;Fraga;14925;7604;7321
22;Huesca;113;Fueva, La;611;321;290
22;Huesca;114;Gistaín;137;77;60
22;Huesca;115;Grado, El;423;225;198
22;Huesca;116;Grañén;1804;942;862
22;Huesca;117;Graus;3329;1666;1663
22;Huesca;119;Gurrea de Gállego;1513;783;730
22;Huesca;122;Hoz de Jaca;72;37;35
22;Huesca;908;Hoz y Costean;217;121;96
22;Huesca;124;Huerto;230;126;104
22;Huesca;125;Huesca;52282;24984;27298
22;Huesca;126;Ibieca;100;54;46
22;Huesca;127;Igriés;711;374;337
22;Huesca;128;Ilche;211;108;103
22;Huesca;129;Isábena;266;144;122
22;Huesca;130;Jaca;12929;6391;6538
22;Huesca;131;Jasa;98;57;41
22;Huesca;133;Labuerda;158;85;73
22;Huesca;135;Laluenga;211;111;100
22;Huesca;136;Lalueza;974;507;467
22;Huesca;137;Lanaja;1231;657;574
22;Huesca;139;Laperdiguera;92;49;43
22;Huesca;141;Lascellas-Ponzano;133;83;50
22;Huesca;142;Lascuarre;136;69;67
22;Huesca;143;Laspaúles;266;154;112
22;Huesca;144;Laspuña;274;151;123
22;Huesca;149;Loarre;337;190;147
22;Huesca;150;Loporzano;536;302;234
22;Huesca;151;Loscorrales;102;51;51
22;Huesca;905;Lupiñén-Ortilla;340;169;171
22;Huesca;155;Monesma y Cajigar;84;43;41
22;Huesca;156;Monflorite-Lascasas;360;192;168
22;Huesca;157;Montanuy;223;128;95
22;Huesca;158;Monzón;17237;8719;8518
22;Huesca;160;Naval;264;137;127
22;Huesca;162;Novales;177;90;87
22;Huesca;163;Nueno;553;302;251
22;Huesca;164;Olvena;45;22;23
22;Huesca;165;Ontiñena;560;282;278
22;Huesca;167;Osso de Cinca;729;391;338
22;Huesca;168;Palo;24;12;12
22;Huesca;170;Panticosa;774;396;378
22;Huesca;172;Peñalba;688;341;347
22;Huesca;173;Peñas de Riglos, Las;258;163;95
22;Huesca;174;Peralta de Alcofea;587;310;277
22;Huesca;175;Peralta de Calasanz;228;130;98
22;Huesca;176;Peraltilla;197;103;94
22;Huesca;177;Perarrúa;113;60;53
22;Huesca;178;Pertusa;115;69;46
22;Huesca;181;Piracés;103;57;46
22;Huesca;182;Plan;299;157;142
22;Huesca;184;Poleñino;209;111;98
22;Huesca;186;Pozán de Vero;204;98;106
22;Huesca;187;Puebla de Castro, La;379;193;186
22;Huesca;188;Puente de Montañana;103;48;55
22;Huesca;902;Puente la Reina de Jaca;272;136;136
22;Huesca;189;Puértolas;213;123;90
22;Huesca;190;Pueyo de Araguás, El;156;90;66
22;Huesca;193;Pueyo de Santa Cruz;317;163;154
22;Huesca;195;Quicena;286;144;142
22;Huesca;197;Robres;569;288;281
22;Huesca;199;Sabiñánigo;9349;4668;4681
22;Huesca;200;Sahún;303;160;143
22;Huesca;201;Salas Altas;310;153;157
22;Huesca;202;Salas Bajas;169;82;87
22;Huesca;203;Salillas;98;53;45
22;Huesca;204;Sallent de Gállego;1461;733;728
22;Huesca;205;San Esteban de Litera;498;252;246
22;Huesca;207;San Juan de Plan;144;81;63
22;Huesca;903;San Miguel del Cinca;826;421;405
22;Huesca;206;Sangarrén;222;116;106
22;Huesca;208;Santa Cilia;219;117;102
22;Huesca;209;Santa Cruz de la Serós;186;107;79
22;Huesca;906;Santa María de Dulcis;226;120;106
22;Huesca;212;Santaliestra y San Quílez;95;48;47
22;Huesca;213;Sariñena;4188;2158;2030
22;Huesca;214;Secastilla;146;68;78
22;Huesca;215;Seira;145;81;64
22;Huesca;217;Sena;507;276;231
22;Huesca;218;Senés de Alcubierre;45;20;25
22;Huesca;220;Sesa;180;102;78
22;Huesca;221;Sesué;103;54;49
22;Huesca;222;Siétamo;680;374;306
22;Huesca;223;Sopeira;95;52;43
22;Huesca;904;Sotonera, La;955;494;461
22;Huesca;225;Tamarite de Litera;3507;1796;1711
22;Huesca;226;Tardienta;965;490;475
22;Huesca;227;Tella-Sin;243;133;110
22;Huesca;228;Tierz;743;367;376
22;Huesca;229;Tolva;134;75;59
22;Huesca;230;Torla-Ordesa;305;159;146
22;Huesca;232;Torralba de Aragón;107;55;52
22;Huesca;233;Torre la Ribera;103;56;47
22;Huesca;234;Torrente de Cinca;1157;585;572
22;Huesca;235;Torres de Alcanadre;98;57;41
22;Huesca;236;Torres de Barbués;281;136;145
22;Huesca;239;Tramaced;113;69;44
22;Huesca;242;Valfarta;70;41;29
22;Huesca;243;Valle de Bardají;34;20;14
22;Huesca;901;Valle de Hecho;879;459;420
22;Huesca;244;Valle de Lierp;52;27;25
22;Huesca;245;Velilla de Cinca;442;230;212
22;Huesca;909;Vencillón;414;217;197
22;Huesca;247;Viacamp y Litera;44;25;19
22;Huesca;248;Vicién;121;71;50
22;Huesca;249;Villanova;162;83;79
22;Huesca;250;Villanúa;441;238;203
22;Huesca;251;Villanueva de Sigena;422;212;210
22;Huesca;252;Yebra de Basa;140;82;58
22;Huesca;253;Yésero;57;34;23
22;Huesca;254;Zaidín;1783;921;862
23;Jaén;001;Albanchez de Mágina;1072;556;516
23;Jaén;002;Alcalá la Real;21758;10692;11066
23;Jaén;003;Alcaudete;10698;5274;5424
23;Jaén;004;Aldeaquemada;516;281;235
23;Jaén;005;Andújar;37975;18686;19289
23;Jaén;006;Arjona;5691;2812;2879
23;Jaén;007;Arjonilla;3695;1843;1852
23;Jaén;008;Arquillos;1836;917;919
23;Jaén;905;Arroyo del Ojanco;2354;1193;1161
23;Jaén;009;Baeza;16100;7995;8105
23;Jaén;010;Bailén;18085;9000;9085
23;Jaén;011;Baños de la Encina;2634;1350;1284
23;Jaén;012;Beas de Segura;5380;2794;2586
23;Jaén;902;Bedmar y Garcíez;2823;1401;1422
23;Jaén;014;Begíjar;3102;1561;1541
23;Jaén;015;Bélmez de la Moraleda;1646;830;816
23;Jaén;016;Benatae;463;242;221
23;Jaén;017;Cabra del Santo Cristo;1908;1003;905
23;Jaén;018;Cambil;2802;1450;1352
23;Jaén;019;Campillo de Arenas;1897;990;907
23;Jaén;020;Canena;1943;996;947
23;Jaén;021;Carboneros;630;327;303
23;Jaén;901;Cárcheles;1387;724;663
23;Jaén;024;Carolina, La;15579;7712;7867
23;Jaén;025;Castellar;3411;1705;1706
23;Jaén;026;Castillo de Locubín;4212;2072;2140
23;Jaén;027;Cazalilla;846;407;439
23;Jaén;028;Cazorla;7673;3729;3944
23;Jaén;029;Chiclana de Segura;1002;495;507
23;Jaén;030;Chilluévar;1499;729;770
23;Jaén;031;Escañuela;947;475;472
23;Jaén;032;Espelúy;687;338;349
23;Jaén;033;Frailes;1637;811;826
23;Jaén;034;Fuensanta de Martos;3115;1541;1574
23;Jaén;035;Fuerte del Rey;1399;725;674
23;Jaén;037;Génave;608;327;281
23;Jaén;038;Guardia de Jaén, La;4895;2488;2407
23;Jaén;039;Guarromán;2861;1440;1421
23;Jaén;041;Higuera de Calatrava;632;333;299
23;Jaén;042;Hinojares;338;173;165
23;Jaén;043;Hornos;649;327;322
23;Jaén;044;Huelma;6021;2993;3028
23;Jaén;045;Huesa;2553;1294;1259
23;Jaén;046;Ibros;2956;1477;1479
23;Jaén;047;Iruela, La;1989;977;1012
23;Jaén;048;Iznatoraf;1031;539;492
23;Jaén;049;Jabalquinto;2152;1070;1082
23;Jaén;050;Jaén;114658;55159;59499
23;Jaén;051;Jamilena;3376;1706;1670
23;Jaén;052;Jimena;1323;637;686
23;Jaén;053;Jódar;11994;5944;6050
23;Jaén;040;Lahiguera;1771;872;899
23;Jaén;054;Larva;483;248;235
23;Jaén;055;Linares;58829;28822;30007
23;Jaén;056;Lopera;3743;1868;1875
23;Jaén;057;Lupión;883;432;451
23;Jaén;058;Mancha Real;11194;5560;5634
23;Jaén;059;Marmolejo;7053;3532;3521
23;Jaén;060;Martos;24240;12032;12208
23;Jaén;061;Mengíbar;9921;4938;4983
23;Jaén;062;Montizón;1768;915;853
23;Jaén;063;Navas de San Juan;4597;2304;2293
23;Jaén;064;Noalejo;1977;997;980
23;Jaén;065;Orcera;1894;954;940
23;Jaén;066;Peal de Becerro;5325;2651;2674
23;Jaén;067;Pegalajar;2966;1482;1484
23;Jaén;069;Porcuna;6532;3329;3203
23;Jaén;070;Pozo Alcón;4857;2480;2377
23;Jaén;071;Puente de Génave;2216;1118;1098
23;Jaén;072;Puerta de Segura, La;2435;1214;1221
23;Jaén;073;Quesada;5483;2777;2706
23;Jaén;074;Rus;3668;1874;1794
23;Jaén;075;Sabiote;4042;2016;2026
23;Jaén;076;Santa Elena;966;514;452
23;Jaén;077;Santiago de Calatrava;727;373;354
23;Jaén;904;Santiago-Pontones;3229;1663;1566
23;Jaén;079;Santisteban del Puerto;4621;2377;2244
23;Jaén;080;Santo Tomé;2249;1132;1117
23;Jaén;081;Segura de la Sierra;1845;907;938
23;Jaén;082;Siles;2336;1185;1151
23;Jaén;084;Sorihuela del Guadalimar;1196;632;564
23;Jaén;085;Torreblascopedro;2669;1339;1330
23;Jaén;086;Torredelcampo;14538;7300;7238
23;Jaén;087;Torredonjimeno;13874;6813;7061
23;Jaén;088;Torreperogil;7468;3634;3834
23;Jaén;090;Torres;1513;768;745
23;Jaén;091;Torres de Albánchez;860;447;413
23;Jaén;092;Úbeda;34835;17095;17740
23;Jaén;093;Valdepeñas de Jaén;3910;1937;1973
23;Jaén;094;Vilches;4646;2336;2310
23;Jaén;095;Villacarrillo;11000;5553;5447
23;Jaén;096;Villanueva de la Reina;3152;1590;1562
23;Jaén;097;Villanueva del Arzobispo;8447;4352;4095
23;Jaén;098;Villardompardo;1017;508;509
23;Jaén;099;Villares, Los;6019;3009;3010
23;Jaén;101;Villarrodrigo;441;227;214
23;Jaén;903;Villatorres;4377;2216;2161
24;León;001;Acebedo;215;126;89
24;León;002;Algadefe;279;143;136
24;León;003;Alija del Infantado;696;351;345
24;León;004;Almanza;563;323;240
24;León;005;Antigua, La;403;232;171
24;León;006;Ardón;563;303;260
24;León;007;Arganza;858;430;428
24;León;008;Astorga;11264;5347;5917
24;León;009;Balboa;322;174;148
24;León;010;Bañeza, La;10450;5042;5408
24;León;011;Barjas;198;105;93
24;León;012;Barrios de Luna, Los;315;178;137
24;León;014;Bembibre;9356;4594;4762
24;León;015;Benavides;2587;1274;1313
24;León;016;Benuza;503;288;215
24;León;017;Bercianos del Páramo;605;308;297
24;León;018;Bercianos del Real Camino;196;101;95
24;León;019;Berlanga del Bierzo;378;174;204
24;León;020;Boca de Huérgano;485;283;202
24;León;021;Boñar;1918;978;940
24;León;022;Borrenes;345;178;167
24;León;023;Brazuelo;300;163;137
24;León;024;Burgo Ranero, El;764;407;357
24;León;025;Burón;320;188;132
24;León;026;Bustillo del Páramo;1274;654;620
24;León;027;Cabañas Raras;1344;684;660
24;León;028;Cabreros del Río;429;234;195
24;León;029;Cabrillanes;804;416;388
24;León;030;Cacabelos;5264;2611;2653
24;León;031;Calzada del Coto;244;140;104
24;León;032;Campazas;122;58;64
24;León;033;Campo de Villavidel;208;111;97
24;León;034;Camponaraya;4096;2041;2055
24;León;036;Candín;290;152;138
24;León;037;Cármenes;378;206;172
24;León;038;Carracedelo;3523;1749;1774
24;León;039;Carrizo;2335;1175;1160
24;León;040;Carrocera;501;264;237
24;León;041;Carucedo;574;293;281
24;León;042;Castilfalé;72;41;31
24;León;043;Castrillo de Cabrera;134;72;62
24;León;044;Castrillo de la Valduerna;180;80;100
24;León;046;Castrocalbón;1021;535;486
24;León;047;Castrocontrigo;823;438;385
24;León;049;Castropodame;1714;875;839
24;León;050;Castrotierra de Valmadrigal;111;59;52
24;León;051;Cea;449;233;216
24;León;052;Cebanico;171;104;67
24;León;053;Cebrones del Río;490;265;225
24;León;065;Chozas de Abajo;2528;1317;1211
24;León;054;Cimanes de la Vega;482;249;233
24;León;055;Cimanes del Tejar;755;408;347
24;León;056;Cistierna;3290;1623;1667
24;León;057;Congosto;1559;775;784
24;León;058;Corbillos de los Oteros;215;122;93
24;León;059;Corullón;937;477;460
24;León;060;Crémenes;584;318;266
24;León;061;Cuadros;2000;1025;975
24;León;062;Cubillas de los Oteros;152;87;65
24;León;063;Cubillas de Rueda;435;222;213
24;León;064;Cubillos del Sil;1813;965;848
24;León;066;Destriana;523;253;270
24;León;067;Encinedo;752;400;352
24;León;068;Ercina, La;478;248;230
24;León;069;Escobar de Campos;42;26;16
24;León;070;Fabero;4746;2305;2441
24;León;071;Folgoso de la Ribera;1142;558;584
24;León;073;Fresno de la Vega;547;273;274
24;León;074;Fuentes de Carbajal;92;51;41
24;León;076;Garrafe de Torío;1480;811;669
24;León;077;Gordaliza del Pino;268;131;137
24;León;078;Gordoncillo;449;229;220
24;León;079;Gradefes;987;526;461
24;León;080;Grajal de Campos;231;118;113
24;León;081;Gusendos de los Oteros;147;82;65
24;León;082;Hospital de Órbigo;993;500;493
24;León;083;Igüeña;1213;645;568
24;León;084;Izagre;174;90;84
24;León;086;Joarilla de las Matas;303;165;138
24;León;087;Laguna Dalga;697;376;321
24;León;088;Laguna de Negrillos;1089;563;526
24;León;089;León;126192;57244;68948
24;León;092;Llamas de la Ribera;869;454;415
24;León;090;Lucillo;399;206;193
24;León;091;Luyego;692;360;332
24;León;093;Magaz de Cepeda;370;191;179
24;León;094;Mansilla de las Mulas;1798;920;878
24;León;095;Mansilla Mayor;341;182;159
24;León;096;Maraña;128;78;50
24;León;097;Matadeón de los Oteros;241;126;115
24;León;098;Matallana de Torío;1342;702;640
24;León;099;Matanza;185;101;84
24;León;100;Molinaseca;888;478;410
24;León;101;Murias de Paredes;412;207;205
24;León;102;Noceda del Bierzo;723;362;361
24;León;103;Oencia;295;171;124
24;León;104;Omañas, Las;288;155;133
24;León;105;Onzonilla;1790;928;862
24;León;106;Oseja de Sajambre;257;153;104
24;León;107;Pajares de los Oteros;283;173;110
24;León;108;Palacios de la Valduerna;407;195;212
24;León;109;Palacios del Sil;1062;569;493
24;León;110;Páramo del Sil;1381;700;681
24;León;112;Peranzanes;320;185;135
24;León;113;Pobladura de Pelayo García;385;196;189
24;León;114;Pola de Gordón, La;3488;1752;1736
24;León;115;Ponferrada;66447;31702;34745
24;León;116;Posada de Valdeón;457;271;186
24;León;117;Pozuelo del Páramo;465;237;228
24;León;118;Prado de la Guzpeña;135;76;59
24;León;119;Priaranza del Bierzo;785;398;387
24;León;120;Prioro;369;209;160
24;León;121;Puebla de Lillo;699;390;309
24;León;122;Puente de Domingo Flórez;1542;804;738
24;León;123;Quintana del Castillo;786;434;352
24;León;124;Quintana del Marco;390;213;177
24;León;125;Quintana y Congosto;358;180;178
24;León;127;Regueras de Arriba;310;169;141
24;León;129;Reyero;128;67;61
24;León;130;Riaño;484;277;207
24;León;131;Riego de la Vega;816;431;385
24;León;132;Riello;648;364;284
24;León;133;Rioseco de Tapia;378;210;168
24;León;134;Robla, La;4142;2086;2056
24;León;136;Roperuelos del Páramo;582;292;290
24;León;137;Sabero;1212;607;605
24;León;139;Sahagún;2645;1307;1338
24;León;141;San Adrián del Valle;109;57;52
24;León;142;San Andrés del Rabanedo;31470;15119;16351
24;León;144;San Cristóbal de la Polantera;767;376;391
24;León;145;San Emiliano;687;377;310
24;León;146;San Esteban de Nogales;272;144;128
24;León;148;San Justo de la Vega;1908;970;938
24;León;149;San Millán de los Caballeros;186;95;91
24;León;150;San Pedro Bercianos;253;136;117
24;León;143;Sancedo;573;287;286
24;León;151;Santa Colomba de Curueño;529;280;249
24;León;152;Santa Colomba de Somoza;522;282;240
24;León;153;Santa Cristina de Valmadrigal;267;135;132
24;León;154;Santa Elena de Jamuz;1133;585;548
24;León;155;Santa María de la Isla;512;268;244
24;León;158;Santa María de Ordás;338;175;163
24;León;156;Santa María del Monte de Cea;249;133;116
24;León;157;Santa María del Páramo;3141;1540;1601
24;León;159;Santa Marina del Rey;1992;992;1000
24;León;160;Santas Martas;770;403;367
24;León;161;Santiago Millas;327;184;143
24;León;162;Santovenia de la Valdoncina;2014;1036;978
24;León;163;Sariegos;4904;2475;2429
24;León;164;Sena de Luna;395;198;197
24;León;165;Sobrado;353;176;177
24;León;166;Soto de la Vega;1600;830;770
24;León;167;Soto y Amío;830;417;413
24;León;168;Toral de los Guzmanes;519;271;248
24;León;206;Toral de los Vados;1941;962;979
24;León;169;Toreno;3304;1658;1646
24;León;170;Torre del Bierzo;2248;1148;1100
24;León;171;Trabadelo;366;204;162
24;León;172;Truchas;444;232;212
24;León;173;Turcia;1039;532;507
24;León;174;Urdiales del Páramo;508;274;234
24;León;185;Val de San Lorenzo;529;262;267
24;León;175;Valdefresno;2158;1113;1045
24;León;176;Valdefuentes del Páramo;347;181;166
24;León;177;Valdelugueros;520;297;223
24;León;178;Valdemora;77;35;42
24;León;179;Valdepiélago;332;188;144
24;León;180;Valdepolo;1248;657;591
24;León;181;Valderas;1777;898;879
24;León;182;Valderrey;454;217;237
24;León;183;Valderrueda;909;466;443
24;León;184;Valdesamario;213;117;96
24;León;187;Valdevimbre;1016;530;486
24;León;188;Valencia de Don Juan;5190;2553;2637
24;León;191;Vallecillo;122;70;52
24;León;189;Valverde de la Virgen;7358;3813;3545
24;León;190;Valverde-Enrique;174;92;82
24;León;193;Vecilla, La;409;213;196
24;León;196;Vega de Espinareda;2232;1122;1110
24;León;197;Vega de Infanzones;883;443;440
24;León;198;Vega de Valcarce;652;333;319
24;León;194;Vegacervera;312;165;147
24;León;199;Vegaquemada;457;245;212
24;León;201;Vegas del Condado;1158;658;500
24;León;202;Villablino;9342;4592;4750
24;León;203;Villabraz;107;61;46
24;León;205;Villadangos del Páramo;1096;561;535
24;León;207;Villademor de la Vega;352;191;161
24;León;209;Villafranca del Bierzo;3153;1525;1628
24;León;210;Villagatón;610;327;283
24;León;211;Villamandos;308;169;139
24;León;901;Villamanín;1001;517;484
24;León;212;Villamañán;1178;569;609
24;León;213;Villamartín de Don Sancho;155;86;69
24;León;214;Villamejil;709;371;338
24;León;215;Villamol;169;85;84
24;León;216;Villamontán de la Valduerna;777;404;373
24;León;217;Villamoratiel de las Matas;155;87;68
24;León;218;Villanueva de las Manzanas;505;266;239
24;León;219;Villaobispo de Otero;590;320;270
24;León;902;Villaornate y Castro;369;185;184
24;León;221;Villaquejida;914;461;453
24;León;222;Villaquilambre;18583;9200;9383
24;León;223;Villarejo de Órbigo;3061;1498;1563
24;León;224;Villares de Órbigo;672;355;317
24;León;225;Villasabariego;1156;614;542
24;León;226;Villaselán;209;120;89
24;León;227;Villaturiel;1942;1012;930
24;León;228;Villazala;726;381;345
24;León;229;Villazanzo de Valderaduey;461;264;197
24;León;230;Zotes del Páramo;456;257;199
25;Lleida;001;Abella de la Conca;181;100;81
25;Lleida;002;Àger;602;322;280
25;Lleida;003;Agramunt;5390;2714;2676
25;Lleida;038;Aitona;2523;1300;1223
25;Lleida;004;Alamús, Els;799;419;380
25;Lleida;005;Alàs i Cerc;350;176;174
25;Lleida;006;Albagés, L';403;212;191
25;Lleida;007;Albatàrrec;2291;1193;1098
25;Lleida;008;Albesa;1596;861;735
25;Lleida;009;Albi, L';803;418;385
25;Lleida;010;Alcanó;249;123;126
25;Lleida;011;Alcarràs;9297;4814;4483
25;Lleida;012;Alcoletge;3375;1745;1630
25;Lleida;013;Alfarràs;2923;1544;1379
25;Lleida;014;Alfés;326;169;157
25;Lleida;015;Algerri;423;229;194
25;Lleida;016;Alguaire;3006;1576;1430
25;Lleida;017;Alins;287;152;135
25;Lleida;019;Almacelles;6800;3569;3231
25;Lleida;020;Almatret;327;181;146
25;Lleida;021;Almenar;3502;1870;1632
25;Lleida;022;Alòs de Balaguer;125;69;56
25;Lleida;023;Alpicat;6233;3108;3125
25;Lleida;024;Alt Àneu;402;226;176
25;Lleida;027;Anglesola;1335;668;667
25;Lleida;029;Arbeca;2240;1137;1103
25;Lleida;031;Arres;64;41;23
25;Lleida;032;Arsèguel;83;50;33
25;Lleida;033;Artesa de Lleida;1512;786;726
25;Lleida;034;Artesa de Segre;3556;1808;1748
25;Lleida;036;Aspa;217;108;109
25;Lleida;037;Avellanes i Santa Linya, Les;465;267;198
25;Lleida;039;Baix Pallars;342;181;161
25;Lleida;040;Balaguer;16530;8363;8167
25;Lleida;041;Barbens;943;500;443
25;Lleida;042;Baronia de Rialb, La;240;129;111
25;Lleida;044;Bassella;235;112;123
25;Lleida;045;Bausen;64;33;31
25;Lleida;046;Belianes;539;269;270
25;Lleida;170;Bellaguarda;307;159;148
25;Lleida;047;Bellcaire d'Urgell;1263;639;624
25;Lleida;048;Bell-lloc d'Urgell;2349;1162;1187
25;Lleida;049;Bellmunt d'Urgell;188;90;98
25;Lleida;050;Bellpuig;5005;2600;2405
25;Lleida;051;Bellver de Cerdanya;1995;1034;961
25;Lleida;052;Bellvís;2264;1150;1114
25;Lleida;053;Benavent de Segrià;1482;772;710
25;Lleida;055;Biosca;187;99;88
25;Lleida;057;Bòrdes, Es;250;138;112
25;Lleida;058;Borges Blanques, Les;6000;3062;2938
25;Lleida;059;Bossòst;1123;555;568
25;Lleida;056;Bovera;267;147;120
25;Lleida;060;Cabanabona;77;36;41
25;Lleida;061;Cabó;92;48;44
25;Lleida;062;Camarasa;879;448;431
25;Lleida;063;Canejan;97;54;43
25;Lleida;904;Castell de Mur;175;94;81
25;Lleida;064;Castellar de la Ribera;142;71;71
25;Lleida;067;Castelldans;958;524;434
25;Lleida;068;Castellnou de Seana;736;393;343
25;Lleida;069;Castelló de Farfanya;556;300;256
25;Lleida;070;Castellserà;1030;519;511
25;Lleida;071;Cava;57;35;22
25;Lleida;072;Cervera;9013;4544;4469
25;Lleida;073;Cervià de les Garrigues;686;357;329
25;Lleida;074;Ciutadilla;204;110;94
25;Lleida;075;Clariana de Cardener;141;71;70
25;Lleida;076;Cogul, El;174;93;81
25;Lleida;077;Coll de Nargó;574;292;282
25;Lleida;163;Coma i la Pedra, La;261;156;105
25;Lleida;161;Conca de Dalt;439;228;211
25;Lleida;078;Corbins;1401;751;650
25;Lleida;079;Cubells;373;196;177
25;Lleida;081;Espluga Calba, L';375;189;186
25;Lleida;082;Espot;361;195;166
25;Lleida;088;Estamariu;119;67;52
25;Lleida;085;Estaràs;163;86;77
25;Lleida;086;Esterri d'Àneu;789;375;414
25;Lleida;087;Esterri de Cardós;69;34;35
25;Lleida;089;Farrera;126;75;51
25;Lleida;908;Fígols i Alinyà;254;147;107
25;Lleida;092;Floresta, La;155;86;69
25;Lleida;093;Fondarella;794;396;398
25;Lleida;094;Foradada;172;98;74
25;Lleida;096;Fuliola, La;1260;630;630
25;Lleida;097;Fulleda;87;46;41
25;Lleida;098;Gavet de la Conca;297;142;155
25;Lleida;912;Gimenells i el Pla de la Font;1111;570;541
25;Lleida;099;Golmés;1835;905;930
25;Lleida;100;Gósol;228;130;98
25;Lleida;101;Granadella, La;723;379;344
25;Lleida;102;Granja d'Escarp, La;977;519;458
25;Lleida;103;Granyanella;153;85;68
25;Lleida;105;Granyena de les Garrigues;158;93;65
25;Lleida;104;Granyena de Segarra;147;77;70
25;Lleida;109;Guimerà;275;147;128
25;Lleida;903;Guingueta d'Àneu, La;308;164;144
25;Lleida;110;Guissona;6892;3639;3253
25;Lleida;111;Guixers;146;94;52
25;Lleida;115;Isona i Conca Dellà;1046;552;494
25;Lleida;112;Ivars de Noguera;351;181;170
25;Lleida;113;Ivars d'Urgell;1578;826;752
25;Lleida;114;Ivorra;114;61;53
25;Lleida;910;Josa i Tuixén;122;71;51
25;Lleida;118;Juncosa;418;226;192
25;Lleida;119;Juneda;3343;1730;1613
25;Lleida;121;Les;958;469;489
25;Lleida;122;Linyola;2650;1330;1320
25;Lleida;123;Lladorre;226;107;119
25;Lleida;124;Lladurs;187;100;87
25;Lleida;125;Llardecans;476;248;228
25;Lleida;126;Llavorsí;355;175;180
25;Lleida;120;Lleida;138144;68284;69860
25;Lleida;127;Lles de Cerdanya;247;144;103
25;Lleida;128;Llimiana;150;88;62
25;Lleida;129;Llobera;203;110;93
25;Lleida;133;Maials;950;513;437
25;Lleida;130;Maldà;230;116;114
25;Lleida;131;Massalcoreig;571;313;258
25;Lleida;132;Massoteres;203;110;93
25;Lleida;134;Menàrguens;847;473;374
25;Lleida;135;Miralcamp;1369;686;683
25;Lleida;137;Mollerussa;14585;7465;7120
25;Lleida;136;Molsosa, La;111;54;57
25;Lleida;139;Montellà i Martinet;547;302;245
25;Lleida;140;Montferrer i Castellbò;1050;566;484
25;Lleida;138;Montgai;651;335;316
25;Lleida;142;Montoliu de Lleida;495;251;244
25;Lleida;141;Montoliu de Segarra;188;105;83
25;Lleida;143;Montornès de Segarra;100;50;50
25;Lleida;145;Nalec;100;52;48
25;Lleida;025;Naut Aran;1764;899;865
25;Lleida;146;Navès;283;137;146
25;Lleida;148;Odèn;259;150;109
25;Lleida;149;Oliana;1844;929;915
25;Lleida;150;Oliola;220;123;97
25;Lleida;151;Olius;929;488;441
25;Lleida;152;Oluges, Les;152;81;71
25;Lleida;153;Omellons, Els;217;116;101
25;Lleida;154;Omells de na Gaia, Els;137;74;63
25;Lleida;155;Organyà;804;399;405
25;Lleida;156;Os de Balaguer;1022;514;508
25;Lleida;157;Ossó de Sió;214;105;109
25;Lleida;158;Palau d'Anglesola, El;2153;1053;1100
25;Lleida;164;Penelles;474;271;203
25;Lleida;165;Peramola;344;172;172
25;Lleida;166;Pinell de Solsonès;213;125;88
25;Lleida;167;Pinós;297;160;137
25;Lleida;911;Plans de Sió, Els;523;280;243
25;Lleida;168;Poal, El;655;343;312
25;Lleida;169;Pobla de Cérvoles, La;206;115;91
25;Lleida;171;Pobla de Segur, La;2973;1475;1498
25;Lleida;030;Pont de Bar, El;165;92;73
25;Lleida;173;Pont de Suert, El;2293;1156;1137
25;Lleida;172;Ponts;2638;1310;1328
25;Lleida;174;Portella, La;741;409;332
25;Lleida;175;Prats i Sansor;238;123;115
25;Lleida;176;Preixana;382;197;185
25;Lleida;177;Preixens;448;229;219
25;Lleida;179;Prullans;208;103;105
25;Lleida;180;Puiggròs;287;145;142
25;Lleida;181;Puigverd d'Agramunt;237;133;104
25;Lleida;182;Puigverd de Lleida;1373;707;666
25;Lleida;183;Rialp;669;347;322
25;Lleida;905;Ribera d'Ondara;446;227;219
25;Lleida;185;Ribera d'Urgellet;962;504;458
25;Lleida;186;Riner;261;128;133
25;Lleida;913;Riu de Cerdanya;97;55;42
25;Lleida;189;Rosselló;3029;1516;1513
25;Lleida;190;Salàs de Pallars;340;183;157
25;Lleida;191;Sanaüja;425;216;209
25;Lleida;196;Sant Esteve de la Sarga;139;87;52
25;Lleida;192;Sant Guim de Freixenet;1059;553;506
25;Lleida;197;Sant Guim de la Plana;170;94;76
25;Lleida;193;Sant Llorenç de Morunys;966;474;492
25;Lleida;902;Sant Martí de Riucorb;674;353;321
25;Lleida;194;Sant Ramon;509;275;234
25;Lleida;201;Sarroca de Bellera;117;69;48
25;Lleida;200;Sarroca de Lleida;374;204;170
25;Lleida;202;Senterada;133;80;53
25;Lleida;035;Sentiu de Sió, La;462;239;223
25;Lleida;204;Seròs;1912;1035;877
25;Lleida;203;Seu d'Urgell, La;12185;5864;6321
25;Lleida;205;Sidamon;734;383;351
25;Lleida;206;Soleràs, El;350;181;169
25;Lleida;207;Solsona;8914;4425;4489
25;Lleida;208;Soriguera;408;221;187
25;Lleida;209;Sort;2145;1068;1077
25;Lleida;210;Soses;1698;880;818
25;Lleida;211;Sudanell;867;481;386
25;Lleida;212;Sunyer;350;200;150
25;Lleida;215;Talarn;689;462;227
25;Lleida;216;Talavera;257;141;116
25;Lleida;217;Tàrrega;16481;8192;8289
25;Lleida;218;Tarrés;100;57;43
25;Lleida;219;Tarroja de Segarra;182;101;81
25;Lleida;220;Térmens;1526;760;766
25;Lleida;221;Tírvia;143;68;75
25;Lleida;222;Tiurana;73;35;38
25;Lleida;223;Torà;1215;610;605
25;Lleida;224;Torms, Els;149;84;65
25;Lleida;225;Tornabous;882;473;409
25;Lleida;227;Torre de Cabdella, La;748;379;369
25;Lleida;226;Torrebesses;293;155;138
25;Lleida;228;Torrefarrera;4630;2361;2269
25;Lleida;907;Torrefeta i Florejacs;590;310;280
25;Lleida;230;Torregrossa;2166;1097;1069
25;Lleida;231;Torrelameu;703;401;302
25;Lleida;232;Torres de Segre;2253;1155;1098
25;Lleida;233;Torre-serona;379;198;181
25;Lleida;234;Tremp;6026;2976;3050
25;Lleida;043;Vall de Boí, La;1022;549;473
25;Lleida;901;Vall de Cardós;356;194;162
25;Lleida;238;Vallbona de les Monges;241;127;114
25;Lleida;240;Vallfogona de Balaguer;1868;924;944
25;Lleida;906;Valls d'Aguilar, Les;291;163;128
25;Lleida;239;Valls de Valira, Les;817;418;399
25;Lleida;909;Vansa i Fórnols, La;200;103;97
25;Lleida;242;Verdú;933;443;490
25;Lleida;243;Vielha e Mijaran;5459;2772;2687
25;Lleida;244;Vilagrassa;510;264;246
25;Lleida;245;Vilaller;552;295;257
25;Lleida;247;Vilamòs;151;81;70
25;Lleida;248;Vilanova de Bellpuig;1168;602;566
25;Lleida;254;Vilanova de la Barca;1054;535;519
25;Lleida;249;Vilanova de l'Aguda;213;105;108
25;Lleida;250;Vilanova de Meià;414;232;182
25;Lleida;251;Vilanova de Segrià;941;498;443
25;Lleida;252;Vila-sana;732;364;368
25;Lleida;253;Vilosell, El;185;91;94
25;Lleida;255;Vinaixa;499;257;242
27;Lugo;001;Abadín;2559;1260;1299
27;Lugo;002;Alfoz;1818;873;945
27;Lugo;003;Antas de Ulla;2080;1027;1053
27;Lugo;004;Baleira;1333;703;630
27;Lugo;901;Baralla;2660;1378;1282
27;Lugo;005;Barreiros;2970;1414;1556
27;Lugo;006;Becerreá;2921;1465;1456
27;Lugo;007;Begonte;3115;1559;1556
27;Lugo;008;Bóveda;1537;791;746
27;Lugo;902;Burela;9552;4723;4829
27;Lugo;009;Carballedo;2280;1150;1130
27;Lugo;010;Castro de Rei;5057;2476;2581
27;Lugo;011;Castroverde;2726;1402;1324
27;Lugo;012;Cervantes;1458;826;632
27;Lugo;013;Cervo;4295;2106;2189
27;Lugo;016;Chantada;8431;4089;4342
27;Lugo;014;Corgo, O;3581;1816;1765
27;Lugo;015;Cospeito;4754;2306;2448
27;Lugo;017;Folgoso do Courel;1060;556;504
27;Lugo;018;Fonsagrada, A;3768;1957;1811
27;Lugo;019;Foz;9908;4844;5064
27;Lugo;020;Friol;3894;1954;1940
27;Lugo;022;Guitiriz;5495;2735;2760
27;Lugo;023;Guntín;2833;1456;1377
27;Lugo;024;Incio, O;1740;868;872
27;Lugo;026;Láncara;2702;1372;1330
27;Lugo;027;Lourenzá;2259;1098;1161
27;Lugo;028;Lugo;98268;45623;52645
27;Lugo;029;Meira;1747;880;867
27;Lugo;030;Mondoñedo;3820;1790;2030
27;Lugo;031;Monforte de Lemos;18922;8957;9965
27;Lugo;032;Monterroso;3741;1868;1873
27;Lugo;033;Muras;668;342;326
27;Lugo;034;Navia de Suarna;1186;666;520
27;Lugo;035;Negueira de Muñiz;215;115;100
27;Lugo;037;Nogais, As;1161;608;553
27;Lugo;038;Ourol;1034;523;511
27;Lugo;039;Outeiro de Rei;5043;2587;2456
27;Lugo;040;Palas de Rei;3554;1784;1770
27;Lugo;041;Pantón;2620;1254;1366
27;Lugo;042;Paradela;1887;946;941
27;Lugo;043;Páramo, O;1456;740;716
27;Lugo;044;Pastoriza, A;3212;1618;1594
27;Lugo;045;Pedrafita do Cebreiro;1088;585;503
27;Lugo;047;Pobra do Brollón, A;1752;862;890
27;Lugo;046;Pol;1696;836;860
27;Lugo;048;Pontenova, A;2402;1160;1242
27;Lugo;049;Portomarín;1528;785;743
27;Lugo;050;Quiroga;3354;1608;1746
27;Lugo;056;Rábade;1521;758;763
27;Lugo;051;Ribadeo;9972;4766;5206
27;Lugo;052;Ribas de Sil;992;498;494
27;Lugo;053;Ribeira de Piquín;570;289;281
27;Lugo;054;Riotorto;1322;656;666
27;Lugo;055;Samos;1392;733;659
27;Lugo;057;Sarria;13337;6527;6810
27;Lugo;058;Saviñao, O;3926;1979;1947
27;Lugo;059;Sober;2375;1163;1212
27;Lugo;060;Taboada;2928;1397;1531
27;Lugo;061;Trabada;1133;544;589
27;Lugo;062;Triacastela;680;340;340
27;Lugo;063;Valadouro, O;2016;972;1044
27;Lugo;064;Vicedo, O;1802;883;919
27;Lugo;065;Vilalba;14487;7050;7437
27;Lugo;066;Viveiro;15615;7633;7982
27;Lugo;021;Xermade;1943;945;998
27;Lugo;025;Xove;3376;1680;1696
28;Madrid;001;Acebeda, La;66;36;30
28;Madrid;002;Ajalvir;4440;2318;2122
28;Madrid;003;Alameda del Valle;208;123;85
28;Madrid;004;Álamo, El;9017;4488;4529
28;Madrid;005;Alcalá de Henares;195907;96008;99899
28;Madrid;006;Alcobendas;113340;54631;58709
28;Madrid;007;Alcorcón;167354;81016;86338
28;Madrid;008;Aldea del Fresno;2584;1370;1214
28;Madrid;009;Algete;20311;10082;10229
28;Madrid;010;Alpedrete;14417;7098;7319
28;Madrid;011;Ambite;595;303;292
28;Madrid;012;Anchuelo;1215;643;572
28;Madrid;013;Aranjuez;57932;28256;29676
28;Madrid;014;Arganda del Rey;54256;27357;26899
28;Madrid;015;Arroyomolinos;28177;14160;14017
28;Madrid;016;Atazar, El;95;55;40
28;Madrid;017;Batres;1582;803;779
28;Madrid;018;Becerril de la Sierra;5439;2685;2754
28;Madrid;019;Belmonte de Tajo;1605;838;767
28;Madrid;021;Berrueco, El;752;382;370
28;Madrid;020;Berzosa del Lozoya;198;115;83
28;Madrid;022;Boadilla del Monte;49762;24332;25430
28;Madrid;023;Boalo, El;7225;3677;3548
28;Madrid;024;Braojos;201;117;84
28;Madrid;025;Brea de Tajo;560;325;235
28;Madrid;026;Brunete;10374;5120;5254
28;Madrid;027;Buitrago del Lozoya;1861;895;966
28;Madrid;028;Bustarviejo;2370;1191;1179
28;Madrid;029;Cabanillas de la Sierra;719;372;347
28;Madrid;030;Cabrera, La;2560;1269;1291
28;Madrid;031;Cadalso de los Vidrios;2788;1453;1335
28;Madrid;032;Camarma de Esteruelas;7050;3576;3474
28;Madrid;033;Campo Real;5888;2988;2900
28;Madrid;034;Canencia;451;243;208
28;Madrid;035;Carabaña;1948;959;989
28;Madrid;036;Casarrubuelos;3589;1834;1755
28;Madrid;037;Cenicientos;1986;977;1009
28;Madrid;038;Cercedilla;6751;3301;3450
28;Madrid;039;Cervera de Buitrago;157;91;66
28;Madrid;051;Chapinería;2214;1135;1079
28;Madrid;052;Chinchón;5294;2675;2619
28;Madrid;040;Ciempozuelos;23773;12042;11731
28;Madrid;041;Cobeña;7009;3458;3551
28;Madrid;046;Collado Mediano;6583;3288;3295
28;Madrid;047;Collado Villalba;61597;30056;31541
28;Madrid;043;Colmenar de Oreja;7946;4036;3910
28;Madrid;042;Colmenar del Arroyo;1632;838;794
28;Madrid;045;Colmenar Viejo;48020;23767;24253
28;Madrid;044;Colmenarejo;8945;4401;4544
28;Madrid;048;Corpa;672;350;322
28;Madrid;049;Coslada;84533;41562;42971
28;Madrid;050;Cubas de la Sagra;5971;2957;3014
28;Madrid;053;Daganzo de Arriba;9981;4999;4982
28;Madrid;054;Escorial, El;15364;7577;7787
28;Madrid;055;Estremera;1319;671;648
28;Madrid;056;Fresnedillas de la Oliva;1547;790;757
28;Madrid;057;Fresno de Torote;2044;1070;974
28;Madrid;058;Fuenlabrada;194171;96249;97922
28;Madrid;059;Fuente el Saz de Jarama;6403;3260;3143
28;Madrid;060;Fuentidueña de Tajo;1936;963;973
28;Madrid;061;Galapagar;32404;15963;16441
28;Madrid;062;Garganta de los Montes;351;187;164
28;Madrid;063;Gargantilla del Lozoya y Pinilla de Buitrago;325;180;145
28;Madrid;064;Gascones;171;99;72
28;Madrid;065;Getafe;176659;86629;90030
28;Madrid;066;Griñón;9938;4923;5015
28;Madrid;067;Guadalix de la Sierra;5982;3000;2982
28;Madrid;068;Guadarrama;15488;7639;7849
28;Madrid;069;Hiruela, La;54;36;18
28;Madrid;070;Horcajo de la Sierra-Aoslos;143;78;65
28;Madrid;071;Horcajuelo de la Sierra;86;43;43
28;Madrid;072;Hoyo de Manzanares;7965;4022;3943
28;Madrid;073;Humanes de Madrid;19563;9837;9726
28;Madrid;074;Leganés;187173;91241;95932
28;Madrid;075;Loeches;8388;4227;4161
28;Madrid;076;Lozoya;576;298;278
28;Madrid;901;Lozoyuela-Navas-Sieteiglesias;1210;637;573
28;Madrid;078;Madarcos;47;30;17
28;Madrid;079;Madrid;3165541;1472172;1693369
28;Madrid;080;Majadahonda;70755;33619;37136
28;Madrid;082;Manzanares el Real;8387;4236;4151
28;Madrid;083;Meco;13426;6763;6663
28;Madrid;084;Mejorada del Campo;22900;11441;11459
28;Madrid;085;Miraflores de la Sierra;5754;2959;2795
28;Madrid;086;Molar, El;8263;4168;4095
28;Madrid;087;Molinos, Los;4373;2166;2207
28;Madrid;088;Montejo de la Sierra;359;183;176
28;Madrid;089;Moraleja de Enmedio;4984;2481;2503
28;Madrid;090;Moralzarzal;12372;6200;6172
28;Madrid;091;Morata de Tajuña;7548;3752;3796
28;Madrid;092;Móstoles;205614;100518;105096
28;Madrid;093;Navacerrada;2885;1433;1452
28;Madrid;094;Navalafuente;1266;653;613
28;Madrid;095;Navalagamella;2423;1263;1160
28;Madrid;096;Navalcarnero;26954;13455;13499
28;Madrid;097;Navarredonda y San Mamés;132;84;48
28;Madrid;099;Navas del Rey;2659;1419;1240
28;Madrid;100;Nuevo Baztán;6018;3042;2976
28;Madrid;101;Olmeda de las Fuentes;326;171;155
28;Madrid;102;Orusco de Tajuña;1225;622;603
28;Madrid;104;Paracuellos de Jarama;23104;11718;11386
28;Madrid;106;Parla;124661;62293;62368
28;Madrid;107;Patones;537;257;280
28;Madrid;108;Pedrezuela;5456;2726;2730
28;Madrid;109;Pelayos de la Presa;2471;1243;1228
28;Madrid;110;Perales de Tajuña;2799;1401;1398
28;Madrid;111;Pezuela de las Torres;793;412;381
28;Madrid;112;Pinilla del Valle;192;108;84
28;Madrid;113;Pinto;49522;24563;24959
28;Madrid;114;Piñuécar-Gandullas;185;101;84
28;Madrid;115;Pozuelo de Alarcón;84989;40722;44267
28;Madrid;116;Pozuelo del Rey;1073;563;510
28;Madrid;117;Prádena del Rincón;134;75;59
28;Madrid;118;Puebla de la Sierra;66;40;26
28;Madrid;902;Puentes Viejas;627;351;276
28;Madrid;119;Quijorna;3239;1650;1589
28;Madrid;120;Rascafría;1692;916;776
28;Madrid;121;Redueña;261;142;119
28;Madrid;122;Ribatejada;689;351;338
28;Madrid;123;Rivas-Vaciamadrid;82715;41221;41494
28;Madrid;124;Robledillo de la Jara;99;47;52
28;Madrid;125;Robledo de Chavela;4001;2090;1911
28;Madrid;126;Robregordo;45;29;16
28;Madrid;127;Rozas de Madrid, Las;94471;45782;48689
28;Madrid;128;Rozas de Puerto Real;533;309;224
28;Madrid;129;San Agustín del Guadalix;12862;6308;6554
28;Madrid;130;San Fernando de Henares;40095;19667;20428
28;Madrid;131;San Lorenzo de El Escorial;18038;8643;9395
28;Madrid;132;San Martín de la Vega;18734;9580;9154
28;Madrid;133;San Martín de Valdeiglesias;8344;4176;4168
28;Madrid;134;San Sebastián de los Reyes;86206;42221;43985
28;Madrid;135;Santa María de la Alameda;1177;623;554
28;Madrid;136;Santorcaz;851;439;412
28;Madrid;137;Santos de la Humosa, Los;2435;1243;1192
28;Madrid;138;Serna del Monte, La;77;40;37
28;Madrid;140;Serranillos del Valle;3990;1970;2020
28;Madrid;141;Sevilla la Nueva;8905;4417;4488
28;Madrid;143;Somosierra;77;43;34
28;Madrid;144;Soto del Real;8483;4150;4333
28;Madrid;145;Talamanca de Jarama;3451;1718;1733
28;Madrid;146;Tielmes;2620;1333;1287
28;Madrid;147;Titulcia;1258;644;614
28;Madrid;148;Torrejón de Ardoz;126981;62757;64224
28;Madrid;149;Torrejón de la Calzada;8171;4039;4132
28;Madrid;150;Torrejón de Velasco;4243;2125;2118
28;Madrid;151;Torrelaguna;4697;2382;2315
28;Madrid;152;Torrelodones;23123;11142;11981
28;Madrid;153;Torremocha de Jarama;906;457;449
28;Madrid;154;Torres de la Alameda;7769;3956;3813
28;Madrid;903;Tres Cantos;44764;21764;23000
28;Madrid;155;Valdaracete;641;330;311
28;Madrid;156;Valdeavero;1407;739;668
28;Madrid;157;Valdelaguna;841;422;419
28;Madrid;158;Valdemanco;911;481;430
28;Madrid;159;Valdemaqueda;779;388;391
28;Madrid;160;Valdemorillo;12168;6205;5963
28;Madrid;161;Valdemoro;72988;36244;36744
28;Madrid;162;Valdeolmos-Alalpardo;3880;1965;1915
28;Madrid;163;Valdepiélagos;574;303;271
28;Madrid;164;Valdetorres de Jarama;4260;2145;2115
28;Madrid;165;Valdilecha;2749;1415;1334
28;Madrid;166;Valverde de Alcalá;430;230;200
28;Madrid;167;Velilla de San Antonio;12222;6159;6063
28;Madrid;168;Vellón, El;1846;968;878
28;Madrid;169;Venturada;2014;1067;947
28;Madrid;171;Villa del Prado;6295;3198;3097
28;Madrid;170;Villaconejos;3350;1703;1647
28;Madrid;172;Villalbilla;12719;6442;6277
28;Madrid;173;Villamanrique de Tajo;705;360;345
28;Madrid;174;Villamanta;2497;1267;1230
28;Madrid;175;Villamantilla;1334;670;664
28;Madrid;176;Villanueva de la Cañada;19611;9553;10058
28;Madrid;178;Villanueva de Perales;1486;755;731
28;Madrid;177;Villanueva del Pardillo;16950;8302;8648
28;Madrid;179;Villar del Olmo;1981;1014;967
28;Madrid;180;Villarejo de Salvanés;7265;3665;3600
28;Madrid;181;Villaviciosa de Odón;27276;13224;14052
28;Madrid;182;Villavieja del Lozoya;270;148;122
28;Madrid;183;Zarzalejo;1565;822;743
29;Málaga;001;Alameda;5390;2730;2660
29;Málaga;002;Alcaucín;2272;1166;1106
29;Málaga;003;Alfarnate;1135;584;551
29;Málaga;004;Alfarnatejo;405;207;198
29;Málaga;005;Algarrobo;6232;3136;3096
29;Málaga;006;Algatocín;795;409;386
29;Málaga;007;Alhaurín de la Torre;38794;19309;19485
29;Málaga;008;Alhaurín el Grande;24315;12157;12158
29;Málaga;009;Almáchar;1835;945;890
29;Málaga;010;Almargen;2046;1046;1000
29;Málaga;011;Almogía;3786;1940;1846
29;Málaga;012;Álora;12941;6528;6413
29;Málaga;013;Alozaina;2030;1023;1007
29;Málaga;014;Alpandeire;246;125;121
29;Málaga;015;Antequera;41065;20192;20873
29;Málaga;016;Árchez;428;215;213
29;Málaga;017;Archidona;8499;4330;4169
29;Málaga;018;Ardales;2507;1271;1236
29;Málaga;019;Arenas;1205;627;578
29;Málaga;020;Arriate;4114;2029;2085
29;Málaga;021;Atajate;171;90;81
29;Málaga;022;Benadalid;232;117;115
29;Málaga;023;Benahavís;7342;3686;3656
29;Málaga;024;Benalauría;456;241;215
29;Málaga;025;Benalmádena;67245;33273;33972
29;Málaga;026;Benamargosa;1558;802;756
29;Málaga;027;Benamocarra;2999;1514;1485
29;Málaga;028;Benaoján;1491;777;714
29;Málaga;029;Benarrabá;493;248;245
29;Málaga;030;Borge, El;960;498;462
29;Málaga;031;Burgo, El;1871;950;921
29;Málaga;032;Campillos;8511;4268;4243
29;Málaga;033;Canillas de Aceituno;1710;908;802
29;Málaga;034;Canillas de Albaida;773;387;386
29;Málaga;035;Cañete la Real;1710;862;848
29;Málaga;036;Carratraca;750;383;367
29;Málaga;037;Cartajima;241;126;115
29;Málaga;038;Cártama;24824;12568;12256
29;Málaga;039;Casabermeja;3443;1818;1625
29;Málaga;040;Casarabonela;2573;1363;1210
29;Málaga;041;Casares;5795;2977;2818
29;Málaga;042;Coín;21456;10790;10666
29;Málaga;043;Colmenar;3385;1743;1642
29;Málaga;044;Comares;1348;730;618
29;Málaga;045;Cómpeta;3705;1872;1833
29;Málaga;046;Cortes de la Frontera;3277;1684;1593
29;Málaga;047;Cuevas Bajas;1430;711;719
29;Málaga;049;Cuevas de San Marcos;3776;1902;1874
29;Málaga;048;Cuevas del Becerro;1618;798;820
29;Málaga;050;Cútar;598;302;296
29;Málaga;051;Estepona;66683;32955;33728
29;Málaga;052;Faraján;265;131;134
29;Málaga;053;Frigiliana;3039;1530;1509
29;Málaga;054;Fuengirola;77486;38004;39482
29;Málaga;055;Fuente de Piedra;2525;1300;1225
29;Málaga;056;Gaucín;1620;847;773
29;Málaga;057;Genalguacil;424;219;205
29;Málaga;058;Guaro;2047;1041;1006
29;Málaga;059;Humilladero;3311;1658;1653
29;Málaga;060;Igualeja;793;407;386
29;Málaga;061;Istán;1399;705;694
29;Málaga;062;Iznate;874;448;426
29;Málaga;063;Jimera de Líbar;409;212;197
29;Málaga;064;Jubrique;634;320;314
29;Málaga;065;Júzcar;228;131;97
29;Málaga;066;Macharaviaya;461;248;213
29;Málaga;067;Málaga;569009;273715;295294
29;Málaga;068;Manilva;14750;7560;7190
29;Málaga;069;Marbella;140744;68050;72694
29;Málaga;070;Mijas;77769;38923;38846
29;Málaga;071;Moclinejo;1217;634;583
29;Málaga;072;Mollina;4913;2461;2452
29;Málaga;073;Monda;2400;1221;1179
29;Málaga;903;Montecorto;640;331;309
29;Málaga;074;Montejaque;1011;497;514
29;Málaga;075;Nerja;21204;10488;10716
29;Málaga;076;Ojén;3385;1716;1669
29;Málaga;077;Parauta;230;112;118
29;Málaga;079;Periana;3149;1647;1502
29;Málaga;080;Pizarra;9106;4608;4498
29;Málaga;081;Pujerra;305;157;148
29;Málaga;082;Rincón de la Victoria;44003;21614;22389
29;Málaga;083;Riogordo;2812;1469;1343
29;Málaga;084;Ronda;34381;16762;17619
29;Málaga;085;Salares;181;93;88
29;Málaga;086;Sayalonga;1628;841;787
29;Málaga;087;Sedella;625;354;271
29;Málaga;904;Serrato;503;253;250
29;Málaga;088;Sierra de Yeguas;3370;1693;1677
29;Málaga;089;Teba;3912;1973;1939
29;Málaga;090;Tolox;2093;1054;1039
29;Málaga;901;Torremolinos;67786;33870;33916
29;Málaga;091;Torrox;15098;7708;7390
29;Málaga;092;Totalán;707;370;337
29;Málaga;093;Valle de Abdalajís;2603;1320;1283
29;Málaga;094;Vélez-Málaga;78890;39114;39776
29;Málaga;095;Villanueva de Algaidas;4325;2233;2092
29;Málaga;902;Villanueva de la Concepción;3304;1610;1694
29;Málaga;098;Villanueva de Tapia;1531;776;755
29;Málaga;096;Villanueva del Rosario;3465;1692;1773
29;Málaga;097;Villanueva del Trabuco;5313;2657;2656
29;Málaga;099;Viñuela;2009;1035;974
29;Málaga;100;Yunquera;2948;1506;1442
30;Murcia;001;Abanilla;6184;3143;3041
30;Murcia;002;Abarán;13183;6640;6543
30;Murcia;003;Águilas;34706;17348;17358
30;Murcia;004;Albudeite;1378;697;681
30;Murcia;005;Alcantarilla;41155;20305;20850
30;Murcia;902;Alcázares, Los;15289;7725;7564
30;Murcia;006;Aledo;941;466;475
30;Murcia;007;Alguazas;9613;4986;4627
30;Murcia;008;Alhama de Murcia;21308;10786;10522
30;Murcia;009;Archena;18734;9758;8976
30;Murcia;010;Beniel;11114;5707;5407
30;Murcia;011;Blanca;6521;3322;3199
30;Murcia;012;Bullas;11714;5907;5807
30;Murcia;013;Calasparra;10268;5231;5037
30;Murcia;014;Campos del Río;2003;957;1046
30;Murcia;015;Caravaca de la Cruz;25591;12803;12788
30;Murcia;016;Cartagena;214759;107344;107415
30;Murcia;017;Cehegín;15321;7685;7636
30;Murcia;018;Ceutí;11321;5682;5639
30;Murcia;019;Cieza;35134;17689;17445
30;Murcia;020;Fortuna;9960;5325;4635
30;Murcia;021;Fuente Álamo de Murcia;16205;8427;7778
30;Murcia;022;Jumilla;25362;13174;12188
30;Murcia;023;Librilla;5107;2607;2500
30;Murcia;024;Lorca;91730;46949;44781
30;Murcia;025;Lorquí;6969;3536;3433
30;Murcia;026;Mazarrón;30704;15835;14869
30;Murcia;027;Molina de Segura;69614;34700;34914
30;Murcia;028;Moratalla;8145;4153;3992
30;Murcia;029;Mula;16689;8526;8163
30;Murcia;030;Murcia;441003;215535;225468
30;Murcia;031;Ojós;497;266;231
30;Murcia;032;Pliego;3933;2031;1902
30;Murcia;033;Puerto Lumbreras;14874;7457;7417
30;Murcia;034;Ricote;1332;701;631
30;Murcia;035;San Javier;31782;16030;15752
30;Murcia;036;San Pedro del Pinatar;24660;12441;12219
30;Murcia;901;Santomera;15952;8081;7871
30;Murcia;037;Torre-Pacheco;34630;18039;16591
30;Murcia;038;Torres de Cotillas, Las;21341;10809;10532
30;Murcia;039;Totana;30981;15962;15019
30;Murcia;040;Ulea;913;476;437
30;Murcia;041;Unión, La;19630;9966;9664
30;Murcia;042;Villanueva del Río Segura;2560;1284;1276
30;Murcia;043;Yecla;34037;17064;16973
31;Navarra;001;Abáigar;90;50;40
31;Navarra;002;Abárzuza/Abartzuza;532;266;266
31;Navarra;003;Abaurregaina/Abaurrea Alta;127;78;49
31;Navarra;004;Abaurrepea/Abaurrea Baja;35;22;13
31;Navarra;005;Aberin;376;203;173
31;Navarra;006;Ablitas;2494;1270;1224
31;Navarra;007;Adiós;155;86;69
31;Navarra;008;Aguilar de Codés;78;42;36
31;Navarra;009;Aibar/Oibar;802;427;375
31;Navarra;011;Allín/Allin;854;461;393
31;Navarra;012;Allo;1003;505;498
31;Navarra;010;Altsasu/Alsasua;7471;3773;3698
31;Navarra;013;Améscoa Baja;764;403;361
31;Navarra;014;Ancín/Antzin;362;199;163
31;Navarra;015;Andosilla;2772;1417;1355
31;Navarra;016;Ansoáin/Antsoain;10817;5346;5471
31;Navarra;017;Anue;473;256;217
31;Navarra;018;Añorbe;537;292;245
31;Navarra;019;Aoiz/Agoitz;2564;1284;1280
31;Navarra;020;Araitz;529;296;233
31;Navarra;025;Arakil;952;490;462
31;Navarra;021;Aranarache/Aranaratxe;71;41;30
31;Navarra;023;Aranguren;9801;4949;4852
31;Navarra;024;Arano;109;61;48
31;Navarra;022;Arantza;631;339;292
31;Navarra;026;Aras;168;91;77
31;Navarra;027;Arbizu;1117;569;548
31;Navarra;028;Arce/Artzi;260;138;122
31;Navarra;029;Arcos, Los;1119;555;564
31;Navarra;030;Arellano;163;89;74
31;Navarra;031;Areso;263;136;127
31;Navarra;032;Arguedas;2277;1171;1106
31;Navarra;033;Aria;52;31;21
31;Navarra;034;Aribe;42;21;21
31;Navarra;035;Armañanzas;64;37;27
31;Navarra;036;Arróniz;1045;551;494
31;Navarra;037;Arruazu;106;57;49
31;Navarra;038;Artajona;1670;860;810
31;Navarra;039;Artazu;105;54;51
31;Navarra;040;Atez/Atetz;235;134;101
31;Navarra;058;Auritz/Burguete;243;124;119
31;Navarra;041;Ayegui/Aiegi;2241;1171;1070
31;Navarra;042;Azagra;3818;1952;1866
31;Navarra;043;Azuelo;37;15;22
31;Navarra;044;Bakaiku;349;183;166
31;Navarra;901;Barañain;20325;9859;10466
31;Navarra;045;Barásoain;660;349;311
31;Navarra;046;Barbarin;62;30;32
31;Navarra;047;Bargota;284;140;144
31;Navarra;048;Barillas;221;122;99
31;Navarra;049;Basaburua;850;489;361
31;Navarra;050;Baztan;7719;3906;3813
31;Navarra;137;Beintza-Labaien;235;136;99
31;Navarra;051;Beire;301;153;148
31;Navarra;052;Belascoáin;124;65;59
31;Navarra;250;Bera;3765;1880;1885
31;Navarra;053;Berbinzana;629;325;304
31;Navarra;905;Beriáin;3890;1898;1992
31;Navarra;902;Berrioplano/Berriobeiti;6731;3414;3317
31;Navarra;903;Berriozar;9756;4973;4783
31;Navarra;054;Bertizarana;600;305;295
31;Navarra;055;Betelu;345;182;163
31;Navarra;253;Bidaurreta;166;91;75
31;Navarra;056;Biurrun-Olcoz;216;121;95
31;Navarra;057;Buñuel;2258;1098;1160
31;Navarra;059;Burgui/Burgi;216;125;91
31;Navarra;060;Burlada/Burlata;18338;8905;9433
31;Navarra;061;Busto, El;63;32;31
31;Navarra;062;Cabanillas;1393;731;662
31;Navarra;063;Cabredo;107;60;47
31;Navarra;064;Cadreita;2066;1095;971
31;Navarra;065;Caparroso;2677;1385;1292
31;Navarra;066;Cárcar;1049;534;515
31;Navarra;067;Carcastillo;2476;1251;1225
31;Navarra;068;Cascante;3772;1861;1911
31;Navarra;069;Cáseda;969;475;494
31;Navarra;070;Castejón;4093;2043;2050
31;Navarra;071;Castillonuevo;17;13;4
31;Navarra;193;Cendea de Olza/Oltza Zendea;1833;919;914
31;Navarra;072;Cintruénigo;7779;3993;3786
31;Navarra;074;Cirauqui/Zirauki;476;256;220
31;Navarra;075;Ciriza/Ziritza;137;64;73
31;Navarra;076;Cizur;3761;1922;1839
31;Navarra;077;Corella;7642;3882;3760
31;Navarra;078;Cortes;3163;1601;1562
31;Navarra;079;Desojo;80;44;36
31;Navarra;080;Dicastillo;624;327;297
31;Navarra;081;Donamaria;453;226;227
31;Navarra;221;Doneztebe/Santesteban;1700;870;830
31;Navarra;083;Echarri;77;39;38
31;Navarra;087;Elgorriaga;212;103;109
31;Navarra;089;Enériz/Eneritz;318;159;159
31;Navarra;090;Eratsun;151;91;60
31;Navarra;091;Ergoiena;399;216;183
31;Navarra;092;Erro;789;443;346
31;Navarra;094;Eslava;120;61;59
31;Navarra;095;Esparza de Salazar/Espartza Zaraitzu;82;44;38
31;Navarra;096;Espronceda;117;68;49
31;Navarra;097;Estella-Lizarra;13668;6571;7097
31;Navarra;098;Esteribar;2590;1344;1246
31;Navarra;099;Etayo;76;41;35
31;Navarra;082;Etxalar;804;434;370
31;Navarra;084;Etxarri Aranatz;2456;1277;1179
31;Navarra;085;Etxauri;603;318;285
31;Navarra;100;Eulate;297;164;133
31;Navarra;101;Ezcabarte;1815;953;862
31;Navarra;093;Ezcároz/Ezkaroze;319;173;146
31;Navarra;102;Ezkurra;149;98;51
31;Navarra;103;Ezprogui;48;24;24
31;Navarra;104;Falces;2335;1174;1161
31;Navarra;105;Fitero;1996;1002;994
31;Navarra;106;Fontellas;973;494;479
31;Navarra;107;Funes;2461;1318;1143
31;Navarra;108;Fustiñana;2501;1239;1262
31;Navarra;109;Galar;2146;1129;1017
31;Navarra;110;Gallipienzo/Galipentzu;104;59;45
31;Navarra;111;Gallués/Galoze;107;67;40
31;Navarra;112;Garaioa;94;52;42
31;Navarra;113;Garde;150;92;58
31;Navarra;114;Garínoain;479;259;220
31;Navarra;115;Garralda;181;96;85
31;Navarra;116;Genevilla;73;43;30
31;Navarra;117;Goizueta;720;389;331
31;Navarra;118;Goñi;164;105;59
31;Navarra;119;Güesa/Gorza;43;24;19
31;Navarra;120;Guesálaz/Gesalatz;444;260;184
31;Navarra;121;Guirguillano;75;39;36
31;Navarra;256;Hiriberri/Villanueva de Aezkoa;115;62;53
31;Navarra;122;Huarte/Uharte;6895;3472;3423
31;Navarra;124;Ibargoiti;248;147;101
31;Navarra;259;Igantzi;606;318;288
31;Navarra;125;Igúzquiza;333;171;162
31;Navarra;126;Imotz;433;230;203
31;Navarra;127;Irañeta;176;97;79
31;Navarra;904;Irurtzun;2187;1125;1062
31;Navarra;128;Isaba/Izaba;439;214;225
31;Navarra;129;Ituren;525;271;254
31;Navarra;130;Iturmendi;398;206;192
31;Navarra;131;Iza/Itza;1213;642;571
31;Navarra;132;Izagaondoa;176;114;62
31;Navarra;133;Izalzu/Itzaltzu;50;30;20
31;Navarra;134;Jaurrieta;196;109;87
31;Navarra;135;Javier;107;37;70
31;Navarra;136;Juslapeña;561;298;263
31;Navarra;138;Lakuntza;1263;658;605
31;Navarra;139;Lana;174;100;74
31;Navarra;140;Lantz;153;89;64
31;Navarra;141;Lapoblación;125;70;55
31;Navarra;142;Larraga;2068;1105;963
31;Navarra;143;Larraona;110;54;56
31;Navarra;144;Larraun;985;536;449
31;Navarra;145;Lazagurría;204;102;102
31;Navarra;146;Leache/Leatxe;40;25;15
31;Navarra;147;Legarda;110;60;50
31;Navarra;148;Legaria;103;43;60
31;Navarra;149;Leitza;2857;1496;1361
31;Navarra;908;Lekunberri;1452;721;731
31;Navarra;150;Leoz/Leotz;243;153;90
31;Navarra;151;Lerga;73;42;31
31;Navarra;152;Lerín;1673;853;820
31;Navarra;153;Lesaka;2733;1407;1326
31;Navarra;154;Lezáun;262;152;110
31;Navarra;155;Liédena;303;157;146
31;Navarra;156;Lizoáin-Arriasgoiti;305;181;124
31;Navarra;157;Lodosa;4738;2392;2346
31;Navarra;158;Lónguida/Longida;309;164;145
31;Navarra;159;Lumbier;1318;702;616
31;Navarra;160;Luquin;130;69;61
31;Navarra;248;Luzaide/Valcarlos;390;231;159
31;Navarra;161;Mañeru;419;221;198
31;Navarra;162;Marañón;53;26;27
31;Navarra;163;Marcilla;2821;1411;1410
31;Navarra;164;Mélida;728;379;349
31;Navarra;165;Mendavia;3612;1853;1759
31;Navarra;166;Mendaza;308;160;148
31;Navarra;167;Mendigorría;1053;549;504
31;Navarra;168;Metauten;300;168;132
31;Navarra;169;Milagro;3289;1725;1564
31;Navarra;170;Mirafuentes;56;25;31
31;Navarra;171;Miranda de Arga;845;446;399
31;Navarra;172;Monreal/Elo;480;257;223
31;Navarra;173;Monteagudo;1073;538;535
31;Navarra;174;Morentin;133;68;65
31;Navarra;175;Mues;84;44;40
31;Navarra;176;Murchante;3906;1947;1959
31;Navarra;177;Murieta;335;181;154
31;Navarra;178;Murillo el Cuende;670;347;323
31;Navarra;179;Murillo el Fruto;614;314;300
31;Navarra;180;Muruzábal;257;112;145
31;Navarra;181;Navascués/Nabaskoze;147;85;62
31;Navarra;182;Nazar;43;25;18
31;Navarra;088;Noáin (Valle de Elorz)/Noain (Elortzibar);8012;4029;3983
31;Navarra;183;Obanos;923;458;465
31;Navarra;185;Ochagavía/Otsagabia;543;282;261
31;Navarra;184;Oco;76;39;37
31;Navarra;186;Odieta;368;202;166
31;Navarra;187;Oiz;146;86;60
31;Navarra;188;Olaibar;334;189;145
31;Navarra;189;Olazti/Olazagutía;1522;786;736
31;Navarra;190;Olejua;52;29;23
31;Navarra;191;Olite/Erriberri;3915;1967;1948
31;Navarra;194;Ollo;406;218;188
31;Navarra;192;Olóriz/Oloritz;200;113;87
31;Navarra;195;Orbaizeta;205;102;103
31;Navarra;196;Orbara;40;21;19
31;Navarra;197;Orísoain;90;48;42
31;Navarra;906;Orkoien;3802;1904;1898
31;Navarra;198;Oronz/Orontze;46;25;21
31;Navarra;199;Oroz-Betelu/Orotz-Betelu;153;88;65
31;Navarra;211;Orreaga/Roncesvalles;34;18;16
31;Navarra;200;Oteiza;939;497;442
31;Navarra;201;Pamplona/Iruña;195650;92949;102701
31;Navarra;202;Peralta/Azkoien;5837;2926;2911
31;Navarra;203;Petilla de Aragón;35;20;15
31;Navarra;204;Piedramillera;37;24;13
31;Navarra;205;Pitillas;494;246;248
31;Navarra;206;Puente la Reina/Gares;2807;1436;1371
31;Navarra;207;Pueyo;339;183;156
31;Navarra;208;Ribaforada;3704;1905;1799
31;Navarra;209;Romanzado;184;100;84
31;Navarra;210;Roncal/Erronkari;210;113;97
31;Navarra;212;Sada;155;84;71
31;Navarra;213;Saldías;115;68;47
31;Navarra;214;Salinas de Oro/Jaitz;117;65;52
31;Navarra;215;San Adrián;6225;3086;3139
31;Navarra;217;San Martín de Unx;370;191;179
31;Navarra;216;Sangüesa/Zangoza;5002;2543;2459
31;Navarra;219;Sansol;103;55;48
31;Navarra;220;Santacara;895;465;430
31;Navarra;222;Sarriés/Sartze;63;40;23
31;Navarra;223;Sartaguda;1362;699;663
31;Navarra;224;Sesma;1164;592;572
31;Navarra;225;Sorlada;54;30;24
31;Navarra;226;Sunbilla;670;346;324
31;Navarra;227;Tafalla;10660;5260;5400
31;Navarra;228;Tiebas-Muruarte de Reta;609;310;299
31;Navarra;229;Tirapu;51;31;20
31;Navarra;230;Torralba del Río;115;61;54
31;Navarra;231;Torres del Río;131;63;68
31;Navarra;232;Tudela;35170;17297;17873
31;Navarra;233;Tulebras;126;58;68
31;Navarra;234;Ucar;175;98;77
31;Navarra;123;Uharte Arakil;834;438;396
31;Navarra;235;Ujué;178;104;74
31;Navarra;236;Ultzama;1667;868;799
31;Navarra;237;Unciti;220;128;92
31;Navarra;238;Unzué/Untzue;129;72;57
31;Navarra;239;Urdazubi/Urdax;399;194;205
31;Navarra;240;Urdiain;671;356;315
31;Navarra;241;Urraul Alto;156;97;59
31;Navarra;242;Urraul Bajo;303;135;168
31;Navarra;244;Urroz;188;105;83
31;Navarra;243;Urroz-Villa;389;204;185
31;Navarra;245;Urzainqui/Urzainki;92;54;38
31;Navarra;246;Uterga;163;95;68
31;Navarra;247;Uztárroz/Uztarroze;148;72;76
31;Navarra;086;Valle de Egüés/Eguesibar;20046;10123;9923
31;Navarra;260;Valle de Yerri/Deierri;1510;776;734
31;Navarra;249;Valtierra;2414;1192;1222
31;Navarra;251;Viana;4025;2047;1978
31;Navarra;252;Vidángoz/Bidankoze;93;50;43
31;Navarra;254;Villafranca;2849;1424;1425
31;Navarra;255;Villamayor de Monjardín;121;64;57
31;Navarra;257;Villatuerta;1154;579;575
31;Navarra;258;Villava/Atarrabia;10317;5056;5261
31;Navarra;261;Yesa;298;170;128
31;Navarra;262;Zabalza/Zabaltza;289;155;134
31;Navarra;073;Ziordia;354;184;170
31;Navarra;907;Zizur Mayor/Zizur Nagusia;14612;7207;7405
31;Navarra;263;Zubieta;311;163;148
31;Navarra;264;Zugarramurdi;237;121;116
31;Navarra;265;Zúñiga;110;69;41
32;Ourense;001;Allariz;5982;2976;3006
32;Ourense;002;Amoeiro;2264;1121;1143
32;Ourense;003;Arnoia, A;1002;499;503
32;Ourense;004;Avión;1910;886;1024
32;Ourense;005;Baltar;986;520;466
32;Ourense;006;Bande;1668;813;855
32;Ourense;007;Baños de Molgas;1648;816;832
32;Ourense;008;Barbadás;10638;5184;5454
32;Ourense;009;Barco de Valdeorras, O;13761;6692;7069
32;Ourense;010;Beade;427;229;198
32;Ourense;011;Beariz;1003;440;563
32;Ourense;012;Blancos, Os;850;466;384
32;Ourense;013;Boborás;2443;1136;1307
32;Ourense;014;Bola, A;1270;601;669
32;Ourense;015;Bolo, O;963;486;477
32;Ourense;016;Calvos de Randín;856;413;443
32;Ourense;018;Carballeda de Avia;1381;675;706
32;Ourense;017;Carballeda de Valdeorras;1664;858;806
32;Ourense;019;Carballiño, O;13913;6531;7382
32;Ourense;020;Cartelle;2757;1341;1416
32;Ourense;022;Castrelo de Miño;1490;752;738
32;Ourense;021;Castrelo do Val;1067;547;520
32;Ourense;023;Castro Caldelas;1313;664;649
32;Ourense;024;Celanova;5508;2626;2882
32;Ourense;025;Cenlle;1196;576;620
32;Ourense;029;Chandrexa de Queixa;506;283;223
32;Ourense;026;Coles;3126;1570;1556
32;Ourense;027;Cortegada;1151;561;590
32;Ourense;028;Cualedro;1792;911;881
32;Ourense;030;Entrimo;1209;574;635
32;Ourense;031;Esgos;1194;600;594
32;Ourense;033;Gomesende;798;381;417
32;Ourense;034;Gudiña, A;1345;699;646
32;Ourense;035;Irixo, O;1546;738;808
32;Ourense;038;Larouco;487;229;258
32;Ourense;039;Laza;1377;713;664
32;Ourense;040;Leiro;1642;800;842
32;Ourense;041;Lobeira;809;392;417
32;Ourense;042;Lobios;1868;940;928
32;Ourense;043;Maceda;2938;1444;1494
32;Ourense;044;Manzaneda;947;467;480
32;Ourense;045;Maside;2818;1373;1445
32;Ourense;046;Melón;1280;613;667
32;Ourense;047;Merca, A;1976;966;1010
32;Ourense;048;Mezquita, A;1070;557;513
32;Ourense;049;Montederramo;791;402;389
32;Ourense;050;Monterrei;2713;1383;1330
32;Ourense;051;Muíños;1572;794;778
32;Ourense;052;Nogueira de Ramuín;2075;1045;1030
32;Ourense;053;Oímbra;1894;1040;854
32;Ourense;054;Ourense;105893;48295;57598
32;Ourense;055;Paderne de Allariz;1439;703;736
32;Ourense;056;Padrenda;1893;910;983
32;Ourense;057;Parada de Sil;592;321;271
32;Ourense;058;Pereiro de Aguiar, O;6255;3220;3035
32;Ourense;059;Peroxa, A;1948;961;987
32;Ourense;060;Petín;957;473;484
32;Ourense;061;Piñor;1212;605;607
32;Ourense;063;Pobra de Trives, A;2191;1094;1097
32;Ourense;064;Pontedeva;588;291;297
32;Ourense;062;Porqueira;859;419;440
32;Ourense;065;Punxín;729;354;375
32;Ourense;066;Quintela de Leirado;616;275;341
32;Ourense;067;Rairiz de Veiga;1394;710;684
32;Ourense;068;Ramirás;1571;718;853
32;Ourense;069;Ribadavia;5068;2454;2614
32;Ourense;071;Riós;1646;826;820
32;Ourense;072;Rúa, A;4530;2228;2302
32;Ourense;073;Rubiá;1448;709;739
32;Ourense;074;San Amaro;1141;551;590
32;Ourense;075;San Cibrao das Viñas;5113;2596;2517
32;Ourense;076;San Cristovo de Cea;2303;1136;1167
32;Ourense;070;San Xoán de Río;583;276;307
32;Ourense;077;Sandiás;1286;595;691
32;Ourense;078;Sarreaus;1259;636;623
32;Ourense;079;Taboadela;1475;757;718
32;Ourense;080;Teixeira, A;368;185;183
32;Ourense;081;Toén;2395;1228;1167
32;Ourense;082;Trasmiras;1365;685;680
32;Ourense;083;Veiga, A;923;466;457
32;Ourense;084;Verea;983;476;507
32;Ourense;085;Verín;14031;6775;7256
32;Ourense;086;Viana do Bolo;2982;1497;1485
32;Ourense;087;Vilamarín;1996;1010;986
32;Ourense;088;Vilamartín de Valdeorras;1798;928;870
32;Ourense;089;Vilar de Barrio;1394;709;685
32;Ourense;090;Vilar de Santos;858;417;441
32;Ourense;091;Vilardevós;2036;1060;976
32;Ourense;092;Vilariño de Conso;586;333;253
32;Ourense;032;Xinzo de Limia;10004;4882;5122
32;Ourense;036;Xunqueira de Ambía;1461;743;718
32;Ourense;037;Xunqueira de Espadanedo;800;396;404
34;Palencia;001;Abarca de Campos;36;23;13
34;Palencia;003;Abia de las Torres;181;100;81
34;Palencia;004;Aguilar de Campoo;6979;3394;3585
34;Palencia;005;Alar del Rey;982;484;498
34;Palencia;006;Alba de Cerrato;83;46;37
34;Palencia;009;Amayuelas de Arriba;39;25;14
34;Palencia;010;Ampudia;651;339;312
34;Palencia;011;Amusco;439;240;199
34;Palencia;012;Antigüedad;384;206;178
34;Palencia;015;Arconada;44;25;19
34;Palencia;017;Astudillo;1004;508;496
34;Palencia;018;Autilla del Pino;231;125;106
34;Palencia;019;Autillo de Campos;146;72;74
34;Palencia;020;Ayuela;54;33;21
34;Palencia;022;Baltanás;1248;656;592
34;Palencia;024;Baquerín de Campos;40;28;12
34;Palencia;025;Bárcena de Campos;62;29;33
34;Palencia;027;Barruelo de Santullán;1235;610;625
34;Palencia;028;Báscones de Ojeda;147;80;67
34;Palencia;029;Becerril de Campos;792;410;382
34;Palencia;031;Belmonte de Campos;32;17;15
34;Palencia;032;Berzosilla;43;23;20
34;Palencia;033;Boada de Campos;18;12;6
34;Palencia;035;Boadilla de Rioseco;122;68;54
34;Palencia;034;Boadilla del Camino;123;68;55
34;Palencia;036;Brañosera;245;141;104
34;Palencia;037;Buenavista de Valdavia;296;163;133
34;Palencia;038;Bustillo de la Vega;313;171;142
34;Palencia;039;Bustillo del Páramo de Carrión;63;37;26
34;Palencia;041;Calahorra de Boedo;94;47;47
34;Palencia;042;Calzada de los Molinos;340;188;152
34;Palencia;045;Capillas;78;40;38
34;Palencia;046;Cardeñosa de Volpejera;44;24;20
34;Palencia;047;Carrión de los Condes;2150;1029;1121
34;Palencia;048;Castil de Vela;69;36;33
34;Palencia;049;Castrejón de la Peña;387;212;175
34;Palencia;050;Castrillo de Don Juan;235;129;106
34;Palencia;051;Castrillo de Onielo;109;58;51
34;Palencia;052;Castrillo de Villavega;192;105;87
34;Palencia;053;Castromocho;226;123;103
34;Palencia;055;Cervatos de la Cueza;287;164;123
34;Palencia;056;Cervera de Pisuerga;2399;1194;1205
34;Palencia;057;Cevico de la Torre;503;252;251
34;Palencia;058;Cevico Navero;202;112;90
34;Palencia;059;Cisneros;459;228;231
34;Palencia;060;Cobos de Cerrato;142;79;63
34;Palencia;061;Collazos de Boedo;112;60;52
34;Palencia;062;Congosto de Valdavia;180;110;70
34;Palencia;063;Cordovilla la Real;99;59;40
34;Palencia;066;Cubillas de Cerrato;62;35;27
34;Palencia;067;Dehesa de Montejo;136;78;58
34;Palencia;068;Dehesa de Romanos;40;25;15
34;Palencia;069;Dueñas;2697;1370;1327
34;Palencia;070;Espinosa de Cerrato;171;85;86
34;Palencia;071;Espinosa de Villagonzalo;195;103;92
34;Palencia;072;Frechilla;162;79;83
34;Palencia;073;Fresno del Río;194;95;99
34;Palencia;074;Frómista;804;411;393
34;Palencia;076;Fuentes de Nava;676;347;329
34;Palencia;077;Fuentes de Valdepero;423;219;204
34;Palencia;079;Grijota;2177;1125;1052
34;Palencia;080;Guardo;6413;3200;3213
34;Palencia;081;Guaza de Campos;61;36;25
34;Palencia;082;Hérmedes de Cerrato;84;46;38
34;Palencia;083;Herrera de Pisuerga;2118;1040;1078
34;Palencia;084;Herrera de Valdecañas;145;79;66
34;Palencia;086;Hontoria de Cerrato;107;55;52
34;Palencia;087;Hornillos de Cerrato;137;72;65
34;Palencia;088;Husillos;286;154;132
34;Palencia;089;Itero de la Vega;171;95;76
34;Palencia;091;Lagartos;137;78;59
34;Palencia;092;Lantadilla;319;173;146
34;Palencia;094;Ledigos;66;37;29
34;Palencia;903;Loma de Ucieza;226;132;94
34;Palencia;096;Lomas;55;35;20
34;Palencia;098;Magaz de Pisuerga;966;507;459
34;Palencia;099;Manquillos;75;39;36
34;Palencia;100;Mantinos;159;87;72
34;Palencia;101;Marcilla de Campos;40;19;21
34;Palencia;102;Mazariegos;214;123;91
34;Palencia;103;Mazuecos de Valdeginate;101;59;42
34;Palencia;104;Melgar de Yuso;265;155;110
34;Palencia;106;Meneses de Campos;116;61;55
34;Palencia;107;Micieces de Ojeda;84;48;36
34;Palencia;108;Monzón de Campos;630;325;305
34;Palencia;109;Moratinos;61;37;24
34;Palencia;110;Mudá;99;51;48
34;Palencia;112;Nogal de las Huertas;50;30;20
34;Palencia;113;Olea de Boedo;38;14;24
34;Palencia;114;Olmos de Ojeda;203;124;79
34;Palencia;116;Osornillo;60;30;30
34;Palencia;901;Osorno la Mayor;1266;662;604
34;Palencia;120;Palencia;79137;37350;41787
34;Palencia;121;Palenzuela;207;112;95
34;Palencia;122;Páramo de Boedo;99;53;46
34;Palencia;123;Paredes de Nava;1932;990;942
34;Palencia;124;Payo de Ojeda;62;38;24
34;Palencia;125;Pedraza de Campos;92;47;45
34;Palencia;126;Pedrosa de la Vega;342;186;156
34;Palencia;127;Perales;97;51;46
34;Palencia;904;Pernía, La;340;196;144
34;Palencia;129;Pino del Río;189;118;71
34;Palencia;130;Piña de Campos;228;117;111
34;Palencia;131;Población de Arroyo;61;33;28
34;Palencia;132;Población de Campos;137;78;59
34;Palencia;133;Población de Cerrato;120;66;54
34;Palencia;134;Polentinos;54;30;24
34;Palencia;135;Pomar de Valdivia;463;259;204
34;Palencia;136;Poza de la Vega;215;121;94
34;Palencia;137;Pozo de Urama;28;18;10
34;Palencia;139;Prádanos de Ojeda;191;104;87
34;Palencia;140;Puebla de Valdavia, La;108;55;53
34;Palencia;141;Quintana del Puente;270;148;122
34;Palencia;143;Quintanilla de Onsoña;185;106;79
34;Palencia;146;Reinoso de Cerrato;51;33;18
34;Palencia;147;Renedo de la Vega;201;107;94
34;Palencia;149;Requena de Campos;21;12;9
34;Palencia;151;Respenda de la Peña;171;99;72
34;Palencia;152;Revenga de Campos;161;85;76
34;Palencia;154;Revilla de Collazos;76;41;35
34;Palencia;155;Ribas de Campos;154;80;74
34;Palencia;156;Riberos de la Cueza;57;37;20
34;Palencia;157;Saldaña;3104;1569;1535
34;Palencia;158;Salinas de Pisuerga;335;178;157
34;Palencia;159;San Cebrián de Campos;449;247;202
34;Palencia;160;San Cebrián de Mudá;156;84;72
34;Palencia;161;San Cristóbal de Boedo;23;14;9
34;Palencia;163;San Mamés de Campos;50;26;24
34;Palencia;165;San Román de la Cuba;68;40;28
34;Palencia;167;Santa Cecilia del Alcor;123;71;52
34;Palencia;168;Santa Cruz de Boedo;56;33;23
34;Palencia;169;Santervás de la Vega;480;270;210
34;Palencia;170;Santibáñez de Ecla;65;33;32
34;Palencia;171;Santibáñez de la Peña;1082;539;543
34;Palencia;174;Santoyo;218;116;102
34;Palencia;175;Serna, La;99;61;38
34;Palencia;177;Soto de Cerrato;193;112;81
34;Palencia;176;Sotobañado y Priorato;162;97;65
34;Palencia;178;Tabanera de Cerrato;128;70;58
34;Palencia;179;Tabanera de Valdavia;28;16;12
34;Palencia;180;Támara de Campos;72;38;34
34;Palencia;181;Tariego de Cerrato;515;276;239
34;Palencia;182;Torquemada;1006;547;459
34;Palencia;184;Torremormojón;57;31;26
34;Palencia;185;Triollo;61;35;26
34;Palencia;186;Valbuena de Pisuerga;50;28;22
34;Palencia;189;Valdeolmillos;67;36;31
34;Palencia;190;Valderrábano;55;27;28
34;Palencia;192;Valde-Ucieza;103;61;42
34;Palencia;196;Valle de Cerrato;91;54;37
34;Palencia;902;Valle del Retortillo;188;108;80
34;Palencia;199;Velilla del Río Carrión;1369;701;668
34;Palencia;023;Venta de Baños;6453;3240;3213
34;Palencia;201;Vertavillo;203;107;96
34;Palencia;093;Vid de Ojeda, La;105;63;42
34;Palencia;202;Villabasta de Valdavia;31;16;15
34;Palencia;204;Villacidaler;48;29;19
34;Palencia;205;Villaconancio;61;36;25
34;Palencia;206;Villada;1008;501;507
34;Palencia;208;Villaeles de Valdavia;54;32;22
34;Palencia;210;Villahán;108;56;52
34;Palencia;211;Villaherreros;199;99;100
34;Palencia;213;Villalaco;61;33;28
34;Palencia;214;Villalba de Guardo;198;105;93
34;Palencia;215;Villalcázar de Sirga;172;92;80
34;Palencia;216;Villalcón;69;40;29
34;Palencia;217;Villalobón;1613;810;803
34;Palencia;218;Villaluenga de la Vega;562;319;243
34;Palencia;220;Villamartín de Campos;176;98;78
34;Palencia;221;Villamediana;183;99;84
34;Palencia;222;Villameriel;126;73;53
34;Palencia;223;Villamoronta;252;146;106
34;Palencia;224;Villamuera de la Cueza;47;29;18
34;Palencia;225;Villamuriel de Cerrato;6427;3323;3104
34;Palencia;227;Villanueva del Rebollar;79;38;41
34;Palencia;228;Villanuño de Valdavia;94;55;39
34;Palencia;229;Villaprovedo;69;44;25
34;Palencia;230;Villarmentero de Campos;20;12;8
34;Palencia;231;Villarrabé;211;112;99
34;Palencia;232;Villarramiel;840;453;387
34;Palencia;233;Villasarracino;135;76;59
34;Palencia;234;Villasila de Valdavia;75;52;23
34;Palencia;236;Villaturde;164;85;79
34;Palencia;237;Villaumbrales;681;347;334
34;Palencia;238;Villaviudas;387;187;200
34;Palencia;240;Villerías de Campos;93;51;42
34;Palencia;241;Villodre;18;10;8
34;Palencia;242;Villodrigo;118;67;51
34;Palencia;243;Villoldo;365;198;167
34;Palencia;245;Villota del Páramo;335;191;144
34;Palencia;246;Villovieco;74;40;34
35;Palmas, Las;001;Agaete;5558;2766;2792
35;Palmas, Las;002;Agüimes;30742;15574;15168
35;Palmas, Las;020;Aldea de San Nicolás, La;7741;3946;3795
35;Palmas, Las;003;Antigua;10834;5795;5039
35;Palmas, Las;004;Arrecife;58537;29291;29246
35;Palmas, Las;005;Artenara;1136;620;516
35;Palmas, Las;006;Arucas;37299;18556;18743
35;Palmas, Las;007;Betancuria;714;369;345
35;Palmas, Las;008;Firgas;7465;3761;3704
35;Palmas, Las;009;Gáldar;24296;12193;12103
35;Palmas, Las;010;Haría;4767;2453;2314
35;Palmas, Las;011;Ingenio;30340;15313;15027
35;Palmas, Las;012;Mogán;21049;10914;10135
35;Palmas, Las;013;Moya;7821;3969;3852
35;Palmas, Las;014;Oliva, La;24508;12895;11613
35;Palmas, Las;015;Pájara;19394;10093;9301
35;Palmas, Las;016;Palmas de Gran Canaria, Las;378998;183816;195182
35;Palmas, Las;017;Puerto del Rosario;38126;19399;18727
35;Palmas, Las;018;San Bartolomé;18151;9159;8992
35;Palmas, Las;019;San Bartolomé de Tirajana;53829;27991;25838
35;Palmas, Las;021;Santa Brígida;18437;9166;9271
35;Palmas, Las;022;Santa Lucía de Tirajana;69178;34553;34625
35;Palmas, Las;023;Santa María de Guía de Gran Canaria;13970;6940;7030
35;Palmas, Las;024;Teguise;21724;11031;10693
35;Palmas, Las;025;Tejeda;1967;1060;907
35;Palmas, Las;026;Telde;102164;50467;51697
35;Palmas, Las;027;Teror;12489;6419;6070
35;Palmas, Las;028;Tías;20037;10267;9770
35;Palmas, Las;029;Tinajo;5924;3070;2854
35;Palmas, Las;030;Tuineje;13945;7172;6773
35;Palmas, Las;032;Valleseco;3861;2028;1833
35;Palmas, Las;031;Valsequillo de Gran Canaria;9227;4644;4583
35;Palmas, Las;033;Vega de San Mateo;7628;3903;3725
35;Palmas, Las;034;Yaiza;15944;8335;7609
36;Pontevedra;020;Agolada;2507;1243;1264
36;Pontevedra;001;Arbo;2770;1412;1358
36;Pontevedra;003;Baiona;12119;6003;6116
36;Pontevedra;002;Barro;3746;1862;1884
36;Pontevedra;004;Bueu;12189;5983;6206
36;Pontevedra;005;Caldas de Reis;9830;4751;5079
36;Pontevedra;006;Cambados;13977;6769;7208
36;Pontevedra;007;Campo Lameiro;1894;902;992
36;Pontevedra;008;Cangas;26584;13127;13457
36;Pontevedra;009;Cañiza, A;5234;2561;2673
36;Pontevedra;010;Catoira;3376;1644;1732
36;Pontevedra;011;Cerdedo;1781;834;947
36;Pontevedra;012;Cotobade;4290;2072;2218
36;Pontevedra;013;Covelo;2528;1257;1271
36;Pontevedra;014;Crecente;2131;1012;1119
36;Pontevedra;015;Cuntis;4794;2262;2532
36;Pontevedra;016;Dozón;1107;576;531
36;Pontevedra;017;Estrada, A;20891;10048;10843
36;Pontevedra;018;Forcarei;3621;1715;1906
36;Pontevedra;019;Fornelos de Montes;1748;827;921
36;Pontevedra;021;Gondomar;14192;7043;7149
36;Pontevedra;022;Grove, O;10758;5301;5457
36;Pontevedra;023;Guarda, A;10133;4937;5196
36;Pontevedra;901;Illa de Arousa, A;4909;2432;2477
36;Pontevedra;024;Lalín;20044;9738;10306
36;Pontevedra;025;Lama, A;2587;1268;1319
36;Pontevedra;026;Marín;24878;12482;12396
36;Pontevedra;027;Meaño;5341;2606;2735
36;Pontevedra;028;Meis;4844;2313;2531
36;Pontevedra;029;Moaña;19458;9488;9970
36;Pontevedra;030;Mondariz;4647;2265;2382
36;Pontevedra;031;Mondariz-Balneario;614;316;298
36;Pontevedra;032;Moraña;4313;2081;2232
36;Pontevedra;033;Mos;15240;7546;7694
36;Pontevedra;034;Neves, As;4038;1945;2093
36;Pontevedra;035;Nigrán;17593;8622;8971
36;Pontevedra;036;Oia;3002;1513;1489
36;Pontevedra;037;Pazos de Borbén;3004;1450;1554
36;Pontevedra;041;Poio;16901;8355;8546
36;Pontevedra;043;Ponte Caldelas;5573;2705;2868
36;Pontevedra;042;Ponteareas;22963;11186;11777
36;Pontevedra;044;Pontecesures;3040;1515;1525
36;Pontevedra;038;Pontevedra;82549;39080;43469
36;Pontevedra;039;Porriño, O;19567;9641;9926
36;Pontevedra;040;Portas;3056;1461;1595
36;Pontevedra;045;Redondela;29563;14424;15139
36;Pontevedra;046;Ribadumia;5105;2484;2621
36;Pontevedra;047;Rodeiro;2644;1330;1314
36;Pontevedra;048;Rosal, O;6349;3123;3226
36;Pontevedra;049;Salceda de Caselas;8914;4452;4462
36;Pontevedra;050;Salvaterra de Miño;9566;4764;4802
36;Pontevedra;051;Sanxenxo;17314;8542;8772
36;Pontevedra;052;Silleda;8734;4247;4487
36;Pontevedra;053;Soutomaior;7251;3608;3643
36;Pontevedra;054;Tomiño;13548;6813;6735
36;Pontevedra;055;Tui;16966;8157;8809
36;Pontevedra;056;Valga;6047;2952;3095
36;Pontevedra;057;Vigo;292817;138911;153906
36;Pontevedra;059;Vila de Cruces;5435;2656;2779
36;Pontevedra;058;Vilaboa;6043;2943;3100
36;Pontevedra;060;Vilagarcía de Arousa;37283;17894;19389
36;Pontevedra;061;Vilanova de Arousa;10406;5102;5304
26;Rioja, La;001;Ábalos;249;149;100
26;Rioja, La;002;Agoncillo;1103;608;495
26;Rioja, La;003;Aguilar del Río Alhama;498;251;247
26;Rioja, La;004;Ajamil de Cameros;65;45;20
26;Rioja, La;005;Albelda de Iregua;3319;1689;1630
26;Rioja, La;006;Alberite;2426;1229;1197
26;Rioja, La;007;Alcanadre;695;367;328
26;Rioja, La;008;Aldeanueva de Ebro;2744;1435;1309
26;Rioja, La;009;Alesanco;507;269;238
26;Rioja, La;010;Alesón;115;67;48
26;Rioja, La;011;Alfaro;9553;4808;4745
26;Rioja, La;012;Almarza de Cameros;26;16;10
26;Rioja, La;013;Anguciana;456;253;203
26;Rioja, La;014;Anguiano;537;297;240
26;Rioja, La;015;Arenzana de Abajo;244;123;121
26;Rioja, La;016;Arenzana de Arriba;29;20;9
26;Rioja, La;017;Arnedillo;467;232;235
26;Rioja, La;018;Arnedo;14609;7251;7358
26;Rioja, La;019;Arrúbal;484;257;227
26;Rioja, La;020;Ausejo;815;434;381
26;Rioja, La;021;Autol;4473;2227;2246
26;Rioja, La;022;Azofra;200;108;92
26;Rioja, La;023;Badarán;532;265;267
26;Rioja, La;024;Bañares;268;137;131
26;Rioja, La;026;Baños de Río Tobía;1620;812;808
26;Rioja, La;025;Baños de Rioja;91;53;38
26;Rioja, La;027;Berceo;170;110;60
26;Rioja, La;028;Bergasa;149;81;68
26;Rioja, La;029;Bergasillas Bajera;38;19;19
26;Rioja, La;030;Bezares;22;11;11
26;Rioja, La;031;Bobadilla;116;61;55
26;Rioja, La;032;Brieva de Cameros;52;34;18
26;Rioja, La;033;Briñas;203;93;110
26;Rioja, La;034;Briones;807;431;376
26;Rioja, La;035;Cabezón de Cameros;16;12;4
26;Rioja, La;036;Calahorra;23827;11698;12129
26;Rioja, La;037;Camprovín;155;87;68
26;Rioja, La;038;Canales de la Sierra;91;59;32
26;Rioja, La;039;Canillas de Río Tuerto;41;20;21
26;Rioja, La;040;Cañas;102;58;44
26;Rioja, La;041;Cárdenas;161;85;76
26;Rioja, La;042;Casalarreina;1193;611;582
26;Rioja, La;043;Castañares de Rioja;448;223;225
26;Rioja, La;044;Castroviejo;59;36;23
26;Rioja, La;045;Cellorigo;12;5;7
26;Rioja, La;046;Cenicero;2013;1015;998
26;Rioja, La;047;Cervera del Río Alhama;2406;1227;1179
26;Rioja, La;048;Cidamón;25;13;12
26;Rioja, La;049;Cihuri;207;107;100
26;Rioja, La;050;Cirueña;131;85;46
26;Rioja, La;051;Clavijo;294;174;120
26;Rioja, La;052;Cordovín;162;79;83
26;Rioja, La;053;Corera;249;133;116
26;Rioja, La;054;Cornago;349;201;148
26;Rioja, La;055;Corporales;43;23;20
26;Rioja, La;056;Cuzcurrita de Río Tirón;506;278;228
26;Rioja, La;057;Daroca de Rioja;50;34;16
26;Rioja, La;058;Enciso;178;108;70
26;Rioja, La;059;Entrena;1501;783;718
26;Rioja, La;060;Estollo;90;59;31
26;Rioja, La;061;Ezcaray;2069;1075;994
26;Rioja, La;062;Foncea;96;51;45
26;Rioja, La;063;Fonzaleche;146;93;53
26;Rioja, La;064;Fuenmayor;3108;1574;1534
26;Rioja, La;065;Galbárruli;47;31;16
26;Rioja, La;066;Galilea;340;172;168
26;Rioja, La;067;Gallinero de Cameros;24;16;8
26;Rioja, La;068;Gimileo;114;62;52
26;Rioja, La;069;Grañón;275;154;121
26;Rioja, La;070;Grávalos;201;105;96
26;Rioja, La;071;Haro;11324;5583;5741
26;Rioja, La;072;Herce;321;173;148
26;Rioja, La;073;Herramélluri;110;59;51
26;Rioja, La;074;Hervías;119;59;60
26;Rioja, La;075;Hormilla;443;237;206
26;Rioja, La;076;Hormilleja;147;73;74
26;Rioja, La;077;Hornillos de Cameros;23;12;11
26;Rioja, La;078;Hornos de Moncalvillo;91;55;36
26;Rioja, La;079;Huércanos;845;458;387
26;Rioja, La;080;Igea;603;333;270
26;Rioja, La;081;Jalón de Cameros;17;9;8
26;Rioja, La;082;Laguna de Cameros;125;74;51
26;Rioja, La;083;Lagunilla del Jubera;309;169;140
26;Rioja, La;084;Lardero;9620;4866;4754
26;Rioja, La;086;Ledesma de la Cogolla;16;12;4
26;Rioja, La;087;Leiva;257;130;127
26;Rioja, La;088;Leza de Río Leza;39;23;16
26;Rioja, La;089;Logroño;150876;71766;79110
26;Rioja, La;091;Lumbreras;169;110;59
26;Rioja, La;092;Manjarrés;115;70;45
26;Rioja, La;093;Mansilla de la Sierra;66;45;21
26;Rioja, La;094;Manzanares de Rioja;83;50;33
26;Rioja, La;095;Matute;101;50;51
26;Rioja, La;096;Medrano;309;164;145
26;Rioja, La;098;Munilla;105;55;50
26;Rioja, La;099;Murillo de Río Leza;1683;856;827
26;Rioja, La;100;Muro de Aguas;51;28;23
26;Rioja, La;101;Muro en Cameros;45;27;18
26;Rioja, La;102;Nájera;8144;4015;4129
26;Rioja, La;103;Nalda;960;517;443
26;Rioja, La;104;Navajún;14;10;4
26;Rioja, La;105;Navarrete;2919;1472;1447
26;Rioja, La;106;Nestares;96;53;43
26;Rioja, La;107;Nieva de Cameros;92;57;35
26;Rioja, La;109;Ochánduri;92;56;36
26;Rioja, La;108;Ocón;280;173;107
26;Rioja, La;110;Ojacastro;168;102;66
26;Rioja, La;111;Ollauri;279;151;128
26;Rioja, La;112;Ortigosa de Cameros;245;143;102
26;Rioja, La;113;Pazuengos;35;26;9
26;Rioja, La;114;Pedroso;81;55;26
26;Rioja, La;115;Pinillos;19;11;8
26;Rioja, La;117;Pradejón;3919;2008;1911
26;Rioja, La;118;Pradillo;60;31;29
26;Rioja, La;119;Préjano;234;133;101
26;Rioja, La;120;Quel;1992;1049;943
26;Rioja, La;121;Rabanera;28;20;8
26;Rioja, La;122;Rasillo de Cameros, El;143;78;65
26;Rioja, La;123;Redal, El;140;79;61
26;Rioja, La;124;Ribafrecha;1003;532;471
26;Rioja, La;125;Rincón de Soto;3763;1904;1859
26;Rioja, La;126;Robres del Castillo;31;20;11
26;Rioja, La;127;Rodezno;250;142;108
26;Rioja, La;128;Sajazarra;126;64;62
26;Rioja, La;129;San Asensio;1166;623;543
26;Rioja, La;130;San Millán de la Cogolla;240;157;83
26;Rioja, La;131;San Millán de Yécora;36;25;11
26;Rioja, La;132;San Román de Cameros;139;80;59
26;Rioja, La;139;San Torcuato;59;29;30
26;Rioja, La;142;San Vicente de la Sonsierra;1008;525;483
26;Rioja, La;134;Santa Coloma;101;61;40
26;Rioja, La;135;Santa Engracia del Jubera;169;106;63
26;Rioja, La;136;Santa Eulalia Bajera;115;60;55
26;Rioja, La;138;Santo Domingo de la Calzada;6369;3214;3155
26;Rioja, La;140;Santurde de Rioja;290;158;132
26;Rioja, La;141;Santurdejo;118;74;44
26;Rioja, La;143;Sojuela;278;164;114
26;Rioja, La;144;Sorzano;226;128;98
26;Rioja, La;145;Sotés;297;169;128
26;Rioja, La;146;Soto en Cameros;101;57;44
26;Rioja, La;147;Terroba;34;18;16
26;Rioja, La;148;Tirgo;201;101;100
26;Rioja, La;149;Tobía;57;34;23
26;Rioja, La;150;Tormantos;145;84;61
26;Rioja, La;153;Torre en Cameros;13;11;2
26;Rioja, La;151;Torrecilla en Cameros;519;278;241
26;Rioja, La;152;Torrecilla sobre Alesanco;36;22;14
26;Rioja, La;154;Torremontalbo;12;7;5
26;Rioja, La;155;Treviana;176;92;84
26;Rioja, La;157;Tricio;374;182;192
26;Rioja, La;158;Tudelilla;336;186;150
26;Rioja, La;160;Uruñuela;962;485;477
26;Rioja, La;161;Valdemadera;7;4;3
26;Rioja, La;162;Valgañón;137;86;51
26;Rioja, La;163;Ventosa;176;90;86
26;Rioja, La;164;Ventrosa;59;36;23
26;Rioja, La;165;Viguera;430;242;188
26;Rioja, La;166;Villalba de Rioja;119;73;46
26;Rioja, La;167;Villalobar de Rioja;63;46;17
26;Rioja, La;168;Villamediana de Iregua;7696;3891;3805
26;Rioja, La;169;Villanueva de Cameros;69;40;29
26;Rioja, La;170;Villar de Arnedo, El;623;323;300
26;Rioja, La;171;Villar de Torre;184;109;75
26;Rioja, La;172;Villarejo;31;24;7
26;Rioja, La;173;Villarroya;5;3;2
26;Rioja, La;174;Villarta-Quintana;151;87;64
26;Rioja, La;175;Villavelayo;52;34;18
26;Rioja, La;176;Villaverde de Rioja;57;33;24
26;Rioja, La;177;Villoslada de Cameros;333;206;127
26;Rioja, La;178;Viniegra de Abajo;82;50;32
26;Rioja, La;179;Viniegra de Arriba;42;27;15
26;Rioja, La;180;Zarratón;261;146;115
26;Rioja, La;181;Zarzosa;14;10;4
26;Rioja, La;183;Zorraquín;90;44;46
37;Salamanca;001;Abusejo;202;106;96
37;Salamanca;002;Agallas;152;76;76
37;Salamanca;003;Ahigal de los Aceiteros;126;68;58
37;Salamanca;004;Ahigal de Villarino;40;22;18
37;Salamanca;005;Alameda de Gardón, La;83;44;39
37;Salamanca;006;Alamedilla, La;143;72;71
37;Salamanca;007;Alaraz;495;257;238
37;Salamanca;008;Alba de Tormes;5229;2590;2639
37;Salamanca;009;Alba de Yeltes;233;123;110
37;Salamanca;010;Alberca, La;1125;556;569
37;Salamanca;011;Alberguería de Argañán, La;134;67;67
37;Salamanca;012;Alconada;163;87;76
37;Salamanca;015;Aldea del Obispo;301;162;139
37;Salamanca;013;Aldeacipreste;121;66;55
37;Salamanca;014;Aldeadávila de la Ribera;1256;641;615
37;Salamanca;016;Aldealengua;696;351;345
37;Salamanca;017;Aldeanueva de Figueroa;284;148;136
37;Salamanca;018;Aldeanueva de la Sierra;110;61;49
37;Salamanca;019;Aldearrodrigo;152;78;74
37;Salamanca;020;Aldearrubia;487;261;226
37;Salamanca;021;Aldeaseca de Alba;82;37;45
37;Salamanca;022;Aldeaseca de la Frontera;292;150;142
37;Salamanca;023;Aldeatejada;1828;922;906
37;Salamanca;024;Aldeavieja de Tormes;104;56;48
37;Salamanca;025;Aldehuela de la Bóveda;284;152;132
37;Salamanca;026;Aldehuela de Yeltes;208;110;98
37;Salamanca;027;Almenara de Tormes;249;144;105
37;Salamanca;028;Almendra;166;97;69
37;Salamanca;029;Anaya de Alba;222;130;92
37;Salamanca;030;Añover de Tormes;93;49;44
37;Salamanca;031;Arabayona de Mógica;392;213;179
37;Salamanca;032;Arapiles;645;344;301
37;Salamanca;033;Arcediano;113;60;53
37;Salamanca;034;Arco, El;93;47;46
37;Salamanca;035;Armenteros;238;133;105
37;Salamanca;037;Atalaya, La;120;68;52
37;Salamanca;038;Babilafuente;869;453;416
37;Salamanca;039;Bañobárez;316;164;152
37;Salamanca;040;Barbadillo;407;212;195
37;Salamanca;041;Barbalos;78;42;36
37;Salamanca;042;Barceo;48;28;20
37;Salamanca;044;Barruecopardo;483;268;215
37;Salamanca;045;Bastida, La;24;14;10
37;Salamanca;046;Béjar;13403;6365;7038
37;Salamanca;047;Beleña;223;113;110
37;Salamanca;049;Bermellar;143;70;73
37;Salamanca;050;Berrocal de Huebra;68;39;29
37;Salamanca;051;Berrocal de Salvatierra;91;47;44
37;Salamanca;052;Boada;297;152;145
37;Salamanca;054;Bodón, El;293;155;138
37;Salamanca;055;Bogajo;141;76;65
37;Salamanca;056;Bouza, La;55;23;32
37;Salamanca;057;Bóveda del Río Almar;245;132;113
37;Salamanca;058;Brincones;58;29;29
37;Salamanca;059;Buenamadre;133;71;62
37;Salamanca;060;Buenavista;270;150;120
37;Salamanca;061;Cabaco, El;248;127;121
37;Salamanca;063;Cabeza de Béjar, La;70;41;29
37;Salamanca;065;Cabeza del Caballo;338;187;151
37;Salamanca;062;Cabezabellosa de la Calzada;87;48;39
37;Salamanca;067;Cabrerizos;4205;2112;2093
37;Salamanca;068;Cabrillas;398;202;196
37;Salamanca;069;Calvarrasa de Abajo;1143;597;546
37;Salamanca;070;Calvarrasa de Arriba;604;323;281
37;Salamanca;071;Calzada de Béjar, La;86;49;37
37;Salamanca;072;Calzada de Don Diego;174;93;81
37;Salamanca;073;Calzada de Valdunciel;660;335;325
37;Salamanca;074;Campillo de Azaba;169;96;73
37;Salamanca;077;Campo de Peñaranda, El;274;155;119
37;Salamanca;078;Candelario;934;463;471
37;Salamanca;079;Canillas de Abajo;77;54;23
37;Salamanca;080;Cantagallo;263;141;122
37;Salamanca;081;Cantalapiedra;1019;529;490
37;Salamanca;082;Cantalpino;927;507;420
37;Salamanca;083;Cantaracillo;204;110;94
37;Salamanca;085;Carbajosa de la Sagrada;6790;3405;3385
37;Salamanca;086;Carpio de Azaba;101;59;42
37;Salamanca;087;Carrascal de Barregas;1117;591;526
37;Salamanca;088;Carrascal del Obispo;222;120;102
37;Salamanca;089;Casafranca;69;40;29
37;Salamanca;090;Casas del Conde, Las;55;28;27
37;Salamanca;091;Casillas de Flores;183;90;93
37;Salamanca;092;Castellanos de Moriscos;2419;1253;1166
37;Salamanca;185;Castellanos de Villiquera;675;361;314
37;Salamanca;096;Castillejo de Martín Viejo;227;130;97
37;Salamanca;097;Castraz;39;24;15
37;Salamanca;098;Cepeda;349;175;174
37;Salamanca;099;Cereceda de la Sierra;75;39;36
37;Salamanca;100;Cerezal de Peñahorcada;80;47;33
37;Salamanca;101;Cerralbo;170;93;77
37;Salamanca;102;Cerro, El;442;220;222
37;Salamanca;103;Cespedosa de Tormes;518;276;242
37;Salamanca;114;Chagarcía Medianero;84;45;39
37;Salamanca;104;Cilleros de la Bastida;25;13;12
37;Salamanca;106;Cipérez;278;142;136
37;Salamanca;107;Ciudad Rodrigo;12896;6260;6636
37;Salamanca;108;Coca de Alba;99;46;53
37;Salamanca;109;Colmenar de Montemayor;193;108;85
37;Salamanca;110;Cordovilla;129;73;56
37;Salamanca;112;Cristóbal;170;97;73
37;Salamanca;113;Cubo de Don Sancho, El;463;249;214
37;Salamanca;115;Dios le Guarde;139;73;66
37;Salamanca;116;Doñinos de Ledesma;68;35;33
37;Salamanca;117;Doñinos de Salamanca;1996;1046;950
37;Salamanca;118;Ejeme;134;76;58
37;Salamanca;120;Encina de San Silvestre;111;57;54
37;Salamanca;119;Encina, La;112;70;42
37;Salamanca;121;Encinas de Abajo;666;346;320
37;Salamanca;122;Encinas de Arriba;242;124;118
37;Salamanca;123;Encinasola de los Comendadores;184;101;83
37;Salamanca;124;Endrinal;233;129;104
37;Salamanca;125;Escurial de la Sierra;246;139;107
37;Salamanca;126;Espadaña;32;19;13
37;Salamanca;127;Espeja;245;127;118
37;Salamanca;128;Espino de la Orbada;284;151;133
37;Salamanca;129;Florida de Liébana;282;153;129
37;Salamanca;130;Forfoleda;189;103;86
37;Salamanca;131;Frades de la Sierra;208;110;98
37;Salamanca;132;Fregeneda, La;377;182;195
37;Salamanca;133;Fresnedoso;107;63;44
37;Salamanca;134;Fresno Alhándiga;245;131;114
37;Salamanca;135;Fuente de San Esteban, La;1358;675;683
37;Salamanca;136;Fuenteguinaldo;687;343;344
37;Salamanca;137;Fuenteliante;108;54;54
37;Salamanca;138;Fuenterroble de Salvatierra;243;125;118
37;Salamanca;139;Fuentes de Béjar;250;125;125
37;Salamanca;140;Fuentes de Oñoro;1058;544;514
37;Salamanca;141;Gajates;166;79;87
37;Salamanca;142;Galindo y Perahuy;693;403;290
37;Salamanca;143;Galinduste;443;220;223
37;Salamanca;144;Galisancho;405;224;181
37;Salamanca;145;Gallegos de Argañán;293;154;139
37;Salamanca;146;Gallegos de Solmirón;131;71;60
37;Salamanca;147;Garcibuey;196;111;85
37;Salamanca;148;Garcihernández;480;250;230
37;Salamanca;149;Garcirrey;69;40;29
37;Salamanca;150;Gejuelo del Barro;41;23;18
37;Salamanca;151;Golpejas;155;82;73
37;Salamanca;152;Gomecello;458;243;215
37;Salamanca;154;Guadramiro;150;85;65
37;Salamanca;155;Guijo de Ávila;77;42;35
37;Salamanca;156;Guijuelo;5630;2798;2832
37;Salamanca;157;Herguijuela de Ciudad Rodrigo;82;48;34
37;Salamanca;158;Herguijuela de la Sierra;272;152;120
37;Salamanca;159;Herguijuela del Campo;91;43;48
37;Salamanca;160;Hinojosa de Duero;699;350;349
37;Salamanca;161;Horcajo de Montemayor;154;82;72
37;Salamanca;162;Horcajo Medianero;207;109;98
37;Salamanca;163;Hoya, La;42;25;17
37;Salamanca;164;Huerta;305;168;137
37;Salamanca;165;Iruelos;36;14;22
37;Salamanca;166;Ituero de Azaba;235;119;116
37;Salamanca;167;Juzbado;174;92;82
37;Salamanca;168;Lagunilla;496;268;228
37;Salamanca;169;Larrodrigo;190;108;82
37;Salamanca;170;Ledesma;1767;880;887
37;Salamanca;171;Ledrada;510;254;256
37;Salamanca;172;Linares de Riofrío;990;551;439
37;Salamanca;173;Lumbrales;1697;854;843
37;Salamanca;175;Machacón;453;236;217
37;Salamanca;174;Macotera;1149;606;543
37;Salamanca;176;Madroñal;153;88;65
37;Salamanca;177;Maíllo, El;287;159;128
37;Salamanca;178;Malpartida;99;57;42
37;Salamanca;179;Mancera de Abajo;225;117;108
37;Salamanca;180;Manzano, El;74;39;35
37;Salamanca;181;Martiago;302;157;145
37;Salamanca;183;Martín de Yeltes;436;226;210
37;Salamanca;182;Martinamor;82;50;32
37;Salamanca;184;Masueco;325;169;156
37;Salamanca;186;Mata de Ledesma, La;110;61;49
37;Salamanca;187;Matilla de los Caños del Río;654;328;326
37;Salamanca;188;Maya, La;190;112;78
37;Salamanca;189;Membribe de la Sierra;124;74;50
37;Salamanca;190;Mieza;226;113;113
37;Salamanca;191;Milano, El;123;73;50
37;Salamanca;192;Miranda de Azán;419;226;193
37;Salamanca;193;Miranda del Castañar;426;222;204
37;Salamanca;194;Mogarraz;309;164;145
37;Salamanca;195;Molinillo;52;28;24
37;Salamanca;196;Monforte de la Sierra;81;42;39
37;Salamanca;197;Monleón;90;51;39
37;Salamanca;198;Monleras;236;111;125
37;Salamanca;199;Monsagro;148;80;68
37;Salamanca;200;Montejo;207;113;94
37;Salamanca;201;Montemayor del Río;296;155;141
37;Salamanca;202;Monterrubio de Armuña;1353;714;639
37;Salamanca;203;Monterrubio de la Sierra;169;92;77
37;Salamanca;204;Morasverdes;274;143;131
37;Salamanca;205;Morille;254;136;118
37;Salamanca;206;Moríñigo;102;55;47
37;Salamanca;207;Moriscos;358;204;154
37;Salamanca;208;Moronta;80;48;32
37;Salamanca;209;Mozárbez;502;262;240
37;Salamanca;211;Narros de Matalayegua;238;129;109
37;Salamanca;213;Nava de Béjar;99;53;46
37;Salamanca;214;Nava de Francia;142;78;64
37;Salamanca;215;Nava de Sotrobal;163;89;74
37;Salamanca;212;Navacarros;106;59;47
37;Salamanca;216;Navales;336;182;154
37;Salamanca;217;Navalmoral de Béjar;66;29;37
37;Salamanca;218;Navamorales;70;44;26
37;Salamanca;219;Navarredonda de la Rinconada;185;96;89
37;Salamanca;221;Navasfrías;470;253;217
37;Salamanca;222;Negrilla de Palencia;97;55;42
37;Salamanca;223;Olmedo de Camaces;111;61;50
37;Salamanca;224;Orbada, La;224;120;104
37;Salamanca;225;Pajares de la Laguna;116;61;55
37;Salamanca;226;Palacios del Arzobispo;163;80;83
37;Salamanca;228;Palaciosrubios;382;204;178
37;Salamanca;229;Palencia de Negrilla;156;87;69
37;Salamanca;230;Parada de Arriba;268;137;131
37;Salamanca;231;Parada de Rubiales;270;136;134
37;Salamanca;232;Paradinas de San Juan;410;234;176
37;Salamanca;233;Pastores;64;35;29
37;Salamanca;234;Payo, El;375;183;192
37;Salamanca;235;Pedraza de Alba;248;129;119
37;Salamanca;236;Pedrosillo de Alba;142;79;63
37;Salamanca;237;Pedrosillo de los Aires;384;215;169
37;Salamanca;238;Pedrosillo el Ralo;136;70;66
37;Salamanca;239;Pedroso de la Armuña, El;238;122;116
37;Salamanca;240;Pelabravo;1151;610;541
37;Salamanca;241;Pelarrodríguez;165;100;65
37;Salamanca;242;Pelayos;98;58;40
37;Salamanca;243;Peña, La;103;48;55
37;Salamanca;244;Peñacaballera;149;75;74
37;Salamanca;245;Peñaparda;370;187;183
37;Salamanca;246;Peñaranda de Bracamonte;6471;3177;3294
37;Salamanca;247;Peñarandilla;210;110;100
37;Salamanca;248;Peralejos de Abajo;165;88;77
37;Salamanca;249;Peralejos de Arriba;43;25;18
37;Salamanca;250;Pereña de la Ribera;377;193;184
37;Salamanca;251;Peromingo;131;62;69
37;Salamanca;252;Pinedas;107;58;49
37;Salamanca;253;Pino de Tormes, El;157;86;71
37;Salamanca;254;Pitiegua;196;111;85
37;Salamanca;255;Pizarral;50;28;22
37;Salamanca;256;Poveda de las Cintas;242;137;105
37;Salamanca;257;Pozos de Hinojo;51;29;22
37;Salamanca;258;Puebla de Azaba;201;109;92
37;Salamanca;259;Puebla de San Medel;44;26;18
37;Salamanca;260;Puebla de Yeltes;151;81;70
37;Salamanca;261;Puente del Congosto;236;132;104
37;Salamanca;262;Puertas;84;45;39
37;Salamanca;263;Puerto de Béjar;380;190;190
37;Salamanca;264;Puerto Seguro;64;32;32
37;Salamanca;265;Rágama;238;122;116
37;Salamanca;266;Redonda, La;94;54;40
37;Salamanca;267;Retortillo;216;117;99
37;Salamanca;268;Rinconada de la Sierra, La;120;66;54
37;Salamanca;269;Robleda;513;275;238
37;Salamanca;270;Robliza de Cojos;209;105;104
37;Salamanca;271;Rollán;388;209;179
37;Salamanca;272;Saelices el Chico;152;80;72
37;Salamanca;273;Sagrada, La;112;62;50
37;Salamanca;303;Sahugo, El;196;108;88
37;Salamanca;274;Salamanca;144949;66017;78932
37;Salamanca;275;Saldeana;119;65;54
37;Salamanca;276;Salmoral;147;92;55
37;Salamanca;277;Salvatierra de Tormes;78;38;40
37;Salamanca;278;San Cristóbal de la Cuesta;958;511;447
37;Salamanca;284;San Esteban de la Sierra;340;188;152
37;Salamanca;285;San Felices de los Gallegos;442;224;218
37;Salamanca;286;San Martín del Castañar;228;123;105
37;Salamanca;287;San Miguel de Valero;338;173;165
37;Salamanca;036;San Miguel del Robledo;62;32;30
37;Salamanca;288;San Morales;306;169;137
37;Salamanca;289;San Muñoz;253;128;125
37;Salamanca;291;San Pedro de Rozados;307;165;142
37;Salamanca;290;San Pedro del Valle;147;82;65
37;Salamanca;292;San Pelayo de Guareña;99;52;47
37;Salamanca;280;Sanchón de la Ribera;78;44;34
37;Salamanca;281;Sanchón de la Sagrada;40;24;16
37;Salamanca;282;Sanchotello;227;118;109
37;Salamanca;279;Sancti-Spíritus;854;457;397
37;Salamanca;283;Sando;132;79;53
37;Salamanca;293;Santa María de Sando;119;60;59
37;Salamanca;294;Santa Marta de Tormes;14939;7358;7581
37;Salamanca;296;Santiago de la Puebla;353;185;168
37;Salamanca;297;Santibáñez de Béjar;493;251;242
37;Salamanca;298;Santibáñez de la Sierra;184;100;84
37;Salamanca;299;Santiz;250;128;122
37;Salamanca;300;Santos, Los;639;325;314
37;Salamanca;301;Sardón de los Frailes;82;49;33
37;Salamanca;302;Saucelle;308;160;148
37;Salamanca;304;Sepulcro-Hilario;181;103;78
37;Salamanca;305;Sequeros;237;118;119
37;Salamanca;306;Serradilla del Arroyo;275;153;122
37;Salamanca;307;Serradilla del Llano;172;85;87
37;Salamanca;309;Sierpe, La;48;24;24
37;Salamanca;310;Sieteiglesias de Tormes;204;104;100
37;Salamanca;311;Sobradillo;242;122;120
37;Salamanca;312;Sorihuela;263;133;130
37;Salamanca;313;Sotoserrano;596;318;278
37;Salamanca;314;Tabera de Abajo;111;64;47
37;Salamanca;315;Tala, La;96;53;43
37;Salamanca;316;Tamames;826;423;403
37;Salamanca;317;Tarazona de Guareña;330;174;156
37;Salamanca;318;Tardáguila;221;130;91
37;Salamanca;319;Tejado, El;120;65;55
37;Salamanca;320;Tejeda y Segoyuela;99;55;44
37;Salamanca;321;Tenebrón;160;77;83
37;Salamanca;322;Terradillos;3089;1583;1506
37;Salamanca;323;Topas;554;297;257
37;Salamanca;324;Tordillos;377;208;169
37;Salamanca;325;Tornadizo, El;88;47;41
37;Salamanca;327;Torresmenudas;196;97;99
37;Salamanca;328;Trabanca;220;108;112
37;Salamanca;329;Tremedal de Tormes;44;21;23
37;Salamanca;330;Valdecarros;363;188;175
37;Salamanca;331;Valdefuentes de Sangusín;229;127;102
37;Salamanca;332;Valdehijaderos;83;46;37
37;Salamanca;333;Valdelacasa;242;143;99
37;Salamanca;334;Valdelageve;81;41;40
37;Salamanca;335;Valdelosa;443;215;228
37;Salamanca;336;Valdemierque;61;38;23
37;Salamanca;337;Valderrodrigo;151;73;78
37;Salamanca;338;Valdunciel;95;48;47
37;Salamanca;339;Valero;317;170;147
37;Salamanca;343;Vallejera de Riofrío;67;33;34
37;Salamanca;340;Valsalabroso;146;84;62
37;Salamanca;341;Valverde de Valdelacasa;76;43;33
37;Salamanca;342;Valverdón;290;150;140
37;Salamanca;344;Vecinos;264;133;131
37;Salamanca;345;Vega de Tirados;180;95;85
37;Salamanca;346;Veguillas, Las;297;137;160
37;Salamanca;347;Vellés, La;557;301;256
37;Salamanca;348;Ventosa del Río Almar;121;68;53
37;Salamanca;349;Vídola, La;117;53;64
37;Salamanca;351;Villaflores;293;153;140
37;Salamanca;352;Villagonzalo de Tormes;222;126;96
37;Salamanca;353;Villalba de los Llanos;138;78;60
37;Salamanca;354;Villamayor;7047;3540;3507
37;Salamanca;355;Villanueva del Conde;177;88;89
37;Salamanca;356;Villar de Argañán;89;47;42
37;Salamanca;357;Villar de Ciervo;289;151;138
37;Salamanca;358;Villar de Gallimazo;202;129;73
37;Salamanca;359;Villar de la Yegua;198;104;94
37;Salamanca;360;Villar de Peralonso;249;123;126
37;Salamanca;361;Villar de Samaniego;88;51;37
37;Salamanca;362;Villares de la Reina;6266;3137;3129
37;Salamanca;363;Villares de Yeltes;128;61;67
37;Salamanca;364;Villarino de los Aires;869;449;420
37;Salamanca;365;Villarmayor;195;107;88
37;Salamanca;366;Villarmuerto;41;27;14
37;Salamanca;367;Villasbuenas;208;113;95
37;Salamanca;368;Villasdardo;17;6;11
37;Salamanca;369;Villaseco de los Gamitos;143;82;61
37;Salamanca;370;Villaseco de los Reyes;350;201;149
37;Salamanca;371;Villasrubias;289;158;131
37;Salamanca;372;Villaverde de Guareña;149;81;68
37;Salamanca;373;Villavieja de Yeltes;838;435;403
37;Salamanca;374;Villoria;1389;697;692
37;Salamanca;375;Villoruela;819;417;402
37;Salamanca;350;Vilvestre;444;219;225
37;Salamanca;376;Vitigudino;2634;1291;1343
37;Salamanca;377;Yecla de Yeltes;261;135;126
37;Salamanca;378;Zamarra;105;59;46
37;Salamanca;379;Zamayón;201;116;85
37;Salamanca;380;Zarapicos;55;30;25
37;Salamanca;381;Zarza de Pumareda, La;156;87;69
37;Salamanca;382;Zorita de la Frontera;183;97;86
38;Santa Cruz de Tenerife;001;Adeje;47316;23944;23372
38;Santa Cruz de Tenerife;002;Agulo;1074;552;522
38;Santa Cruz de Tenerife;003;Alajeró;1971;1050;921
38;Santa Cruz de Tenerife;004;Arafo;5458;2683;2775
38;Santa Cruz de Tenerife;005;Arico;7423;3848;3575
38;Santa Cruz de Tenerife;006;Arona;79172;40470;38702
38;Santa Cruz de Tenerife;007;Barlovento;1886;957;929
38;Santa Cruz de Tenerife;008;Breña Alta;7086;3493;3593
38;Santa Cruz de Tenerife;009;Breña Baja;5377;2688;2689
38;Santa Cruz de Tenerife;010;Buenavista del Norte;4832;2444;2388
38;Santa Cruz de Tenerife;011;Candelaria;26746;13018;13728
38;Santa Cruz de Tenerife;012;Fasnia;2783;1456;1327
38;Santa Cruz de Tenerife;013;Frontera;3959;2008;1951
38;Santa Cruz de Tenerife;014;Fuencaliente de la Palma;1705;864;841
38;Santa Cruz de Tenerife;015;Garachico;4916;2466;2450
38;Santa Cruz de Tenerife;016;Garafía;1607;841;766
38;Santa Cruz de Tenerife;017;Granadilla de Abona;45332;22708;22624
38;Santa Cruz de Tenerife;018;Guancha, La;5423;2641;2782
38;Santa Cruz de Tenerife;019;Guía de Isora;20460;10205;10255
38;Santa Cruz de Tenerife;020;Güímar;19000;9361;9639
38;Santa Cruz de Tenerife;021;Hermigua;1924;976;948
38;Santa Cruz de Tenerife;022;Icod de los Vinos;22606;11185;11421
38;Santa Cruz de Tenerife;024;Llanos de Aridane, Los;20043;9718;10325
38;Santa Cruz de Tenerife;025;Matanza de Acentejo, La;8772;4409;4363
38;Santa Cruz de Tenerife;026;Orotava, La;41294;20332;20962
38;Santa Cruz de Tenerife;027;Paso, El;7457;3711;3746
38;Santa Cruz de Tenerife;901;Pinar de El Hierro, El;1743;904;839
38;Santa Cruz de Tenerife;028;Puerto de la Cruz;29497;14401;15096
38;Santa Cruz de Tenerife;029;Puntagorda;2025;1022;1003
38;Santa Cruz de Tenerife;030;Puntallana;2387;1195;1192
38;Santa Cruz de Tenerife;031;Realejos, Los;36149;17810;18339
38;Santa Cruz de Tenerife;032;Rosario, El;17191;8717;8474
38;Santa Cruz de Tenerife;033;San Andrés y Sauces;4171;2097;2074
38;Santa Cruz de Tenerife;023;San Cristóbal de La Laguna;153111;74324;78787
38;Santa Cruz de Tenerife;034;San Juan de la Rambla;4910;2450;2460
38;Santa Cruz de Tenerife;035;San Miguel de Abona;17870;8994;8876
38;Santa Cruz de Tenerife;036;San Sebastián de la Gomera;8707;4371;4336
38;Santa Cruz de Tenerife;037;Santa Cruz de la Palma;15711;7636;8075
38;Santa Cruz de Tenerife;038;Santa Cruz de Tenerife;203585;97229;106356
38;Santa Cruz de Tenerife;039;Santa Úrsula;14125;7056;7069
38;Santa Cruz de Tenerife;040;Santiago del Teide;11338;5667;5671
38;Santa Cruz de Tenerife;041;Sauzal, El;8873;4386;4487
38;Santa Cruz de Tenerife;042;Silos, Los;4786;2387;2399
38;Santa Cruz de Tenerife;043;Tacoronte;23772;11836;11936
38;Santa Cruz de Tenerife;044;Tanque, El;2658;1296;1362
38;Santa Cruz de Tenerife;045;Tazacorte;4633;2363;2270
38;Santa Cruz de Tenerife;046;Tegueste;11114;5496;5618
38;Santa Cruz de Tenerife;047;Tijarafe;2577;1301;1276
38;Santa Cruz de Tenerife;049;Valle Gran Rey;4285;2175;2110
38;Santa Cruz de Tenerife;050;Vallehermoso;2979;1524;1455
38;Santa Cruz de Tenerife;048;Valverde;4885;2479;2406
38;Santa Cruz de Tenerife;051;Victoria de Acentejo, La;8969;4513;4456
38;Santa Cruz de Tenerife;052;Vilaflor de Chasna;1630;841;789
38;Santa Cruz de Tenerife;053;Villa de Mazo;4821;2412;2409
40;Segovia;001;Abades;862;431;431
40;Segovia;002;Adrada de Pirón;39;19;20
40;Segovia;003;Adrados;149;82;67
40;Segovia;004;Aguilafuente;579;278;301
40;Segovia;005;Alconada de Maderuelo;35;23;12
40;Segovia;012;Aldea Real;322;170;152
40;Segovia;006;Aldealcorvo;24;14;10
40;Segovia;007;Aldealengua de Pedraza;82;51;31
40;Segovia;008;Aldealengua de Santa María;62;32;30
40;Segovia;009;Aldeanueva de la Serrezuela;55;38;17
40;Segovia;010;Aldeanueva del Codonal;136;72;64
40;Segovia;013;Aldeasoña;63;37;26
40;Segovia;014;Aldehorno;57;33;24
40;Segovia;015;Aldehuela del Codonal;31;16;15
40;Segovia;016;Aldeonte;58;27;31
40;Segovia;017;Anaya;126;62;64
40;Segovia;018;Añe;98;54;44
40;Segovia;019;Arahuetes;40;27;13
40;Segovia;020;Arcones;183;89;94
40;Segovia;021;Arevalillo de Cega;29;18;11
40;Segovia;022;Armuña;247;143;104
40;Segovia;024;Ayllón;1253;647;606
40;Segovia;025;Barbolla;186;99;87
40;Segovia;026;Basardilla;143;65;78
40;Segovia;028;Bercial;117;61;56
40;Segovia;029;Bercimuel;31;16;15
40;Segovia;030;Bernardos;534;293;241
40;Segovia;031;Bernuy de Porreros;716;382;334
40;Segovia;032;Boceguillas;754;385;369
40;Segovia;033;Brieva;85;47;38
40;Segovia;034;Caballar;91;49;42
40;Segovia;035;Cabañas de Polendos;178;100;78
40;Segovia;036;Cabezuela;685;353;332
40;Segovia;037;Calabazas de Fuentidueña;38;21;17
40;Segovia;039;Campo de San Pedro;284;156;128
40;Segovia;040;Cantalejo;3628;1808;1820
40;Segovia;041;Cantimpalos;1344;703;641
40;Segovia;043;Carbonero el Mayor;2529;1307;1222
40;Segovia;044;Carrascal del Río;154;84;70
40;Segovia;045;Casla;148;84;64
40;Segovia;046;Castillejo de Mesleón;130;78;52
40;Segovia;047;Castro de Fuentidueña;31;20;11
40;Segovia;048;Castrojimeno;37;19;18
40;Segovia;049;Castroserna de Abajo;51;29;22
40;Segovia;051;Castroserracín;52;29;23
40;Segovia;052;Cedillo de la Torre;103;54;49
40;Segovia;053;Cerezo de Abajo;131;67;64
40;Segovia;054;Cerezo de Arriba;143;80;63
40;Segovia;065;Chañe;850;401;449
40;Segovia;055;Cilleruelo de San Mamés;39;25;14
40;Segovia;056;Cobos de Fuentidueña;32;16;16
40;Segovia;057;Coca;1863;939;924
40;Segovia;058;Codorniz;348;177;171
40;Segovia;059;Collado Hermoso;136;65;71
40;Segovia;060;Condado de Castilnovo;107;60;47
40;Segovia;061;Corral de Ayllón;84;48;36
40;Segovia;902;Cozuelos de Fuentidueña;132;74;58
40;Segovia;062;Cubillo;74;44;30
40;Segovia;063;Cuéllar;9501;4786;4715
40;Segovia;905;Cuevas de Provanco;142;78;64
40;Segovia;068;Domingo García;30;17;13
40;Segovia;069;Donhierro;99;52;47
40;Segovia;070;Duruelo;170;100;70
40;Segovia;071;Encinas;45;23;22
40;Segovia;072;Encinillas;257;146;111
40;Segovia;073;Escalona del Prado;533;282;251
40;Segovia;074;Escarabajosa de Cabezas;313;170;143
40;Segovia;075;Escobar de Polendos;181;96;85
40;Segovia;076;Espinar, El;9212;4727;4485
40;Segovia;077;Espirdo;1189;644;545
40;Segovia;078;Fresneda de Cuéllar;176;99;77
40;Segovia;079;Fresno de Cantespino;272;147;125
40;Segovia;080;Fresno de la Fuente;87;49;38
40;Segovia;081;Frumales;119;61;58
40;Segovia;082;Fuente de Santa Cruz;120;62;58
40;Segovia;083;Fuente el Olmo de Fuentidueña;178;71;107
40;Segovia;084;Fuente el Olmo de Íscar;66;38;28
40;Segovia;086;Fuentepelayo;893;472;421
40;Segovia;087;Fuentepiñel;97;51;46
40;Segovia;088;Fuenterrebollo;358;184;174
40;Segovia;089;Fuentesaúco de Fuentidueña;242;128;114
40;Segovia;091;Fuentesoto;115;60;55
40;Segovia;092;Fuentidueña;148;86;62
40;Segovia;093;Gallegos;94;51;43
40;Segovia;094;Garcillán;447;231;216
40;Segovia;095;Gomezserracín;700;365;335
40;Segovia;097;Grajera;233;128;105
40;Segovia;099;Honrubia de la Cuesta;56;32;24
40;Segovia;100;Hontalbilla;304;162;142
40;Segovia;101;Hontanares de Eresma;1322;696;626
40;Segovia;103;Huertos, Los;183;107;76
40;Segovia;104;Ituero y Lama;358;189;169
40;Segovia;105;Juarros de Riomoros;56;31;25
40;Segovia;106;Juarros de Voltoya;235;117;118
40;Segovia;107;Labajos;136;76;60
40;Segovia;108;Laguna de Contreras;121;69;52
40;Segovia;109;Languilla;82;46;36
40;Segovia;110;Lastras de Cuéllar;403;207;196
40;Segovia;111;Lastras del Pozo;78;37;41
40;Segovia;112;Lastrilla, La;3647;1842;1805
40;Segovia;113;Losa, La;533;294;239
40;Segovia;115;Maderuelo;110;60;50
40;Segovia;903;Marazoleja;109;70;39
40;Segovia;118;Marazuela;54;32;22
40;Segovia;119;Martín Miguel;218;126;92
40;Segovia;120;Martín Muñoz de la Dehesa;227;119;108
40;Segovia;121;Martín Muñoz de las Posadas;315;162;153
40;Segovia;122;Marugán;624;336;288
40;Segovia;124;Mata de Cuéllar;266;138;128
40;Segovia;123;Matabuena;186;109;77
40;Segovia;125;Matilla, La;106;58;48
40;Segovia;126;Melque de Cercos;84;42;42
40;Segovia;127;Membibre de la Hoz;31;17;14
40;Segovia;128;Migueláñez;150;81;69
40;Segovia;129;Montejo de Arévalo;190;104;86
40;Segovia;130;Montejo de la Vega de la Serrezuela;148;88;60
40;Segovia;131;Monterrubio;63;35;28
40;Segovia;132;Moral de Hornuez;64;34;30
40;Segovia;134;Mozoncillo;918;487;431
40;Segovia;135;Muñopedro;325;173;152
40;Segovia;136;Muñoveros;161;79;82
40;Segovia;138;Nava de la Asunción;2849;1440;1409
40;Segovia;139;Navafría;321;170;151
40;Segovia;140;Navalilla;119;61;58
40;Segovia;141;Navalmanzano;1091;574;517
40;Segovia;142;Navares de Ayuso;55;27;28
40;Segovia;143;Navares de Enmedio;96;57;39
40;Segovia;144;Navares de las Cuevas;27;16;11
40;Segovia;145;Navas de Oro;1360;695;665
40;Segovia;904;Navas de Riofrío;423;206;217
40;Segovia;146;Navas de San Antonio;358;186;172
40;Segovia;148;Nieva;299;157;142
40;Segovia;149;Olombrada;599;317;282
40;Segovia;150;Orejana;69;39;30
40;Segovia;151;Ortigosa de Pestaño;67;34;33
40;Segovia;901;Ortigosa del Monte;552;294;258
40;Segovia;152;Otero de Herreros;971;487;484
40;Segovia;154;Pajarejos;19;11;8
40;Segovia;155;Palazuelos de Eresma;5052;2609;2443
40;Segovia;156;Pedraza;414;233;181
40;Segovia;157;Pelayos del Arroyo;51;31;20
40;Segovia;158;Perosillo;17;13;4
40;Segovia;159;Pinarejos;184;105;79
40;Segovia;160;Pinarnegrillo;105;57;48
40;Segovia;161;Pradales;46;26;20
40;Segovia;162;Prádena;540;287;253
40;Segovia;163;Puebla de Pedraza;61;31;30
40;Segovia;164;Rapariegos;197;103;94
40;Segovia;181;Real Sitio de San Ildefonso;5352;2638;2714
40;Segovia;165;Rebollo;84;43;41
40;Segovia;166;Remondo;277;141;136
40;Segovia;168;Riaguas de San Bartolomé;37;22;15
40;Segovia;170;Riaza;2187;1163;1024
40;Segovia;171;Ribota;41;33;8
40;Segovia;172;Riofrío de Riaza;38;24;14
40;Segovia;173;Roda de Eresma;186;102;84
40;Segovia;174;Sacramenia;422;222;200
40;Segovia;176;Samboal;472;257;215
40;Segovia;177;San Cristóbal de Cuéllar;160;85;75
40;Segovia;178;San Cristóbal de la Vega;113;60;53
40;Segovia;906;San Cristóbal de Segovia;2991;1508;1483
40;Segovia;182;San Martín y Mudrián;244;118;126
40;Segovia;183;San Miguel de Bernuy;148;75;73
40;Segovia;184;San Pedro de Gaíllos;308;167;141
40;Segovia;179;Sanchonuño;946;463;483
40;Segovia;180;Sangarcía;328;180;148
40;Segovia;185;Santa María la Real de Nieva;1013;539;474
40;Segovia;186;Santa Marta del Cerro;43;23;20
40;Segovia;188;Santiuste de Pedraza;104;63;41
40;Segovia;189;Santiuste de San Juan Bautista;579;320;259
40;Segovia;190;Santo Domingo de Pirón;62;39;23
40;Segovia;191;Santo Tomé del Puerto;288;162;126
40;Segovia;192;Sauquillo de Cabezas;183;98;85
40;Segovia;193;Sebúlcor;280;149;131
40;Segovia;194;Segovia;52257;24713;27544
40;Segovia;195;Sepúlveda;1122;588;534
40;Segovia;196;Sequera de Fresno;40;24;16
40;Segovia;198;Sotillo;25;15;10
40;Segovia;199;Sotosalbos;115;58;57
40;Segovia;200;Tabanera la Luenga;51;24;27
40;Segovia;201;Tolocirio;56;27;29
40;Segovia;206;Torre Val de San Pedro;190;97;93
40;Segovia;202;Torreadrada;65;30;35
40;Segovia;203;Torrecaballeros;1299;646;653
40;Segovia;204;Torrecilla del Pinar;216;114;102
40;Segovia;205;Torreiglesias;293;152;141
40;Segovia;207;Trescasas;1055;535;520
40;Segovia;208;Turégano;1031;519;512
40;Segovia;210;Urueñas;108;64;44
40;Segovia;211;Valdeprados;80;44;36
40;Segovia;212;Valdevacas de Montejo;30;14;16
40;Segovia;213;Valdevacas y Guijar;94;49;45
40;Segovia;218;Valle de Tabladillo;99;57;42
40;Segovia;219;Vallelado;707;378;329
40;Segovia;220;Valleruela de Pedraza;73;37;36
40;Segovia;221;Valleruela de Sepúlveda;53;27;26
40;Segovia;214;Valseca;255;145;110
40;Segovia;215;Valtiendas;91;53;38
40;Segovia;216;Valverde del Majano;1070;544;526
40;Segovia;222;Veganzones;246;134;112
40;Segovia;223;Vegas de Matute;272;167;105
40;Segovia;224;Ventosilla y Tejadilla;22;15;7
40;Segovia;225;Villacastín;1521;788;733
40;Segovia;228;Villaverde de Íscar;615;326;289
40;Segovia;229;Villaverde de Montejo;35;19;16
40;Segovia;230;Villeguillo;110;68;42
40;Segovia;231;Yanguas de Eresma;138;68;70
40;Segovia;233;Zarzuela del Monte;529;270;259
40;Segovia;234;Zarzuela del Pinar;463;242;221
41;Sevilla;001;Aguadulce;2073;1024;1049
41;Sevilla;002;Alanís;1811;906;905
41;Sevilla;003;Albaida del Aljarafe;3135;1564;1571
41;Sevilla;004;Alcalá de Guadaíra;75080;37297;37783
41;Sevilla;005;Alcalá del Río;11813;5986;5827
41;Sevilla;006;Alcolea del Río;3397;1704;1693
41;Sevilla;007;Algaba, La;16203;8037;8166
41;Sevilla;008;Algámitas;1283;663;620
41;Sevilla;009;Almadén de la Plata;1461;754;707
41;Sevilla;010;Almensilla;5919;2961;2958
41;Sevilla;011;Arahal;19594;9700;9894
41;Sevilla;012;Aznalcázar;4470;2268;2202
41;Sevilla;013;Aznalcóllar;6148;3158;2990
41;Sevilla;014;Badolatosa;3147;1619;1528
41;Sevilla;015;Benacazón;7134;3568;3566
41;Sevilla;016;Bollullos de la Mitación;10330;5208;5122
41;Sevilla;017;Bormujos;21476;10642;10834
41;Sevilla;018;Brenes;12683;6355;6328
41;Sevilla;019;Burguillos;6449;3240;3209
41;Sevilla;020;Cabezas de San Juan, Las;16516;8333;8183
41;Sevilla;021;Camas;27258;13341;13917
41;Sevilla;022;Campana, La;5399;2703;2696
41;Sevilla;023;Cantillana;10645;5440;5205
41;Sevilla;901;Cañada Rosal;3302;1635;1667
41;Sevilla;024;Carmona;28595;14379;14216
41;Sevilla;025;Carrión de los Céspedes;2548;1220;1328
41;Sevilla;026;Casariche;5593;2860;2733
41;Sevilla;027;Castilblanco de los Arroyos;4868;2458;2410
41;Sevilla;028;Castilleja de Guzmán;2857;1478;1379
41;Sevilla;029;Castilleja de la Cuesta;17532;8530;9002
41;Sevilla;030;Castilleja del Campo;635;326;309
41;Sevilla;031;Castillo de las Guardas, El;1480;751;729
41;Sevilla;032;Cazalla de la Sierra;4933;2425;2508
41;Sevilla;033;Constantina;6119;3044;3075
41;Sevilla;034;Coria del Río;30418;15184;15234
41;Sevilla;035;Coripe;1337;669;668
41;Sevilla;036;Coronil, El;4855;2421;2434
41;Sevilla;037;Corrales, Los;3987;2032;1955
41;Sevilla;903;Cuervo de Sevilla, El;8681;4411;4270
41;Sevilla;038;Dos Hermanas;131855;64985;66870
41;Sevilla;039;Écija;40270;19819;20451
41;Sevilla;040;Espartinas;15198;7600;7598
41;Sevilla;041;Estepa;12615;6279;6336
41;Sevilla;042;Fuentes de Andalucía;7166;3562;3604
41;Sevilla;043;Garrobo, El;770;385;385
41;Sevilla;044;Gelves;9951;4936;5015
41;Sevilla;045;Gerena;7444;3751;3693
41;Sevilla;046;Gilena;3825;1935;1890
41;Sevilla;047;Gines;13261;6504;6757
41;Sevilla;048;Guadalcanal;2706;1341;1365
41;Sevilla;049;Guillena;12570;6366;6204
41;Sevilla;050;Herrera;6503;3225;3278
41;Sevilla;051;Huévar del Aljarafe;2836;1452;1384
41;Sevilla;902;Isla Mayor;5911;2950;2961
41;Sevilla;052;Lantejuela;3858;1974;1884
41;Sevilla;053;Lebrija;27398;13683;13715
41;Sevilla;054;Lora de Estepa;848;430;418
41;Sevilla;055;Lora del Río;19124;9486;9638
41;Sevilla;056;Luisiana, La;4604;2321;2283
41;Sevilla;057;Madroño, El;296;144;152
41;Sevilla;058;Mairena del Alcor;23047;11558;11489
41;Sevilla;059;Mairena del Aljarafe;45040;22075;22965
41;Sevilla;060;Marchena;19773;9873;9900
41;Sevilla;061;Marinaleda;2711;1380;1331
41;Sevilla;062;Martín de la Jara;2733;1415;1318
41;Sevilla;063;Molares, Los;3470;1777;1693
41;Sevilla;064;Montellano;7050;3528;3522
41;Sevilla;065;Morón de la Frontera;28073;13888;14185
41;Sevilla;066;Navas de la Concepción, Las;1629;807;822
41;Sevilla;067;Olivares;9415;4724;4691
41;Sevilla;068;Osuna;17738;8811;8927
41;Sevilla;069;Palacios y Villafranca, Los;38173;19240;18933
41;Sevilla;070;Palomares del Río;8315;4179;4136
41;Sevilla;071;Paradas;6991;3490;3501
41;Sevilla;072;Pedrera;5295;2619;2676
41;Sevilla;073;Pedroso, El;2074;1025;1049
41;Sevilla;074;Peñaflor;3697;1861;1836
41;Sevilla;075;Pilas;13999;7073;6926
41;Sevilla;076;Pruna;2664;1357;1307
41;Sevilla;077;Puebla de Cazalla, La;11190;5583;5607
41;Sevilla;078;Puebla de los Infantes, La;3071;1523;1548
41;Sevilla;079;Puebla del Río, La;11995;5945;6050
41;Sevilla;080;Real de la Jara, El;1575;769;806
41;Sevilla;081;Rinconada, La;38277;19019;19258
41;Sevilla;082;Roda de Andalucía, La;4278;2128;2150
41;Sevilla;083;Ronquillo, El;1397;722;675
41;Sevilla;084;Rubio, El;3497;1702;1795
41;Sevilla;085;Salteras;5498;2676;2822
41;Sevilla;086;San Juan de Aznalfarache;21556;10455;11101
41;Sevilla;088;San Nicolás del Puerto;590;303;287
41;Sevilla;087;Sanlúcar la Mayor;13539;6706;6833
41;Sevilla;089;Santiponce;8442;4208;4234
41;Sevilla;090;Saucejo, El;4350;2154;2196
41;Sevilla;091;Sevilla;690566;327866;362700
41;Sevilla;092;Tocina;9689;4805;4884
41;Sevilla;093;Tomares;24851;12307;12544
41;Sevilla;094;Umbrete;8663;4344;4319
41;Sevilla;095;Utrera;52674;26252;26422
41;Sevilla;096;Valencina de la Concepción;7949;3923;4026
41;Sevilla;097;Villamanrique de la Condesa;4462;2191;2271
41;Sevilla;100;Villanueva de San Juan;1202;571;631
41;Sevilla;098;Villanueva del Ariscal;6490;3155;3335
41;Sevilla;099;Villanueva del Río y Minas;4906;2456;2450
41;Sevilla;101;Villaverde del Río;7840;3981;3859
41;Sevilla;102;Viso del Alcor, El;19168;9586;9582
42;Soria;001;Abejar;327;182;145
42;Soria;003;Adradas;48;27;21
42;Soria;004;Ágreda;3008;1536;1472
42;Soria;006;Alconaba;191;122;69
42;Soria;007;Alcubilla de Avellaneda;127;66;61
42;Soria;008;Alcubilla de las Peñas;60;36;24
42;Soria;009;Aldealafuente;87;48;39
42;Soria;010;Aldealices;29;17;12
42;Soria;011;Aldealpozo;19;9;10
42;Soria;012;Aldealseñor;38;21;17
42;Soria;013;Aldehuela de Periáñez;37;21;16
42;Soria;014;Aldehuelas, Las;68;35;33
42;Soria;015;Alentisque;32;18;14
42;Soria;016;Aliud;16;12;4
42;Soria;017;Almajano;181;93;88
42;Soria;018;Almaluez;157;93;64
42;Soria;019;Almarza;590;333;257
42;Soria;020;Almazán;5648;2862;2786
42;Soria;021;Almazul;76;44;32
42;Soria;022;Almenar de Soria;235;140;95
42;Soria;023;Alpanseque;66;36;30
42;Soria;024;Arancón;89;59;30
42;Soria;025;Arcos de Jalón;1573;848;725
42;Soria;026;Arenillas;27;13;14
42;Soria;027;Arévalo de la Sierra;77;50;27
42;Soria;028;Ausejo de la Sierra;89;49;40
42;Soria;029;Baraona;154;93;61
42;Soria;030;Barca;106;66;40
42;Soria;031;Barcones;23;15;8
42;Soria;032;Bayubas de Abajo;152;81;71
42;Soria;033;Bayubas de Arriba;51;30;21
42;Soria;034;Beratón;33;20;13
42;Soria;035;Berlanga de Duero;923;463;460
42;Soria;036;Blacos;50;27;23
42;Soria;037;Bliecos;37;21;16
42;Soria;038;Borjabad;35;21;14
42;Soria;039;Borobia;252;131;121
42;Soria;041;Buberos;34;19;15
42;Soria;042;Buitrago;58;32;26
42;Soria;043;Burgo de Osma-Ciudad de Osma;5005;2489;2516
42;Soria;044;Cabrejas del Campo;57;35;22
42;Soria;045;Cabrejas del Pinar;362;208;154
42;Soria;046;Calatañazor;56;31;25
42;Soria;048;Caltojar;63;39;24
42;Soria;049;Candilichera;122;72;50
42;Soria;050;Cañamaque;34;25;9
42;Soria;051;Carabantes;21;9;12
42;Soria;052;Caracena;16;11;5
42;Soria;053;Carrascosa de Abajo;27;18;9
42;Soria;054;Carrascosa de la Sierra;18;12;6
42;Soria;055;Casarejos;177;93;84
42;Soria;056;Castilfrío de la Sierra;29;19;10
42;Soria;058;Castillejo de Robledo;116;67;49
42;Soria;057;Castilruiz;180;98;82
42;Soria;059;Centenera de Andaluz;21;9;12
42;Soria;060;Cerbón;38;24;14
42;Soria;061;Cidones;334;196;138
42;Soria;062;Cigudosa;22;14;8
42;Soria;063;Cihuela;52;27;25
42;Soria;064;Ciria;90;49;41
42;Soria;065;Cirujales del Río;21;14;7
42;Soria;068;Coscurita;87;52;35
42;Soria;069;Covaleda;1757;905;852
42;Soria;070;Cubilla;35;21;14
42;Soria;071;Cubo de la Solana;184;100;84
42;Soria;073;Cueva de Ágreda;76;46;30
42;Soria;075;Dévanos;90;49;41
42;Soria;076;Deza;239;124;115
42;Soria;078;Duruelo de la Sierra;1146;588;558
42;Soria;079;Escobosa de Almazán;27;19;8
42;Soria;080;Espeja de San Marcelino;174;100;74
42;Soria;081;Espejón;184;93;91
42;Soria;082;Estepa de San Juan;8;6;2
42;Soria;083;Frechilla de Almazán;25;13;12
42;Soria;084;Fresno de Caracena;25;15;10
42;Soria;085;Fuentearmegil;189;105;84
42;Soria;086;Fuentecambrón;39;21;18
42;Soria;087;Fuentecantos;57;28;29
42;Soria;088;Fuentelmonge;72;41;31
42;Soria;089;Fuentelsaz de Soria;59;29;30
42;Soria;090;Fuentepinilla;94;59;35
42;Soria;092;Fuentes de Magaña;65;36;29
42;Soria;093;Fuentestrún;41;27;14
42;Soria;094;Garray;742;399;343
42;Soria;095;Golmayo;2519;1329;1190
42;Soria;096;Gómara;322;177;145
42;Soria;097;Gormaz;26;18;8
42;Soria;098;Herrera de Soria;10;7;3
42;Soria;100;Hinojosa del Campo;32;21;11
42;Soria;103;Langa de Duero;733;399;334
42;Soria;105;Liceras;54;28;26
42;Soria;106;Losilla, La;14;9;5
42;Soria;107;Magaña;79;43;36
42;Soria;108;Maján;13;7;6
42;Soria;110;Matalebreras;66;39;27
42;Soria;111;Matamala de Almazán;326;174;152
42;Soria;113;Medinaceli;741;358;383
42;Soria;115;Miño de Medinaceli;71;46;25
42;Soria;116;Miño de San Esteban;52;33;19
42;Soria;117;Molinos de Duero;171;90;81
42;Soria;118;Momblona;23;16;7
42;Soria;119;Monteagudo de las Vicarías;212;111;101
42;Soria;120;Montejo de Tiermes;172;113;59
42;Soria;121;Montenegro de Cameros;66;42;24
42;Soria;123;Morón de Almazán;213;112;101
42;Soria;124;Muriel de la Fuente;66;38;28
42;Soria;125;Muriel Viejo;86;53;33
42;Soria;127;Nafría de Ucero;35;21;14
42;Soria;128;Narros;44;25;19
42;Soria;129;Navaleno;808;432;376
42;Soria;130;Nepas;59;39;20
42;Soria;131;Nolay;56;30;26
42;Soria;132;Noviercas;155;80;75
42;Soria;134;Ólvega;3661;1890;1771
42;Soria;135;Oncala;75;44;31
42;Soria;139;Pinilla del Campo;24;14;10
42;Soria;140;Portillo de Soria;16;11;5
42;Soria;141;Póveda de Soria, La;114;67;47
42;Soria;142;Pozalmuro;66;29;37
42;Soria;144;Quintana Redonda;515;296;219
42;Soria;145;Quintanas de Gormaz;152;89;63
42;Soria;148;Quiñonería;10;5;5
42;Soria;149;Rábanos, Los;492;280;212
42;Soria;151;Rebollar;39;18;21
42;Soria;152;Recuerda;90;50;40
42;Soria;153;Rello;17;11;6
42;Soria;154;Renieblas;108;65;43
42;Soria;155;Retortillo de Soria;186;109;77
42;Soria;156;Reznos;31;21;10
42;Soria;157;Riba de Escalote, La;15;10;5
42;Soria;158;Rioseco de Soria;129;74;55
42;Soria;159;Rollamienta;39;25;14
42;Soria;160;Royo, El;281;153;128
42;Soria;161;Salduero;144;80;64
42;Soria;162;San Esteban de Gormaz;3043;1606;1437
42;Soria;163;San Felices;58;34;24
42;Soria;164;San Leonardo de Yagüe;2112;1060;1052
42;Soria;165;San Pedro Manrique;593;335;258
42;Soria;166;Santa Cruz de Yanguas;67;43;24
42;Soria;167;Santa María de Huerta;300;167;133
42;Soria;168;Santa María de las Hoyas;113;64;49
42;Soria;171;Serón de Nágima;129;69;60
42;Soria;172;Soliedra;36;20;16
42;Soria;173;Soria;39171;18534;20637
42;Soria;174;Sotillo del Rincón;188;100;88
42;Soria;175;Suellacabras;24;14;10
42;Soria;176;Tajahuerce;31;18;13
42;Soria;177;Tajueco;72;40;32
42;Soria;178;Talveila;127;69;58
42;Soria;181;Tardelcuende;439;231;208
42;Soria;182;Taroda;48;25;23
42;Soria;183;Tejado;124;72;52
42;Soria;184;Torlengua;61;32;29
42;Soria;185;Torreblacos;26;14;12
42;Soria;187;Torrubia de Soria;74;50;24
42;Soria;188;Trévago;50;23;27
42;Soria;189;Ucero;55;28;27
42;Soria;190;Vadillo;100;55;45
42;Soria;191;Valdeavellano de Tera;204;119;85
42;Soria;192;Valdegeña;43;29;14
42;Soria;193;Valdelagua del Cerro;20;14;6
42;Soria;194;Valdemaluque;177;81;96
42;Soria;195;Valdenebro;116;67;49
42;Soria;196;Valdeprado;11;8;3
42;Soria;197;Valderrodilla;77;43;34
42;Soria;198;Valtajeros;25;14;11
42;Soria;200;Velamazán;82;52;30
42;Soria;201;Velilla de la Sierra;23;14;9
42;Soria;202;Velilla de los Ajos;20;11;9
42;Soria;204;Viana de Duero;57;43;14
42;Soria;205;Villaciervos;92;60;32
42;Soria;206;Villanueva de Gormaz;8;5;3
42;Soria;207;Villar del Ala;49;25;24
42;Soria;208;Villar del Campo;22;14;8
42;Soria;209;Villar del Río;141;90;51
42;Soria;211;Villares de Soria, Los;91;52;39
42;Soria;212;Villasayas;75;49;26
42;Soria;213;Villaseca de Arciel;36;19;17
42;Soria;215;Vinuesa;911;492;419
42;Soria;216;Vizmanos;27;19;8
42;Soria;217;Vozmediano;37;24;13
42;Soria;218;Yanguas;104;67;37
42;Soria;219;Yelo;44;26;18
43;Tarragona;001;Aiguamúrcia;903;476;427
43;Tarragona;002;Albinyana;2303;1167;1136
43;Tarragona;003;Albiol, L';459;235;224
43;Tarragona;004;Alcanar;9494;4785;4709
43;Tarragona;005;Alcover;5095;2538;2557
43;Tarragona;904;Aldea, L';4250;2236;2014
43;Tarragona;006;Aldover;863;436;427
43;Tarragona;007;Aleixar, L';887;456;431
43;Tarragona;008;Alfara de Carles;371;199;172
43;Tarragona;009;Alforja;1844;936;908
43;Tarragona;010;Alió;405;193;212
43;Tarragona;011;Almoster;1401;701;700
43;Tarragona;012;Altafulla;5034;2472;2562
43;Tarragona;013;Ametlla de Mar, L';7102;3593;3509
43;Tarragona;906;Ampolla, L';3322;1680;1642
43;Tarragona;014;Amposta;20654;10389;10265
43;Tarragona;016;Arboç, L';5520;2842;2678
43;Tarragona;015;Arbolí;125;72;53
43;Tarragona;017;Argentera, L';136;77;59
43;Tarragona;018;Arnes;472;238;234
43;Tarragona;019;Ascó;1695;881;814
43;Tarragona;020;Banyeres del Penedès;3091;1563;1528
43;Tarragona;021;Barberà de la Conca;478;255;223
43;Tarragona;022;Batea;1967;982;985
43;Tarragona;023;Bellmunt del Priorat;296;145;151
43;Tarragona;024;Bellvei;2190;1136;1054
43;Tarragona;025;Benifallet;708;348;360
43;Tarragona;026;Benissanet;1218;653;565
43;Tarragona;027;Bisbal de Falset, La;208;115;93
43;Tarragona;028;Bisbal del Penedès, La;3466;1831;1635
43;Tarragona;029;Blancafort;393;205;188
43;Tarragona;030;Bonastre;639;327;312
43;Tarragona;031;Borges del Camp, Les;2070;1042;1028
43;Tarragona;032;Bot;615;312;303
43;Tarragona;033;Botarell;1120;587;533
43;Tarragona;034;Bràfim;668;337;331
43;Tarragona;035;Cabacés;326;166;160
43;Tarragona;036;Cabra del Camp;1113;581;532
43;Tarragona;037;Calafell;24289;12192;12097
43;Tarragona;903;Camarles;3349;1707;1642
43;Tarragona;038;Cambrils;33273;16317;16956
43;Tarragona;907;Canonja, La;5846;2886;2960
43;Tarragona;039;Capafonts;112;58;54
43;Tarragona;040;Capçanes;392;192;200
43;Tarragona;041;Caseres;253;127;126
43;Tarragona;042;Castellvell del Camp;2851;1436;1415
43;Tarragona;043;Catllar, El;4211;2170;2041
43;Tarragona;045;Colldejou;171;92;79
43;Tarragona;046;Conesa;116;60;56
43;Tarragona;047;Constantí;6439;3340;3099
43;Tarragona;048;Corbera d'Ebre;1080;568;512
43;Tarragona;049;Cornudella de Montsant;966;524;442
43;Tarragona;050;Creixell;3467;1759;1708
43;Tarragona;051;Cunit;11808;5837;5971
43;Tarragona;901;Deltebre;11544;5841;5703
43;Tarragona;053;Duesaigües;242;136;106
43;Tarragona;054;Espluga de Francolí, L';3791;1824;1967
43;Tarragona;055;Falset;2834;1411;1423
43;Tarragona;056;Fatarella, La;1004;496;508
43;Tarragona;057;Febró, La;40;26;14
43;Tarragona;058;Figuera, La;105;63;42
43;Tarragona;059;Figuerola del Camp;341;165;176
43;Tarragona;060;Flix;3677;1843;1834
43;Tarragona;061;Forès;47;26;21
43;Tarragona;062;Freginals;396;211;185
43;Tarragona;063;Galera, La;748;389;359
43;Tarragona;064;Gandesa;2999;1526;1473
43;Tarragona;065;Garcia;601;306;295
43;Tarragona;066;Garidells, Els;193;94;99
43;Tarragona;067;Ginestar;778;407;371
43;Tarragona;068;Godall;631;318;313
43;Tarragona;069;Gratallops;237;129;108
43;Tarragona;070;Guiamets, Els;273;128;145
43;Tarragona;071;Horta de Sant Joan;1189;621;568
43;Tarragona;072;Lloar, El;123;64;59
43;Tarragona;073;Llorac;96;56;40
43;Tarragona;074;Llorenç del Penedès;2323;1155;1168
43;Tarragona;076;Marçà;586;309;277
43;Tarragona;075;Margalef;97;59;38
43;Tarragona;077;Mas de Barberans;605;296;309
43;Tarragona;078;Masdenverge;1088;555;533
43;Tarragona;079;Masllorenç;502;272;230
43;Tarragona;080;Masó, La;290;155;135
43;Tarragona;081;Maspujols;774;400;374
43;Tarragona;082;Masroig, El;494;273;221
43;Tarragona;083;Milà, El;178;89;89
43;Tarragona;084;Miravet;737;398;339
43;Tarragona;085;Molar, El;282;148;134
43;Tarragona;086;Montblanc;7290;3682;3608
43;Tarragona;088;Montbrió del Camp;2779;1428;1351
43;Tarragona;089;Montferri;400;217;183
43;Tarragona;090;Montmell, El;1397;747;650
43;Tarragona;091;Mont-ral;166;94;72
43;Tarragona;092;Mont-roig del Camp;11521;5970;5551
43;Tarragona;093;Móra d'Ebre;5574;2765;2809
43;Tarragona;094;Móra la Nova;3104;1564;1540
43;Tarragona;095;Morell, El;3550;1808;1742
43;Tarragona;096;Morera de Montsant, La;153;89;64
43;Tarragona;097;Nou de Gaià, La;546;268;278
43;Tarragona;098;Nulles;453;237;216
43;Tarragona;100;Pallaresos, Els;4597;2322;2275
43;Tarragona;099;Palma d'Ebre, La;363;172;191
43;Tarragona;101;Passanant i Belltall;161;93;68
43;Tarragona;102;Paüls;580;280;300
43;Tarragona;103;Perafort;1282;679;603
43;Tarragona;104;Perelló, El;2903;1502;1401
43;Tarragona;105;Piles, Les;207;112;95
43;Tarragona;106;Pinell de Brai, El;1014;510;504
43;Tarragona;107;Pira;500;268;232
43;Tarragona;108;Pla de Santa Maria, El;2294;1191;1103
43;Tarragona;109;Pobla de Mafumet, La;3771;1939;1832
43;Tarragona;110;Pobla de Massaluca, La;333;179;154
43;Tarragona;111;Pobla de Montornès, La;2806;1473;1333
43;Tarragona;112;Poboleda;374;204;170
43;Tarragona;113;Pont d'Armentera, El;515;264;251
43;Tarragona;141;Pontils;120;65;55
43;Tarragona;114;Porrera;445;238;207
43;Tarragona;115;Pradell de la Teixeta;174;76;98
43;Tarragona;116;Prades;587;307;280
43;Tarragona;117;Prat de Comte;177;94;83
43;Tarragona;118;Pratdip;691;366;325
43;Tarragona;119;Puigpelat;1121;572;549
43;Tarragona;120;Querol;543;306;237
43;Tarragona;121;Rasquera;819;399;420
43;Tarragona;122;Renau;148;77;71
43;Tarragona;123;Reus;103615;50188;53427
43;Tarragona;124;Riba, La;594;324;270
43;Tarragona;125;Riba-roja d'Ebre;1156;611;545
43;Tarragona;126;Riera de Gaià, La;1694;846;848
43;Tarragona;127;Riudecanyes;1116;587;529
43;Tarragona;128;Riudecols;1169;614;555
43;Tarragona;129;Riudoms;6591;3397;3194
43;Tarragona;130;Rocafort de Queralt;251;133;118
43;Tarragona;131;Roda de Berà;6391;3309;3082
43;Tarragona;132;Rodonyà;492;254;238
43;Tarragona;133;Roquetes;8165;4241;3924
43;Tarragona;134;Rourell, El;398;203;195
43;Tarragona;135;Salomó;540;277;263
43;Tarragona;905;Salou;26386;13738;12648
43;Tarragona;136;Sant Carles de la Ràpita;14718;7220;7498
43;Tarragona;137;Sant Jaume dels Domenys;2543;1312;1231
43;Tarragona;902;Sant Jaume d'Enveja;3516;1761;1755
43;Tarragona;138;Santa Bàrbara;3774;1926;1848
43;Tarragona;139;Santa Coloma de Queralt;2726;1347;1379
43;Tarragona;140;Santa Oliva;3260;1657;1603
43;Tarragona;142;Sarral;1587;811;776
43;Tarragona;143;Savallà del Comtat;59;29;30
43;Tarragona;144;Secuita, La;1692;850;842
43;Tarragona;145;Selva del Camp, La;5591;2813;2778
43;Tarragona;146;Senan;51;33;18
43;Tarragona;044;Sénia, La;5654;2835;2819
43;Tarragona;147;Solivella;619;314;305
43;Tarragona;148;Tarragona;131094;63798;67296
43;Tarragona;149;Tivenys;887;451;436
43;Tarragona;150;Tivissa;1684;847;837
43;Tarragona;151;Torre de Fontaubella, La;134;69;65
43;Tarragona;152;Torre de l'Espanyol, La;635;331;304
43;Tarragona;153;Torredembarra;15460;7557;7903
43;Tarragona;154;Torroja del Priorat;153;85;68
43;Tarragona;155;Tortosa;33743;16837;16906
43;Tarragona;156;Ulldecona;6368;3271;3097
43;Tarragona;157;Ulldemolins;401;227;174
43;Tarragona;158;Vallclara;110;62;48
43;Tarragona;159;Vallfogona de Riucorb;94;57;37
43;Tarragona;160;Vallmoll;1645;824;821
43;Tarragona;161;Valls;24285;12101;12184
43;Tarragona;162;Vandellòs i l'Hospitalet de l'Infant;6143;3074;3069
43;Tarragona;163;Vendrell, El;36482;18162;18320
43;Tarragona;164;Vespella de Gaià;421;231;190
43;Tarragona;165;Vilabella;760;393;367
43;Tarragona;175;Vilalba dels Arcs;658;331;327
43;Tarragona;166;Vilallonga del Camp;2255;1158;1097
43;Tarragona;168;Vilanova de Prades;118;62;56
43;Tarragona;167;Vilanova d'Escornalbou;542;286;256
43;Tarragona;169;Vilaplana;590;302;288
43;Tarragona;170;Vila-rodona;1255;647;608
43;Tarragona;171;Vila-seca;21935;11021;10914
43;Tarragona;172;Vilaverd;452;235;217
43;Tarragona;173;Vilella Alta, La;135;73;62
43;Tarragona;174;Vilella Baixa, La;193;106;87
43;Tarragona;176;Vimbodí i Poblet;954;528;426
43;Tarragona;177;Vinebre;430;215;215
43;Tarragona;178;Vinyols i els Arcs;1918;994;924
43;Tarragona;052;Xerta;1190;574;616
44;Teruel;001;Ababuj;76;47;29
44;Teruel;002;Abejuela;56;34;22
44;Teruel;003;Aguatón;19;7;12
44;Teruel;004;Aguaviva;550;267;283
44;Teruel;005;Aguilar del Alfambra;64;43;21
44;Teruel;006;Alacón;279;142;137
44;Teruel;007;Alba;196;107;89
44;Teruel;008;Albalate del Arzobispo;2003;1013;990
44;Teruel;009;Albarracín;1054;542;512
44;Teruel;010;Albentosa;267;136;131
44;Teruel;011;Alcaine;70;44;26
44;Teruel;012;Alcalá de la Selva;398;218;180
44;Teruel;013;Alcañiz;16043;7972;8071
44;Teruel;014;Alcorisa;3326;1688;1638
44;Teruel;016;Alfambra;568;300;268
44;Teruel;017;Aliaga;348;191;157
44;Teruel;021;Allepuz;128;63;65
44;Teruel;022;Alloza;602;300;302
44;Teruel;023;Allueva;29;15;14
44;Teruel;018;Almohaja;19;14;5
44;Teruel;019;Alobras;63;37;26
44;Teruel;020;Alpeñés;23;14;9
44;Teruel;024;Anadón;27;17;10
44;Teruel;025;Andorra;7875;3987;3888
44;Teruel;026;Arcos de las Salinas;106;58;48
44;Teruel;027;Arens de Lledó;212;101;111
44;Teruel;028;Argente;207;101;106
44;Teruel;029;Ariño;738;371;367
44;Teruel;031;Azaila;106;52;54
44;Teruel;032;Bádenas;19;11;8
44;Teruel;033;Báguena;316;173;143
44;Teruel;034;Bañón;158;86;72
44;Teruel;035;Barrachina;129;69;60
44;Teruel;036;Bea;35;21;14
44;Teruel;037;Beceite;561;287;274
44;Teruel;039;Bello;245;115;130
44;Teruel;038;Belmonte de San José;119;61;58
44;Teruel;040;Berge;248;128;120
44;Teruel;041;Bezas;65;40;25
44;Teruel;042;Blancas;147;83;64
44;Teruel;043;Blesa;101;64;37
44;Teruel;044;Bordón;114;65;49
44;Teruel;045;Bronchales;417;243;174
44;Teruel;046;Bueña;53;26;27
44;Teruel;047;Burbáguena;254;133;121
44;Teruel;048;Cabra de Mora;68;39;29
44;Teruel;049;Calaceite;1039;520;519
44;Teruel;050;Calamocha;4368;2147;2221
44;Teruel;051;Calanda;3846;1902;1944
44;Teruel;052;Calomarde;80;49;31
44;Teruel;053;Camañas;130;71;59
44;Teruel;054;Camarena de la Sierra;127;78;49
44;Teruel;055;Camarillas;94;56;38
44;Teruel;056;Caminreal;637;330;307
44;Teruel;059;Cantavieja;712;381;331
44;Teruel;060;Cañada de Benatanduz;41;27;14
44;Teruel;061;Cañada de Verich, La;94;58;36
44;Teruel;062;Cañada Vellida;35;25;10
44;Teruel;063;Cañizar del Olivar;94;50;44
44;Teruel;064;Cascante del Río;74;46;28
44;Teruel;065;Castejón de Tornos;62;37;25
44;Teruel;066;Castel de Cabra;120;65;55
44;Teruel;070;Castellar, El;56;36;20
44;Teruel;071;Castellote;706;366;340
44;Teruel;067;Castelnou;137;71;66
44;Teruel;068;Castelserás;827;431;396
44;Teruel;074;Cedrillas;619;318;301
44;Teruel;075;Celadas;403;226;177
44;Teruel;076;Cella;2673;1403;1270
44;Teruel;077;Cerollera, La;96;61;35
44;Teruel;080;Codoñera, La;368;195;173
44;Teruel;082;Corbalán;109;59;50
44;Teruel;084;Cortes de Aragón;63;28;35
44;Teruel;085;Cosa;55;31;24
44;Teruel;086;Cretas;554;277;277
44;Teruel;087;Crivillén;71;35;36
44;Teruel;088;Cuba, La;38;20;18
44;Teruel;089;Cubla;52;35;17
44;Teruel;090;Cucalón;96;57;39
44;Teruel;092;Cuervo, El;89;49;40
44;Teruel;093;Cuevas de Almudén;141;81;60
44;Teruel;094;Cuevas Labradas;127;70;57
44;Teruel;096;Ejulve;189;97;92
44;Teruel;097;Escorihuela;152;75;77
44;Teruel;099;Escucha;954;522;432
44;Teruel;100;Estercuel;237;135;102
44;Teruel;101;Ferreruela de Huerva;67;36;31
44;Teruel;102;Fonfría;31;18;13
44;Teruel;103;Formiche Alto;164;87;77
44;Teruel;105;Fórnoles;86;45;41
44;Teruel;106;Fortanete;204;114;90
44;Teruel;107;Foz-Calanda;264;137;127
44;Teruel;108;Fresneda, La;470;267;203
44;Teruel;109;Frías de Albarracín;130;73;57
44;Teruel;110;Fuenferrada;56;32;24
44;Teruel;111;Fuentes Calientes;105;58;47
44;Teruel;112;Fuentes Claras;494;269;225
44;Teruel;113;Fuentes de Rubielos;114;62;52
44;Teruel;114;Fuentespalda;291;146;145
44;Teruel;115;Galve;159;80;79
44;Teruel;116;Gargallo;102;53;49
44;Teruel;117;Gea de Albarracín;374;198;176
44;Teruel;118;Ginebrosa, La;199;110;89
44;Teruel;119;Griegos;160;94;66
44;Teruel;120;Guadalaviar;245;141;104
44;Teruel;121;Gúdar;73;42;31
44;Teruel;122;Híjar;1724;869;855
44;Teruel;123;Hinojosa de Jarque;131;75;56
44;Teruel;124;Hoz de la Vieja, La;79;41;38
44;Teruel;125;Huesa del Común;69;42;27
44;Teruel;126;Iglesuela del Cid, La;424;222;202
44;Teruel;127;Jabaloyas;77;43;34
44;Teruel;128;Jarque de la Val;74;38;36
44;Teruel;129;Jatiel;42;24;18
44;Teruel;130;Jorcas;38;24;14
44;Teruel;131;Josa;34;20;14
44;Teruel;132;Lagueruela;79;42;37
44;Teruel;133;Lanzuela;27;21;6
44;Teruel;135;Libros;113;70;43
44;Teruel;136;Lidón;55;27;28
44;Teruel;137;Linares de Mora;267;155;112
44;Teruel;141;Lledó;163;86;77
44;Teruel;138;Loscos;138;84;54
44;Teruel;142;Maicas;35;19;16
44;Teruel;143;Manzanera;502;267;235
44;Teruel;144;Martín del Río;429;216;213
44;Teruel;145;Mas de las Matas;1302;684;618
44;Teruel;146;Mata de los Olmos, La;263;130;133
44;Teruel;147;Mazaleón;540;292;248
44;Teruel;148;Mezquita de Jarque;109;63;46
44;Teruel;149;Mirambel;122;69;53
44;Teruel;150;Miravete de la Sierra;28;19;9
44;Teruel;151;Molinos;251;132;119
44;Teruel;152;Monforte de Moyuela;66;47;19
44;Teruel;153;Monreal del Campo;2526;1265;1261
44;Teruel;154;Monroyo;338;205;133
44;Teruel;155;Montalbán;1281;649;632
44;Teruel;156;Monteagudo del Castillo;52;28;24
44;Teruel;157;Monterde de Albarracín;66;36;30
44;Teruel;158;Mora de Rubielos;1574;798;776
44;Teruel;159;Moscardón;56;29;27
44;Teruel;160;Mosqueruela;581;322;259
44;Teruel;161;Muniesa;629;333;296
44;Teruel;163;Noguera de Albarracín;146;79;67
44;Teruel;164;Nogueras;29;20;9
44;Teruel;165;Nogueruelas;214;117;97
44;Teruel;167;Obón;44;24;20
44;Teruel;168;Odón;225;122;103
44;Teruel;169;Ojos Negros;405;218;187
44;Teruel;171;Olba;230;133;97
44;Teruel;172;Oliete;365;187;178
44;Teruel;173;Olmos, Los;127;68;59
44;Teruel;174;Orihuela del Tremedal;504;273;231
44;Teruel;175;Orrios;133;69;64
44;Teruel;176;Palomar de Arroyos;174;104;70
44;Teruel;177;Pancrudo;116;72;44
44;Teruel;178;Parras de Castellote, Las;57;33;24
44;Teruel;179;Peñarroya de Tastavins;465;252;213
44;Teruel;180;Peracense;75;43;32
44;Teruel;181;Peralejos;86;44;42
44;Teruel;182;Perales del Alfambra;227;119;108
44;Teruel;183;Pitarque;91;46;45
44;Teruel;184;Plou;49;31;18
44;Teruel;185;Pobo, El;132;84;48
44;Teruel;187;Portellada, La;240;119;121
44;Teruel;189;Pozondón;60;33;27
44;Teruel;190;Pozuel del Campo;72;39;33
44;Teruel;191;Puebla de Híjar, La;930;466;464
44;Teruel;192;Puebla de Valverde, La;460;253;207
44;Teruel;193;Puertomingalvo;112;64;48
44;Teruel;194;Ráfales;138;75;63
44;Teruel;195;Rillo;92;52;40
44;Teruel;196;Riodeva;151;73;78
44;Teruel;197;Ródenas;64;36;28
44;Teruel;198;Royuela;215;117;98
44;Teruel;199;Rubiales;50;29;21
44;Teruel;200;Rubielos de la Cérida;39;22;17
44;Teruel;201;Rubielos de Mora;658;342;316
44;Teruel;203;Salcedillo;17;14;3
44;Teruel;204;Saldón;26;16;10
44;Teruel;205;Samper de Calanda;845;422;423
44;Teruel;206;San Agustín;132;84;48
44;Teruel;207;San Martín del Río;163;84;79
44;Teruel;208;Santa Cruz de Nogueras;40;20;20
44;Teruel;209;Santa Eulalia;1059;532;527
44;Teruel;210;Sarrión;1125;596;529
44;Teruel;211;Segura de los Baños;44;28;16
44;Teruel;212;Seno;41;19;22
44;Teruel;213;Singra;80;46;34
44;Teruel;215;Terriente;173;99;74
44;Teruel;216;Teruel;35564;17008;18556
44;Teruel;217;Toril y Masegoso;30;25;5
44;Teruel;218;Tormón;34;20;14
44;Teruel;219;Tornos;228;122;106
44;Teruel;220;Torralba de los Sisones;163;91;72
44;Teruel;223;Torre de Arcas;81;38;43
44;Teruel;224;Torre de las Arcas;29;14;15
44;Teruel;225;Torre del Compte;129;63;66
44;Teruel;227;Torre los Negros;87;46;41
44;Teruel;221;Torrecilla de Alcañiz;424;225;199
44;Teruel;222;Torrecilla del Rebollar;137;87;50
44;Teruel;226;Torrelacárcel;176;90;86
44;Teruel;228;Torremocha de Jiloca;110;63;47
44;Teruel;229;Torres de Albarracín;179;100;79
44;Teruel;230;Torrevelilla;203;95;108
44;Teruel;231;Torrijas;45;21;24
44;Teruel;232;Torrijo del Campo;462;243;219
44;Teruel;234;Tramacastiel;66;37;29
44;Teruel;235;Tramacastilla;108;51;57
44;Teruel;236;Tronchón;67;36;31
44;Teruel;237;Urrea de Gaén;475;237;238
44;Teruel;238;Utrillas;3056;1574;1482
44;Teruel;239;Valacloche;23;13;10
44;Teruel;240;Valbona;186;102;84
44;Teruel;241;Valdealgorfa;645;325;320
44;Teruel;243;Valdecuenca;34;23;11
44;Teruel;244;Valdelinares;90;55;35
44;Teruel;245;Valdeltormo;296;146;150
44;Teruel;246;Valderrobres;2311;1171;1140
44;Teruel;247;Valjunquera;363;187;176
44;Teruel;249;Vallecillo, El;59;35;24
44;Teruel;250;Veguillas de la Sierra;19;11;8
44;Teruel;251;Villafranca del Campo;300;158;142
44;Teruel;252;Villahermosa del Campo;99;67;32
44;Teruel;256;Villanueva del Rebollar de la Sierra;49;28;21
44;Teruel;257;Villar del Cobo;188;105;83
44;Teruel;258;Villar del Salz;70;42;28
44;Teruel;260;Villarluengo;176;106;70
44;Teruel;261;Villarquemado;863;452;411
44;Teruel;262;Villarroya de los Pinares;160;84;76
44;Teruel;263;Villastar;503;256;247
44;Teruel;264;Villel;338;196;142
44;Teruel;265;Vinaceite;262;134;128
44;Teruel;266;Visiedo;138;64;74
44;Teruel;267;Vivel del Río Martín;78;42;36
44;Teruel;268;Zoma, La;16;5;11
45;Toledo;001;Ajofrín;2267;1133;1134
45;Toledo;002;Alameda de la Sagra;3561;1864;1697
45;Toledo;003;Albarreal de Tajo;701;365;336
45;Toledo;004;Alcabón;705;369;336
45;Toledo;005;Alcañizo;281;142;139
45;Toledo;006;Alcaudete de la Jara;1832;937;895
45;Toledo;007;Alcolea de Tajo;835;417;418
45;Toledo;008;Aldea en Cabo;172;89;83
45;Toledo;009;Aldeanueva de Barbarroya;594;294;300
45;Toledo;010;Aldeanueva de San Bartolomé;449;228;221
45;Toledo;011;Almendral de la Cañada;320;173;147
45;Toledo;012;Almonacid de Toledo;851;417;434
45;Toledo;013;Almorox;2240;1177;1063
45;Toledo;014;Añover de Tajo;5160;2654;2506
45;Toledo;015;Arcicóllar;784;393;391
45;Toledo;016;Argés;6093;3061;3032
45;Toledo;017;Azután;289;143;146
45;Toledo;018;Barcience;783;421;362
45;Toledo;019;Bargas;10021;4976;5045
45;Toledo;020;Belvís de la Jara;1611;810;801
45;Toledo;021;Borox;3614;1878;1736
45;Toledo;022;Buenaventura;430;226;204
45;Toledo;023;Burguillos de Toledo;3092;1580;1512
45;Toledo;024;Burujón;1379;725;654
45;Toledo;025;Cabañas de la Sagra;1781;932;849
45;Toledo;026;Cabañas de Yepes;251;130;121
45;Toledo;027;Cabezamesada;385;209;176
45;Toledo;028;Calera y Chozas;4633;2362;2271
45;Toledo;029;Caleruela;225;114;111
45;Toledo;030;Calzada de Oropesa;541;296;245
45;Toledo;031;Camarena;3723;1931;1792
45;Toledo;032;Camarenilla;565;291;274
45;Toledo;033;Campillo de la Jara, El;390;206;184
45;Toledo;034;Camuñas;1812;927;885
45;Toledo;035;Cardiel de los Montes;353;186;167
45;Toledo;036;Carmena;771;402;369
45;Toledo;037;Carpio de Tajo, El;1963;982;981
45;Toledo;038;Carranque;4612;2378;2234
45;Toledo;039;Carriches;282;145;137
45;Toledo;040;Casar de Escalona, El;1933;1024;909
45;Toledo;041;Casarrubios del Monte;5309;2787;2522
45;Toledo;042;Casasbuenas;210;107;103
45;Toledo;043;Castillo de Bayuela;946;480;466
45;Toledo;045;Cazalegas;1764;886;878
45;Toledo;046;Cebolla;3445;1742;1703
45;Toledo;047;Cedillo del Condado;3680;1909;1771
45;Toledo;048;Cerralbos, Los;415;225;190
45;Toledo;049;Cervera de los Montes;539;275;264
45;Toledo;056;Chozas de Canales;3710;1955;1755
45;Toledo;057;Chueca;268;142;126
45;Toledo;050;Ciruelos;556;299;257
45;Toledo;051;Cobeja;2201;1152;1049
45;Toledo;052;Cobisa;4186;2096;2090
45;Toledo;053;Consuegra;10328;5217;5111
45;Toledo;054;Corral de Almaguer;5536;2823;2713
45;Toledo;055;Cuerva;1385;725;660
45;Toledo;058;Domingo Pérez;436;219;217
45;Toledo;059;Dosbarrios;2241;1149;1092
45;Toledo;060;Erustes;222;115;107
45;Toledo;061;Escalona;3203;1638;1565
45;Toledo;062;Escalonilla;1462;728;734
45;Toledo;063;Espinoso del Rey;497;271;226
45;Toledo;064;Esquivias;5386;2724;2662
45;Toledo;065;Estrella, La;250;128;122
45;Toledo;066;Fuensalida;11001;5561;5440
45;Toledo;067;Gálvez;3136;1572;1564
45;Toledo;068;Garciotum;181;91;90
45;Toledo;069;Gerindote;2384;1226;1158
45;Toledo;070;Guadamur;1833;921;912
45;Toledo;071;Guardia, La;2286;1159;1127
45;Toledo;072;Herencias, Las;815;432;383
45;Toledo;073;Herreruela de Oropesa;365;181;184
45;Toledo;074;Hinojosa de San Vicente;413;225;188
45;Toledo;075;Hontanar;158;95;63
45;Toledo;076;Hormigos;722;387;335
45;Toledo;077;Huecas;657;338;319
45;Toledo;078;Huerta de Valdecarábanos;1770;876;894
45;Toledo;079;Iglesuela, La;433;227;206
45;Toledo;080;Illán de Vacas;6;4;2
45;Toledo;081;Illescas;26672;13560;13112
45;Toledo;082;Lagartera;1468;727;741
45;Toledo;083;Layos;625;310;315
45;Toledo;084;Lillo;2754;1428;1326
45;Toledo;085;Lominchar;2365;1240;1125
45;Toledo;086;Lucillos;602;316;286
45;Toledo;087;Madridejos;10793;5436;5357
45;Toledo;088;Magán;3225;1653;1572
45;Toledo;089;Malpica de Tajo;1842;939;903
45;Toledo;090;Manzaneque;406;198;208
45;Toledo;091;Maqueda;480;242;238
45;Toledo;092;Marjaliza;288;142;146
45;Toledo;093;Marrupe;163;85;78
45;Toledo;094;Mascaraque;446;223;223
45;Toledo;095;Mata, La;908;458;450
45;Toledo;096;Mazarambroz;1278;657;621
45;Toledo;097;Mejorada;1268;657;611
45;Toledo;098;Menasalbas;2785;1459;1326
45;Toledo;099;Méntrida;4909;2515;2394
45;Toledo;100;Mesegar de Tajo;224;118;106
45;Toledo;101;Miguel Esteban;5042;2516;2526
45;Toledo;102;Mocejón;4844;2458;2386
45;Toledo;103;Mohedas de la Jara;436;241;195
45;Toledo;104;Montearagón;522;275;247
45;Toledo;105;Montesclaros;426;228;198
45;Toledo;106;Mora;9897;4968;4929
45;Toledo;107;Nambroca;4524;2320;2204
45;Toledo;108;Nava de Ricomalillo, La;570;292;278
45;Toledo;109;Navahermosa;3818;1973;1845
45;Toledo;110;Navalcán;2137;1139;998
45;Toledo;111;Navalmoralejo;70;38;32
45;Toledo;112;Navalmorales, Los;2673;1400;1273
45;Toledo;113;Navalucillos, Los;2309;1190;1119
45;Toledo;114;Navamorcuende;655;334;321
45;Toledo;115;Noblejas;3533;1796;1737
45;Toledo;116;Noez;899;453;446
45;Toledo;117;Nombela;920;482;438
45;Toledo;118;Novés;2707;1413;1294
45;Toledo;119;Numancia de la Sagra;4734;2483;2251
45;Toledo;120;Nuño Gómez;143;77;66
45;Toledo;121;Ocaña;10489;5315;5174
45;Toledo;122;Olías del Rey;7357;3737;3620
45;Toledo;123;Ontígola;4250;2266;1984
45;Toledo;124;Orgaz;2706;1349;1357
45;Toledo;125;Oropesa;2744;1347;1397
45;Toledo;126;Otero;356;183;173
45;Toledo;127;Palomeque;876;477;399
45;Toledo;128;Pantoja;3335;1678;1657
45;Toledo;129;Paredes de Escalona;137;65;72
45;Toledo;130;Parrillas;365;192;173
45;Toledo;131;Pelahustán;333;181;152
45;Toledo;132;Pepino;2801;1462;1339
45;Toledo;133;Polán;3833;1925;1908
45;Toledo;134;Portillo de Toledo;2153;1073;1080
45;Toledo;135;Puebla de Almoradiel, La;5454;2764;2690
45;Toledo;136;Puebla de Montalbán, La;7959;4038;3921
45;Toledo;137;Pueblanueva, La;2244;1122;1122
45;Toledo;138;Puente del Arzobispo, El;1296;636;660
45;Toledo;139;Puerto de San Vicente;174;92;82
45;Toledo;140;Pulgar;1558;794;764
45;Toledo;141;Quero;1065;544;521
45;Toledo;142;Quintanar de la Orden;11130;5562;5568
45;Toledo;143;Quismondo;1525;778;747
45;Toledo;144;Real de San Vicente, El;998;526;472
45;Toledo;145;Recas;4309;2395;1914
45;Toledo;146;Retamoso de la Jara;110;54;56
45;Toledo;147;Rielves;746;376;370
45;Toledo;148;Robledo del Mazo;310;171;139
45;Toledo;149;Romeral, El;641;321;320
45;Toledo;150;San Bartolomé de las Abiertas;495;263;232
45;Toledo;151;San Martín de Montalbán;786;391;395
45;Toledo;152;San Martín de Pusa;712;371;341
45;Toledo;153;San Pablo de los Montes;1900;961;939
45;Toledo;154;San Román de los Montes;1869;993;876
45;Toledo;155;Santa Ana de Pusa;413;236;177
45;Toledo;156;Santa Cruz de la Zarza;4328;2185;2143
45;Toledo;157;Santa Cruz del Retamar;2857;1476;1381
45;Toledo;158;Santa Olalla;3220;1640;1580
45;Toledo;901;Santo Domingo-Caudilla;1014;535;479
45;Toledo;159;Sartajada;102;59;43
45;Toledo;160;Segurilla;1317;672;645
45;Toledo;161;Seseña;22027;11440;10587
45;Toledo;162;Sevilleja de la Jara;729;395;334
45;Toledo;163;Sonseca;11198;5679;5519
45;Toledo;164;Sotillo de las Palomas;204;111;93
45;Toledo;165;Talavera de la Reina;84119;40543;43576
45;Toledo;166;Tembleque;2091;1069;1022
45;Toledo;167;Toboso, El;1887;948;939
45;Toledo;168;Toledo;83459;39986;43473
45;Toledo;169;Torralba de Oropesa;215;113;102
45;Toledo;171;Torre de Esteban Hambrán, La;1729;886;843
45;Toledo;170;Torrecilla de la Jara;251;130;121
45;Toledo;172;Torrico;781;401;380
45;Toledo;173;Torrijos;13257;6522;6735
45;Toledo;174;Totanés;362;185;177
45;Toledo;175;Turleque;813;419;394
45;Toledo;176;Ugena;5294;2724;2570
45;Toledo;177;Urda;2705;1337;1368
45;Toledo;179;Valdeverdeja;613;303;310
45;Toledo;180;Valmojado;4113;2087;2026
45;Toledo;181;Velada;2890;1494;1396
45;Toledo;182;Ventas con Peña Aguilera, Las;1183;601;582
45;Toledo;183;Ventas de Retamosa, Las;3275;1718;1557
45;Toledo;184;Ventas de San Julián, Las;235;112;123
45;Toledo;186;Villa de Don Fadrique, La;3854;1920;1934
45;Toledo;185;Villacañas;9935;4930;5005
45;Toledo;187;Villafranca de los Caballeros;5098;2532;2566
45;Toledo;188;Villaluenga de la Sagra;3828;1903;1925
45;Toledo;189;Villamiel de Toledo;857;451;406
45;Toledo;190;Villaminaya;567;288;279
45;Toledo;191;Villamuelas;651;341;310
45;Toledo;192;Villanueva de Alcardete;3451;1801;1650
45;Toledo;193;Villanueva de Bogas;755;392;363
45;Toledo;194;Villarejo de Montalbán;77;42;35
45;Toledo;195;Villarrubia de Santiago;2611;1315;1296
45;Toledo;196;Villaseca de la Sagra;1831;912;919
45;Toledo;197;Villasequilla;2503;1280;1223
45;Toledo;198;Villatobas;2433;1248;1185
45;Toledo;199;Viso de San Juan, El;4207;2252;1955
45;Toledo;200;Yébenes, Los;6095;3128;2967
45;Toledo;201;Yeles;5052;2660;2392
45;Toledo;202;Yepes;5066;2589;2477
45;Toledo;203;Yuncler;3648;1848;1800
45;Toledo;204;Yunclillos;864;448;416
45;Toledo;205;Yuncos;10613;5471;5142
46;Valencia/València;001;Ademuz;1137;605;532
46;Valencia/València;002;Ador;1437;757;680
46;Valencia/València;004;Agullent;2395;1188;1207
46;Valencia/València;042;Aielo de Malferit;4724;2356;2368
46;Valencia/València;043;Aielo de Rugat;168;89;79
46;Valencia/València;005;Alaquàs;29660;14582;15078
46;Valencia/València;006;Albaida;5933;2923;3010
46;Valencia/València;007;Albal;16136;8072;8064
46;Valencia/València;008;Albalat de la Ribera;3431;1742;1689
46;Valencia/València;009;Albalat dels Sorells;3889;1885;2004
46;Valencia/València;010;Albalat dels Tarongers;1185;627;558
46;Valencia/València;011;Alberic;10537;5299;5238
46;Valencia/València;012;Alborache;1147;596;551
46;Valencia/València;013;Alboraya;23837;11678;12159
46;Valencia/València;014;Albuixech;3919;1955;1964
46;Valencia/València;016;Alcàntera de Xúquer;1319;650;669
46;Valencia/València;015;Alcàsser;9692;4905;4787
46;Valencia/València;018;Alcublas;691;357;334
46;Valencia/València;020;Alcúdia de Crespins, l';5181;2584;2597
46;Valencia/València;019;Alcúdia, l';11820;5794;6026
46;Valencia/València;021;Aldaia;31246;15612;15634
46;Valencia/València;022;Alfafar;20777;10186;10591
46;Valencia/València;024;Alfara de la Baronia;522;264;258
46;Valencia/València;025;Alfara del Patriarca;3323;1627;1696
46;Valencia/València;026;Alfarp;1510;781;729
46;Valencia/València;027;Alfarrasí;1274;634;640
46;Valencia/València;023;Alfauir;451;229;222
46;Valencia/València;028;Algar de Palancia;484;246;238
46;Valencia/València;029;Algemesí;27607;13706;13901
46;Valencia/València;030;Algimia de Alfara;1047;532;515
46;Valencia/València;031;Alginet;13283;6760;6523
46;Valencia/València;032;Almàssera;7297;3553;3744
46;Valencia/València;033;Almiserà;273;136;137
46;Valencia/València;034;Almoines;2322;1176;1146
46;Valencia/València;035;Almussafes;8869;4448;4421
46;Valencia/València;036;Alpuente;641;353;288
46;Valencia/València;037;Alqueria de la Comtessa, l';1451;713;738
46;Valencia/València;017;Alzira;44488;21659;22829
46;Valencia/València;038;Andilla;349;222;127
46;Valencia/València;039;Anna;2678;1348;1330
46;Valencia/València;040;Antella;1271;622;649
46;Valencia/València;041;Aras de los Olmos;381;213;168
46;Valencia/València;003;Atzeneta d'Albaida;1153;593;560
46;Valencia/València;044;Ayora;5320;2675;2645
46;Valencia/València;046;Barx;1280;662;618
46;Valencia/València;045;Barxeta;1607;826;781
46;Valencia/València;047;Bèlgida;689;337;352
46;Valencia/València;048;Bellreguard;4582;2280;2302
46;Valencia/València;049;Bellús;319;160;159
46;Valencia/València;050;Benagéber;207;115;92
46;Valencia/València;051;Benaguasil;10967;5582;5385
46;Valencia/València;052;Benavites;613;289;324
46;Valencia/València;053;Beneixida;674;324;350
46;Valencia/València;054;Benetússer;14505;7048;7457
46;Valencia/València;055;Beniarjó;1756;874;882
46;Valencia/València;056;Beniatjar;226;115;111
46;Valencia/València;057;Benicolet;610;306;304
46;Valencia/València;904;Benicull de Xúquer;972;497;475
46;Valencia/València;060;Benifaió;11903;5904;5999
46;Valencia/València;059;Benifairó de la Valldigna;1600;791;809
46;Valencia/València;058;Benifairó de les Valls;2218;1113;1105
46;Valencia/València;061;Beniflá;453;229;224
46;Valencia/València;062;Benigànim;5912;2997;2915
46;Valencia/València;063;Benimodo;2237;1156;1081
46;Valencia/València;064;Benimuslem;644;332;312
46;Valencia/València;065;Beniparrell;1948;1003;945
46;Valencia/València;066;Benirredrà;1596;769;827
46;Valencia/València;067;Benisanó;2226;1109;1117
46;Valencia/València;068;Benissoda;429;234;195
46;Valencia/València;069;Benisuera;187;93;94
46;Valencia/València;070;Bétera;22696;11368;11328
46;Valencia/València;071;Bicorp;527;272;255
46;Valencia/València;072;Bocairent;4288;2157;2131
46;Valencia/València;073;Bolbaite;1369;690;679
46;Valencia/València;074;Bonrepòs i Mirambell;3614;1768;1846
46;Valencia/València;075;Bufali;168;93;75
46;Valencia/València;076;Bugarra;728;363;365
46;Valencia/València;077;Buñol;9618;4820;4798
46;Valencia/València;078;Burjassot;37324;18026;19298
46;Valencia/València;079;Calles;364;207;157
46;Valencia/València;080;Camporrobles;1255;642;613
46;Valencia/València;081;Canals;13775;6906;6869
46;Valencia/València;082;Canet d'En Berenguer;6513;3332;3181
46;Valencia/València;083;Carcaixent;20520;10162;10358
46;Valencia/València;084;Càrcer;1949;940;1009
46;Valencia/València;085;Carlet;15384;7662;7722
46;Valencia/València;086;Carrícola;95;48;47
46;Valencia/València;087;Casas Altas;148;78;70
46;Valencia/València;088;Casas Bajas;179;92;87
46;Valencia/València;089;Casinos;2783;1430;1353
46;Valencia/València;090;Castelló de Rugat;2277;1167;1110
46;Valencia/València;091;Castellonet de la Conquesta;141;76;65
46;Valencia/València;092;Castielfabib;330;168;162
46;Valencia/València;093;Catadau;2737;1362;1375
46;Valencia/València;094;Catarroja;27728;13736;13992
46;Valencia/València;095;Caudete de las Fuentes;743;394;349
46;Valencia/València;096;Cerdà;363;190;173
46;Valencia/València;107;Chella;2530;1242;1288
46;Valencia/València;106;Chelva;1466;757;709
46;Valencia/València;108;Chera;510;272;238
46;Valencia/València;109;Cheste;8471;4338;4133
46;Valencia/València;111;Chiva;14758;7583;7175
46;Valencia/València;112;Chulilla;632;333;299
46;Valencia/València;097;Cofrentes;1114;570;544
46;Valencia/València;098;Corbera;3207;1598;1609
46;Valencia/València;099;Cortes de Pallás;968;524;444
46;Valencia/València;100;Cotes;354;172;182
46;Valencia/València;105;Cullera;22139;11001;11138
46;Valencia/València;113;Daimús;3058;1537;1521
46;Valencia/València;114;Domeño;686;353;333
46;Valencia/València;115;Dos Aguas;394;223;171
46;Valencia/València;116;Eliana, l';17591;8637;8954
46;Valencia/València;117;Emperador;676;357;319
46;Valencia/València;118;Enguera;5027;2497;2530
46;Valencia/València;119;Ènova, l';936;477;459
46;Valencia/València;120;Estivella;1374;678;696
46;Valencia/València;121;Estubeny;118;59;59
46;Valencia/València;122;Faura;3493;1763;1730
46;Valencia/València;123;Favara;2467;1250;1217
46;Valencia/València;126;Foios;7208;3546;3662
46;Valencia/València;128;Font de la Figuera, la;2109;1054;1055
46;Valencia/València;127;Font d'En Carròs, la;3764;1877;1887
46;Valencia/València;124;Fontanars dels Alforins;973;497;476
46;Valencia/València;125;Fortaleny;1021;509;512
46;Valencia/València;129;Fuenterrobles;690;379;311
46;Valencia/València;131;Gandia;74814;37046;37768
46;Valencia/València;902;Gátova;366;172;194
46;Valencia/València;130;Gavarda;1089;519;570
46;Valencia/València;132;Genovés;2809;1425;1384
46;Valencia/València;133;Gestalgar;634;330;304
46;Valencia/València;134;Gilet;3304;1704;1600
46;Valencia/València;135;Godella;13029;6325;6704
46;Valencia/València;136;Godelleta;3396;1730;1666
46;Valencia/València;137;Granja de la Costera, la;333;173;160
46;Valencia/València;138;Guadasséquies;456;243;213
46;Valencia/València;139;Guadassuar;5898;2887;3011
46;Valencia/València;140;Guardamar de la Safor;490;265;225
46;Valencia/València;141;Higueruelas;511;269;242
46;Valencia/València;142;Jalance;885;462;423
46;Valencia/València;144;Jarafuel;785;403;382
46;Valencia/València;154;Llanera de Ranes;1046;525;521
46;Valencia/València;155;Llaurí;1212;613;599
46;Valencia/València;147;Llíria;22796;11555;11241
46;Valencia/València;152;Llocnou de la Corona;137;71;66
46;Valencia/València;153;Llocnou de Sant Jeroni;543;275;268
46;Valencia/València;151;Llocnou d'En Fenollet;907;472;435
46;Valencia/València;156;Llombai;2753;1388;1365
46;Valencia/València;157;Llosa de Ranes, la;3511;1808;1703
46;Valencia/València;150;Llutxent;2402;1232;1170
46;Valencia/València;148;Loriguilla;1998;1044;954
46;Valencia/València;149;Losa del Obispo;514;265;249
46;Valencia/València;158;Macastre;1237;651;586
46;Valencia/València;159;Manises;30704;15144;15560
46;Valencia/València;160;Manuel;2459;1204;1255
46;Valencia/València;161;Marines;1869;961;908
46;Valencia/València;162;Massalavés;1571;819;752
46;Valencia/València;163;Massalfassar;2472;1231;1241
46;Valencia/València;164;Massamagrell;15574;7713;7861
46;Valencia/València;165;Massanassa;9341;4638;4703
46;Valencia/València;166;Meliana;10619;5239;5380
46;Valencia/València;167;Millares;369;186;183
46;Valencia/València;168;Miramar;2609;1349;1260
46;Valencia/València;169;Mislata;42988;20833;22155
46;Valencia/València;170;Mogente/Moixent;4378;2204;2174
46;Valencia/València;171;Moncada;21700;10665;11035
46;Valencia/València;173;Montaverner;1691;846;845
46;Valencia/València;174;Montesa;1227;620;607
46;Valencia/València;175;Montitxelvo/Montichelvo;644;321;323
46;Valencia/València;176;Montroi/Montroy;2907;1558;1349
46;Valencia/València;172;Montserrat;7295;3792;3503
46;Valencia/València;177;Museros;6252;3137;3115
46;Valencia/València;178;Náquera;6087;3187;2900
46;Valencia/València;179;Navarrés;3056;1540;1516
46;Valencia/València;180;Novelé/Novetlè;854;422;432
46;Valencia/València;181;Oliva;25789;12764;13025
46;Valencia/València;183;Olleria, l';8311;4186;4125
46;Valencia/València;182;Olocau;1685;890;795
46;Valencia/València;184;Ontinyent;35534;17610;17924
46;Valencia/València;185;Otos;448;228;220
46;Valencia/València;186;Paiporta;25084;12521;12563
46;Valencia/València;187;Palma de Gandía;1561;798;763
46;Valencia/València;188;Palmera;1011;534;477
46;Valencia/València;189;Palomar, el;581;294;287
46;Valencia/València;190;Paterna;67854;33627;34227
46;Valencia/València;191;Pedralba;2813;1484;1329
46;Valencia/València;192;Petrés;959;468;491
46;Valencia/València;193;Picanya;11281;5539;5742
46;Valencia/València;194;Picassent;20498;10364;10134
46;Valencia/València;195;Piles;2757;1381;1376
46;Valencia/València;196;Pinet;163;81;82
46;Valencia/València;199;Pobla de Farnals, la;7698;3872;3826
46;Valencia/València;202;Pobla de Vallbona, la;23403;11811;11592
46;Valencia/València;200;Pobla del Duc, la;2564;1256;1308
46;Valencia/València;203;Pobla Llarga, la;4546;2268;2278
46;Valencia/València;197;Polinyà de Xúquer;2464;1252;1212
46;Valencia/València;198;Potries;1017;512;505
46;Valencia/València;205;Puçol;19438;9607;9831
46;Valencia/València;201;Puebla de San Miguel;64;39;25
46;Valencia/València;204;Puig de Santa Maria, el;8735;4231;4504
46;Valencia/València;101;Quart de les Valls;1039;500;539
46;Valencia/València;102;Quart de Poblet;24776;12168;12608
46;Valencia/València;103;Quartell;1538;743;795
46;Valencia/València;104;Quatretonda;2338;1175;1163
46;Valencia/València;206;Quesa;680;352;328
46;Valencia/València;207;Rafelbunyol;8907;4418;4489
46;Valencia/València;208;Rafelcofer;1374;663;711
46;Valencia/València;209;Rafelguaraf;2403;1191;1212
46;Valencia/València;210;Ráfol de Salem;423;207;216
46;Valencia/València;212;Real;2263;1170;1093
46;Valencia/València;211;Real de Gandía;2286;1120;1166
46;Valencia/València;213;Requena;20510;10234;10276
46;Valencia/València;214;Riba-roja de Túria;21521;10926;10595
46;Valencia/València;215;Riola;1832;929;903
46;Valencia/València;216;Rocafort;6940;3425;3515
46;Valencia/València;217;Rotglà i Corberà;1123;558;565
46;Valencia/València;218;Rótova;1276;663;613
46;Valencia/València;219;Rugat;179;95;84
46;Valencia/València;220;Sagunto/Sagunt;64439;31551;32888
46;Valencia/València;221;Salem;437;218;219
46;Valencia/València;903;San Antonio de Benagéber;8463;4171;4292
46;Valencia/València;222;Sant Joanet;480;238;242
46;Valencia/València;223;Sedaví;10172;4954;5218
46;Valencia/València;224;Segart;159;80;79
46;Valencia/València;225;Sellent;382;196;186
46;Valencia/València;226;Sempere;48;25;23
46;Valencia/València;227;Senyera;1172;577;595
46;Valencia/València;228;Serra;3070;1596;1474
46;Valencia/València;229;Siete Aguas;1223;666;557
46;Valencia/València;230;Silla;18462;9181;9281
46;Valencia/València;231;Simat de la Valldigna;3341;1687;1654
46;Valencia/València;232;Sinarcas;1148;593;555
46;Valencia/València;233;Sollana;4919;2410;2509
46;Valencia/València;234;Sot de Chera;396;204;192
46;Valencia/València;235;Sueca;28090;13916;14174
46;Valencia/València;236;Sumacàrcer;1140;564;576
46;Valencia/València;237;Tavernes Blanques;9181;4498;4683
46;Valencia/València;238;Tavernes de la Valldigna;17485;8784;8701
46;Valencia/València;239;Teresa de Cofrentes;651;334;317
46;Valencia/València;240;Terrateig;296;154;142
46;Valencia/València;241;Titaguas;471;245;226
46;Valencia/València;242;Torrebaja;412;213;199
46;Valencia/València;243;Torrella;154;87;67
46;Valencia/València;244;Torrent;80762;39958;40804
46;Valencia/València;245;Torres Torres;644;346;298
46;Valencia/València;246;Tous;1270;646;624
46;Valencia/València;247;Tuéjar;1193;634;559
46;Valencia/València;248;Turís;6609;3452;3157
46;Valencia/València;249;Utiel;11748;5890;5858
46;Valencia/València;250;Valencia;790201;377233;412968
46;Valencia/València;251;Vallada;3089;1578;1511
46;Valencia/València;252;Vallanca;133;70;63
46;Valencia/València;253;Vallés;161;81;80
46;Valencia/València;254;Venta del Moro;1299;693;606
46;Valencia/València;255;Vilallonga/Villalonga;4375;2173;2202
46;Valencia/València;256;Vilamarxant;9223;4779;4444
46;Valencia/València;257;Villanueva de Castellón;7266;3603;3663
46;Valencia/València;258;Villar del Arzobispo;3565;1818;1747
46;Valencia/València;259;Villargordo del Cabriel;639;338;301
46;Valencia/València;260;Vinalesa;3310;1619;1691
46;Valencia/València;145;Xàtiva;28973;14140;14833
46;Valencia/València;143;Xeraco;5732;2909;2823
46;Valencia/València;146;Xeresa;2197;1128;1069
46;Valencia/València;110;Xirivella;28771;14176;14595
46;Valencia/València;261;Yátova;2079;1072;1007
46;Valencia/València;262;Yesa, La;242;132;110
46;Valencia/València;263;Zarra;440;239;201
47;Valladolid;001;Adalia;59;36;23
47;Valladolid;002;Aguasal;24;19;5
47;Valladolid;003;Aguilar de Campos;266;150;116
47;Valladolid;004;Alaejos;1400;741;659
47;Valladolid;005;Alcazarén;692;375;317
47;Valladolid;006;Aldea de San Miguel;226;118;108
47;Valladolid;007;Aldeamayor de San Martín;5077;2621;2456
47;Valladolid;008;Almenara de Adaja;26;12;14
47;Valladolid;009;Amusquillo;106;68;38
47;Valladolid;010;Arroyo de la Encomienda;19042;9630;9412
47;Valladolid;011;Ataquines;584;320;264
47;Valladolid;012;Bahabón;123;56;67
47;Valladolid;013;Barcial de la Loma;104;56;48
47;Valladolid;014;Barruelo del Valle;66;41;25
47;Valladolid;015;Becilla de Valderaduey;249;141;108
47;Valladolid;016;Benafarces;75;40;35
47;Valladolid;017;Bercero;215;119;96
47;Valladolid;018;Berceruelo;37;22;15
47;Valladolid;019;Berrueces;98;55;43
47;Valladolid;020;Bobadilla del Campo;303;171;132
47;Valladolid;021;Bocigas;86;47;39
47;Valladolid;022;Bocos de Duero;54;25;29
47;Valladolid;023;Boecillo;4083;2084;1999
47;Valladolid;024;Bolaños de Campos;337;184;153
47;Valladolid;025;Brahojos de Medina;130;69;61
47;Valladolid;026;Bustillo de Chaves;80;41;39
47;Valladolid;027;Cabezón de Pisuerga;3657;1869;1788
47;Valladolid;028;Cabezón de Valderaduey;37;19;18
47;Valladolid;029;Cabreros del Monte;73;40;33
47;Valladolid;030;Campaspero;1101;596;505
47;Valladolid;031;Campillo, El;217;126;91
47;Valladolid;032;Camporredondo;161;93;68
47;Valladolid;033;Canalejas de Peñafiel;242;133;109
47;Valladolid;034;Canillas de Esgueva;79;45;34
47;Valladolid;035;Carpio;1047;561;486
47;Valladolid;036;Casasola de Arión;267;151;116
47;Valladolid;037;Castrejón de Trabancos;181;90;91
47;Valladolid;038;Castrillo de Duero;124;70;54
47;Valladolid;039;Castrillo-Tejeriego;189;105;84
47;Valladolid;040;Castrobol;65;34;31
47;Valladolid;041;Castrodeza;160;97;63
47;Valladolid;042;Castromembibre;64;39;25
47;Valladolid;043;Castromonte;314;182;132
47;Valladolid;044;Castronuevo de Esgueva;391;214;177
47;Valladolid;045;Castronuño;888;440;448
47;Valladolid;046;Castroponce;146;79;67
47;Valladolid;047;Castroverde de Cerrato;227;139;88
47;Valladolid;048;Ceinos de Campos;237;132;105
47;Valladolid;049;Cervillego de la Cruz;98;56;42
47;Valladolid;050;Cigales;5032;2572;2460
47;Valladolid;051;Ciguñuela;384;201;183
47;Valladolid;052;Cistérniga;8895;4510;4385
47;Valladolid;053;Cogeces de Íscar;140;71;69
47;Valladolid;054;Cogeces del Monte;716;388;328
47;Valladolid;055;Corcos;214;112;102
47;Valladolid;056;Corrales de Duero;81;47;34
47;Valladolid;057;Cubillas de Santa Marta;307;178;129
47;Valladolid;058;Cuenca de Campos;228;120;108
47;Valladolid;059;Curiel de Duero;102;68;34
47;Valladolid;060;Encinas de Esgueva;282;163;119
47;Valladolid;061;Esguevillas de Esgueva;277;146;131
47;Valladolid;062;Fombellida;179;104;75
47;Valladolid;063;Fompedraza;113;59;54
47;Valladolid;064;Fontihoyuelo;34;20;14
47;Valladolid;065;Fresno el Viejo;946;502;444
47;Valladolid;066;Fuensaldaña;1563;800;763
47;Valladolid;067;Fuente el Sol;181;97;84
47;Valladolid;068;Fuente-Olmedo;38;19;19
47;Valladolid;069;Gallegos de Hornija;131;66;65
47;Valladolid;070;Gatón de Campos;37;19;18
47;Valladolid;071;Geria;507;249;258
47;Valladolid;073;Herrín de Campos;130;65;65
47;Valladolid;074;Hornillos de Eresma;170;93;77
47;Valladolid;075;Íscar;6516;3287;3229
47;Valladolid;076;Laguna de Duero;22696;11355;11341
47;Valladolid;077;Langayo;260;164;96
47;Valladolid;079;Llano de Olmedo;61;33;28
47;Valladolid;078;Lomoviejo;183;96;87
47;Valladolid;080;Manzanillo;47;24;23
47;Valladolid;081;Marzales;49;23;26
47;Valladolid;082;Matapozuelos;1040;526;514
47;Valladolid;083;Matilla de los Caños;108;60;48
47;Valladolid;084;Mayorga;1649;810;839
47;Valladolid;086;Medina de Rioseco;4803;2368;2435
47;Valladolid;085;Medina del Campo;20774;10043;10731
47;Valladolid;087;Megeces;444;234;210
47;Valladolid;088;Melgar de Abajo;107;59;48
47;Valladolid;089;Melgar de Arriba;177;95;82
47;Valladolid;090;Mojados;3232;1694;1538
47;Valladolid;091;Monasterio de Vega;85;46;39
47;Valladolid;092;Montealegre de Campos;122;70;52
47;Valladolid;093;Montemayor de Pililla;910;483;427
47;Valladolid;094;Moral de la Reina;180;99;81
47;Valladolid;095;Moraleja de las Panaderas;39;27;12
47;Valladolid;096;Morales de Campos;149;79;70
47;Valladolid;097;Mota del Marqués;375;194;181
47;Valladolid;098;Mucientes;692;350;342
47;Valladolid;099;Mudarra, La;160;81;79
47;Valladolid;100;Muriel;143;77;66
47;Valladolid;101;Nava del Rey;2094;1077;1017
47;Valladolid;102;Nueva Villa de las Torres;311;176;135
47;Valladolid;103;Olivares de Duero;306;171;135
47;Valladolid;104;Olmedo;3674;1811;1863
47;Valladolid;105;Olmos de Esgueva;211;114;97
47;Valladolid;106;Olmos de Peñafiel;62;34;28
47;Valladolid;109;Palazuelo de Vedija;208;108;100
47;Valladolid;110;Parrilla, La;496;250;246
47;Valladolid;111;Pedraja de Portillo, La;1151;589;562
47;Valladolid;112;Pedrajas de San Esteban;3337;1728;1609
47;Valladolid;113;Pedrosa del Rey;196;108;88
47;Valladolid;114;Peñafiel;5327;2660;2667
47;Valladolid;115;Peñaflor de Hornija;310;177;133
47;Valladolid;116;Pesquera de Duero;474;259;215
47;Valladolid;117;Piña de Esgueva;342;179;163
47;Valladolid;118;Piñel de Abajo;186;101;85
47;Valladolid;119;Piñel de Arriba;99;52;47
47;Valladolid;121;Pollos;606;318;288
47;Valladolid;122;Portillo;2455;1285;1170
47;Valladolid;123;Pozal de Gallinas;555;300;255
47;Valladolid;124;Pozaldez;484;259;225
47;Valladolid;125;Pozuelo de la Orden;60;36;24
47;Valladolid;126;Puras;58;29;29
47;Valladolid;127;Quintanilla de Arriba;153;82;71
47;Valladolid;129;Quintanilla de Onésimo;1059;548;511
47;Valladolid;130;Quintanilla de Trigueros;107;54;53
47;Valladolid;128;Quintanilla del Molar;64;28;36
47;Valladolid;131;Rábano;187;101;86
47;Valladolid;132;Ramiro;51;28;23
47;Valladolid;133;Renedo de Esgueva;3697;1885;1812
47;Valladolid;134;Roales de Campos;169;96;73
47;Valladolid;135;Robladillo;95;55;40
47;Valladolid;137;Roturas;32;19;13
47;Valladolid;138;Rubí de Bracamonte;234;130;104
47;Valladolid;139;Rueda;1294;663;631
47;Valladolid;140;Saelices de Mayorga;117;73;44
47;Valladolid;141;Salvador de Zapardiel;136;78;58
47;Valladolid;142;San Cebrián de Mazote;159;93;66
47;Valladolid;143;San Llorente;124;72;52
47;Valladolid;144;San Martín de Valvení;87;48;39
47;Valladolid;145;San Miguel del Arroyo;693;372;321
47;Valladolid;146;San Miguel del Pino;323;172;151
47;Valladolid;147;San Pablo de la Moraleja;121;63;58
47;Valladolid;148;San Pedro de Latarce;522;283;239
47;Valladolid;149;San Pelayo;45;21;24
47;Valladolid;150;San Román de Hornija;331;155;176
47;Valladolid;151;San Salvador;31;16;15
47;Valladolid;156;San Vicente del Palacio;176;95;81
47;Valladolid;152;Santa Eufemia del Arroyo;99;53;46
47;Valladolid;153;Santervás de Campos;122;67;55
47;Valladolid;154;Santibáñez de Valcorba;163;94;69
47;Valladolid;155;Santovenia de Pisuerga;4241;2183;2058
47;Valladolid;157;Sardón de Duero;610;313;297
47;Valladolid;158;Seca, La;1105;566;539
47;Valladolid;159;Serrada;1139;600;539
47;Valladolid;160;Siete Iglesias de Trabancos;474;256;218
47;Valladolid;161;Simancas;5254;2662;2592
47;Valladolid;162;Tamariz de Campos;61;33;28
47;Valladolid;163;Tiedra;311;153;158
47;Valladolid;164;Tordehumos;439;223;216
47;Valladolid;165;Tordesillas;8905;4484;4421
47;Valladolid;169;Torre de Esgueva;72;36;36
47;Valladolid;170;Torre de Peñafiel;41;24;17
47;Valladolid;166;Torrecilla de la Abadesa;291;141;150
47;Valladolid;167;Torrecilla de la Orden;260;133;127
47;Valladolid;168;Torrecilla de la Torre;30;19;11
47;Valladolid;171;Torrelobatón;436;226;210
47;Valladolid;172;Torrescárcela;161;85;76
47;Valladolid;173;Traspinedo;1089;593;496
47;Valladolid;174;Trigueros del Valle;303;164;139
47;Valladolid;175;Tudela de Duero;8582;4391;4191
47;Valladolid;176;Unión de Campos, La;254;123;131
47;Valladolid;177;Urones de Castroponce;114;66;48
47;Valladolid;178;Urueña;189;102;87
47;Valladolid;179;Valbuena de Duero;478;248;230
47;Valladolid;180;Valdearcos de la Vega;84;44;40
47;Valladolid;181;Valdenebro de los Valles;206;104;102
47;Valladolid;182;Valdestillas;1675;868;807
47;Valladolid;183;Valdunquillo;147;73;74
47;Valladolid;186;Valladolid;301876;142105;159771
47;Valladolid;184;Valoria la Buena;658;345;313
47;Valladolid;185;Valverde de Campos;103;62;41
47;Valladolid;187;Vega de Ruiponce;100;60;40
47;Valladolid;188;Vega de Valdetronco;115;65;50
47;Valladolid;189;Velascálvaro;172;94;78
47;Valladolid;190;Velilla;114;55;59
47;Valladolid;191;Velliza;106;68;38
47;Valladolid;192;Ventosa de la Cuesta;121;67;54
47;Valladolid;193;Viana de Cega;2009;1058;951
47;Valladolid;195;Villabáñez;544;304;240
47;Valladolid;196;Villabaruz de Campos;37;16;21
47;Valladolid;197;Villabrágima;1045;551;494
47;Valladolid;198;Villacarralón;84;50;34
47;Valladolid;199;Villacid de Campos;83;52;31
47;Valladolid;200;Villaco;91;58;33
47;Valladolid;203;Villafrades de Campos;67;35;32
47;Valladolid;204;Villafranca de Duero;289;152;137
47;Valladolid;205;Villafrechós;492;265;227
47;Valladolid;206;Villafuerte;94;55;39
47;Valladolid;207;Villagarcía de Campos;330;197;133
47;Valladolid;208;Villagómez la Nueva;69;37;32
47;Valladolid;209;Villalán de Campos;44;28;16
47;Valladolid;210;Villalar de los Comuneros;440;218;222
47;Valladolid;211;Villalba de la Loma;59;29;30
47;Valladolid;212;Villalba de los Alcores;422;230;192
47;Valladolid;213;Villalbarba;118;62;56
47;Valladolid;214;Villalón de Campos;1689;831;858
47;Valladolid;215;Villamuriel de Campos;59;29;30
47;Valladolid;216;Villán de Tordesillas;122;71;51
47;Valladolid;217;Villanubla;2615;1371;1244
47;Valladolid;218;Villanueva de Duero;1196;623;573
47;Valladolid;219;Villanueva de la Condesa;62;32;30
47;Valladolid;220;Villanueva de los Caballeros;176;90;86
47;Valladolid;221;Villanueva de los Infantes;112;67;45
47;Valladolid;222;Villanueva de San Mancio;83;46;37
47;Valladolid;223;Villardefrades;172;97;75
47;Valladolid;224;Villarmentero de Esgueva;98;53;45
47;Valladolid;225;Villasexmir;83;49;34
47;Valladolid;226;Villavaquerín;170;97;73
47;Valladolid;227;Villavellid;63;36;27
47;Valladolid;228;Villaverde de Medina;514;274;240
47;Valladolid;229;Villavicencio de los Caballeros;235;119;116
47;Valladolid;194;Viloria;352;182;170
47;Valladolid;230;Wamba;343;182;161
47;Valladolid;231;Zaratán;6201;3187;3014
47;Valladolid;232;Zarza, La;113;62;51
49;Zamora;002;Abezames;65;33;32
49;Zamora;003;Alcañices;1111;560;551
49;Zamora;004;Alcubilla de Nogales;134;72;62
49;Zamora;005;Alfaraz de Sayago;149;84;65
49;Zamora;006;Algodre;159;89;70
49;Zamora;007;Almaraz de Duero;405;203;202
49;Zamora;008;Almeida de Sayago;492;264;228
49;Zamora;009;Andavías;444;230;214
49;Zamora;010;Arcenillas;404;204;200
49;Zamora;011;Arcos de la Polvorosa;251;132;119
49;Zamora;012;Argañín;77;38;39
49;Zamora;013;Argujillo;271;134;137
49;Zamora;014;Arquillinos;119;63;56
49;Zamora;015;Arrabalde;247;122;125
49;Zamora;016;Aspariegos;279;127;152
49;Zamora;017;Asturianos;264;133;131
49;Zamora;018;Ayoó de Vidriales;349;177;172
49;Zamora;019;Barcial del Barco;267;144;123
49;Zamora;020;Belver de los Montes;307;162;145
49;Zamora;021;Benavente;18315;8870;9445
49;Zamora;022;Benegiles;324;171;153
49;Zamora;023;Bermillo de Sayago;1085;570;515
49;Zamora;024;Bóveda de Toro, La;760;380;380
49;Zamora;025;Bretó;182;108;74
49;Zamora;026;Bretocino;238;126;112
49;Zamora;027;Brime de Sog;147;72;75
49;Zamora;028;Brime de Urz;120;70;50
49;Zamora;029;Burganes de Valverde;682;355;327
49;Zamora;030;Bustillo del Oro;87;45;42
49;Zamora;031;Cabañas de Sayago;153;81;72
49;Zamora;032;Calzadilla de Tera;341;157;184
49;Zamora;033;Camarzana de Tera;871;435;436
49;Zamora;034;Cañizal;466;244;222
49;Zamora;035;Cañizo;243;130;113
49;Zamora;036;Carbajales de Alba;553;279;274
49;Zamora;037;Carbellino;204;109;95
49;Zamora;038;Casaseca de Campeán;100;56;44
49;Zamora;039;Casaseca de las Chanas;394;213;181
49;Zamora;040;Castrillo de la Guareña;126;66;60
49;Zamora;041;Castrogonzalo;495;267;228
49;Zamora;042;Castronuevo;243;116;127
49;Zamora;043;Castroverde de Campos;334;170;164
49;Zamora;044;Cazurra;82;45;37
49;Zamora;046;Cerecinos de Campos;297;161;136
49;Zamora;047;Cerecinos del Carrizal;116;65;51
49;Zamora;048;Cernadilla;128;64;64
49;Zamora;050;Cobreros;588;325;263
49;Zamora;052;Coomonte;202;110;92
49;Zamora;053;Coreses;1050;540;510
49;Zamora;054;Corrales del Vino;1022;505;517
49;Zamora;055;Cotanes del Monte;113;61;52
49;Zamora;056;Cubillos;328;164;164
49;Zamora;057;Cubo de Benavente;119;65;54
49;Zamora;058;Cubo de Tierra del Vino, El;347;188;159
49;Zamora;059;Cuelgamures;90;55;35
49;Zamora;061;Entrala;168;88;80
49;Zamora;062;Espadañedo;123;60;63
49;Zamora;063;Faramontanos de Tábara;365;189;176
49;Zamora;064;Fariza;548;285;263
49;Zamora;065;Fermoselle;1277;650;627
49;Zamora;066;Ferreras de Abajo;555;283;272
49;Zamora;067;Ferreras de Arriba;405;217;188
49;Zamora;068;Ferreruela;504;273;231
49;Zamora;069;Figueruela de Arriba;378;180;198
49;Zamora;071;Fonfría;823;419;404
49;Zamora;075;Fresno de la Polvorosa;149;79;70
49;Zamora;076;Fresno de la Ribera;371;205;166
49;Zamora;077;Fresno de Sayago;199;107;92
49;Zamora;078;Friera de Valverde;177;95;82
49;Zamora;079;Fuente Encalada;114;65;49
49;Zamora;080;Fuentelapeña;761;412;349
49;Zamora;082;Fuentes de Ropel;409;210;199
49;Zamora;081;Fuentesaúco;1606;794;812
49;Zamora;083;Fuentesecas;58;27;31
49;Zamora;084;Fuentespreadas;322;175;147
49;Zamora;085;Galende;1141;589;552
49;Zamora;086;Gallegos del Pan;125;73;52
49;Zamora;087;Gallegos del Río;544;299;245
49;Zamora;088;Gamones;99;56;43
49;Zamora;090;Gema;229;119;110
49;Zamora;091;Granja de Moreruela;292;153;139
49;Zamora;092;Granucillo;138;68;70
49;Zamora;093;Guarrate;343;175;168
49;Zamora;094;Hermisende;251;132;119
49;Zamora;095;Hiniesta, La;330;170;160
49;Zamora;096;Jambrina;174;92;82
49;Zamora;097;Justel;88;53;35
49;Zamora;098;Losacino;230;127;103
49;Zamora;099;Losacio;125;64;61
49;Zamora;100;Lubián;326;174;152
49;Zamora;101;Luelmo;164;86;78
49;Zamora;102;Maderal, El;206;107;99
49;Zamora;103;Madridanos;481;253;228
49;Zamora;104;Mahide;353;193;160
49;Zamora;105;Maire de Castroponce;161;85;76
49;Zamora;107;Malva;132;64;68
49;Zamora;108;Manganeses de la Lampreana;499;249;250
49;Zamora;109;Manganeses de la Polvorosa;707;347;360
49;Zamora;110;Manzanal de Arriba;373;198;175
49;Zamora;112;Manzanal de los Infantes;138;77;61
49;Zamora;111;Manzanal del Barco;136;72;64
49;Zamora;113;Matilla de Arzón;174;101;73
49;Zamora;114;Matilla la Seca;45;24;21
49;Zamora;115;Mayalde;202;108;94
49;Zamora;116;Melgar de Tera;409;214;195
49;Zamora;117;Micereces de Tera;488;241;247
49;Zamora;118;Milles de la Polvorosa;228;123;105
49;Zamora;119;Molacillos;268;147;121
49;Zamora;120;Molezuelas de la Carballeda;82;42;40
49;Zamora;121;Mombuey;425;227;198
49;Zamora;122;Monfarracinos;986;505;481
49;Zamora;123;Montamarta;587;310;277
49;Zamora;124;Moral de Sayago;271;152;119
49;Zamora;126;Moraleja de Sayago;249;130;119
49;Zamora;125;Moraleja del Vino;1692;875;817
49;Zamora;128;Morales de Rey;599;305;294
49;Zamora;129;Morales de Toro;1008;527;481
49;Zamora;130;Morales de Valverde;187;96;91
49;Zamora;127;Morales del Vino;2966;1551;1415
49;Zamora;131;Moralina;282;145;137
49;Zamora;132;Moreruela de los Infanzones;362;187;175
49;Zamora;133;Moreruela de Tábara;332;166;166
49;Zamora;134;Muelas de los Caballeros;188;103;85
49;Zamora;135;Muelas del Pan;677;344;333
49;Zamora;136;Muga de Sayago;368;179;189
49;Zamora;137;Navianos de Valverde;203;112;91
49;Zamora;138;Olmillos de Castro;248;133;115
49;Zamora;139;Otero de Bodas;178;94;84
49;Zamora;141;Pajares de la Lampreana;365;179;186
49;Zamora;143;Palacios de Sanabria;260;133;127
49;Zamora;142;Palacios del Pan;261;136;125
49;Zamora;145;Pedralba de la Pradería;292;155;137
49;Zamora;146;Pego, El;314;157;157
49;Zamora;147;Peleagonzalo;258;129;129
49;Zamora;148;Peleas de Abajo;259;132;127
49;Zamora;149;Peñausende;415;206;209
49;Zamora;150;Peque;147;63;84
49;Zamora;151;Perdigón, El;720;389;331
49;Zamora;152;Pereruela;578;312;266
49;Zamora;153;Perilla de Castro;181;91;90
49;Zamora;154;Pías;138;75;63
49;Zamora;155;Piedrahita de Castro;88;47;41
49;Zamora;156;Pinilla de Toro;247;132;115
49;Zamora;157;Pino del Oro;215;118;97
49;Zamora;158;Piñero, El;242;129;113
49;Zamora;160;Pobladura de Valderaduey;44;23;21
49;Zamora;159;Pobladura del Valle;310;161;149
49;Zamora;162;Porto;188;104;84
49;Zamora;163;Pozoantiguo;242;125;117
49;Zamora;164;Pozuelo de Tábara;172;88;84
49;Zamora;165;Prado;59;34;25
49;Zamora;166;Puebla de Sanabria;1460;704;756
49;Zamora;167;Pueblica de Valverde;214;114;100
49;Zamora;170;Quintanilla de Urz;106;53;53
49;Zamora;168;Quintanilla del Monte;102;49;53
49;Zamora;169;Quintanilla del Olmo;32;16;16
49;Zamora;171;Quiruelas de Vidriales;706;359;347
49;Zamora;172;Rabanales;562;292;270
49;Zamora;173;Rábano de Aliste;405;198;207
49;Zamora;174;Requejo;149;76;73
49;Zamora;175;Revellinos;269;144;125
49;Zamora;176;Riofrío de Aliste;739;395;344
49;Zamora;177;Rionegro del Puente;297;152;145
49;Zamora;178;Roales;856;459;397
49;Zamora;179;Robleda-Cervantes;448;237;211
49;Zamora;180;Roelos de Sayago;171;80;91
49;Zamora;181;Rosinos de la Requejada;387;208;179
49;Zamora;183;Salce;103;46;57
49;Zamora;184;Samir de los Caños;182;101;81
49;Zamora;185;San Agustín del Pozo;188;102;86
49;Zamora;186;San Cebrián de Castro;269;131;138
49;Zamora;187;San Cristóbal de Entreviñas;1454;761;693
49;Zamora;188;San Esteban del Molar;125;73;52
49;Zamora;189;San Justo;234;124;110
49;Zamora;190;San Martín de Valderaduey;63;33;30
49;Zamora;191;San Miguel de la Ribera;303;150;153
49;Zamora;192;San Miguel del Valle;145;70;75
49;Zamora;193;San Pedro de Ceque;503;261;242
49;Zamora;194;San Pedro de la Nave-Almendra;370;188;182
49;Zamora;208;San Vicente de la Cabeza;417;219;198
49;Zamora;209;San Vitero;543;301;242
49;Zamora;197;Santa Clara de Avedillo;180;93;87
49;Zamora;199;Santa Colomba de las Monjas;276;139;137
49;Zamora;200;Santa Cristina de la Polvorosa;1088;554;534
49;Zamora;201;Santa Croya de Tera;322;162;160
49;Zamora;202;Santa Eufemia del Barco;189;109;80
49;Zamora;203;Santa María de la Vega;342;172;170
49;Zamora;204;Santa María de Valverde;60;25;35
49;Zamora;205;Santibáñez de Tera;400;205;195
49;Zamora;206;Santibáñez de Vidriales;1021;521;500
49;Zamora;207;Santovenia;268;131;137
49;Zamora;210;Sanzoles;539;272;267
49;Zamora;214;Tábara;797;412;385
49;Zamora;216;Tapioles;164;96;68
49;Zamora;219;Toro;9115;4428;4687
49;Zamora;220;Torre del Valle, La;148;77;71
49;Zamora;221;Torregamones;294;156;138
49;Zamora;222;Torres del Carrizal;430;213;217
49;Zamora;223;Trabazos;967;508;459
49;Zamora;224;Trefacio;186;96;90
49;Zamora;225;Uña de Quintana;150;76;74
49;Zamora;226;Vadillo de la Guareña;279;148;131
49;Zamora;227;Valcabado;359;183;176
49;Zamora;228;Valdefinjas;54;32;22
49;Zamora;229;Valdescorriel;141;69;72
49;Zamora;230;Vallesa de la Guareña;99;53;46
49;Zamora;231;Vega de Tera;371;182;189
49;Zamora;232;Vega de Villalobos;117;56;61
49;Zamora;233;Vegalatrave;92;50;42
49;Zamora;234;Venialbo;473;256;217
49;Zamora;235;Vezdemarbán;417;212;205
49;Zamora;236;Vidayanes;88;45;43
49;Zamora;237;Videmala;172;90;82
49;Zamora;238;Villabrázaro;226;121;105
49;Zamora;239;Villabuena del Puente;734;378;356
49;Zamora;240;Villadepera;221;121;100
49;Zamora;241;Villaescusa;261;142;119
49;Zamora;242;Villafáfila;478;245;233
49;Zamora;243;Villaferrueña;115;57;58
49;Zamora;244;Villageriz;49;29;20
49;Zamora;245;Villalazán;284;139;145
49;Zamora;246;Villalba de la Lampreana;246;136;110
49;Zamora;247;Villalcampo;471;234;237
49;Zamora;248;Villalobos;255;129;126
49;Zamora;249;Villalonso;96;54;42
49;Zamora;250;Villalpando;1528;756;772
49;Zamora;251;Villalube;169;88;81
49;Zamora;252;Villamayor de Campos;322;165;157
49;Zamora;255;Villamor de los Escuderos;418;220;198
49;Zamora;256;Villanázar;289;148;141
49;Zamora;257;Villanueva de Azoague;331;171;160
49;Zamora;258;Villanueva de Campeán;122;70;52
49;Zamora;259;Villanueva de las Peras;88;49;39
49;Zamora;260;Villanueva del Campo;900;448;452
49;Zamora;263;Villar de Fallaves;46;25;21
49;Zamora;264;Villar del Buey;620;322;298
49;Zamora;261;Villaralbo;1880;961;919
49;Zamora;262;Villardeciervos;450;218;232
49;Zamora;265;Villardiegua de la Ribera;133;67;66
49;Zamora;266;Villárdiga;84;46;38
49;Zamora;267;Villardondiego;97;53;44
49;Zamora;268;Villarrín de Campos;425;230;195
49;Zamora;269;Villaseco del Pan;249;119;130
49;Zamora;270;Villavendimio;170;103;67
49;Zamora;272;Villaveza de Valverde;89;44;45
49;Zamora;271;Villaveza del Agua;209;114;95
49;Zamora;273;Viñas;199;104;95
49;Zamora;275;Zamora;63217;29542;33675
50;Zaragoza;001;Abanto;106;59;47
50;Zaragoza;002;Acered;223;134;89
50;Zaragoza;003;Agón;155;87;68
50;Zaragoza;004;Aguarón;686;358;328
50;Zaragoza;005;Aguilón;247;134;113
50;Zaragoza;006;Ainzón;1136;582;554
50;Zaragoza;007;Aladrén;48;32;16
50;Zaragoza;008;Alagón;7045;3491;3554
50;Zaragoza;009;Alarba;137;82;55
50;Zaragoza;010;Alberite de San Juan;80;46;34
50;Zaragoza;011;Albeta;139;67;72
50;Zaragoza;012;Alborge;111;58;53
50;Zaragoza;013;Alcalá de Ebro;263;124;139
50;Zaragoza;014;Alcalá de Moncayo;175;100;75
50;Zaragoza;015;Alconchel de Ariza;76;43;33
50;Zaragoza;016;Aldehuela de Liestos;53;38;15
50;Zaragoza;017;Alfajarín;2298;1188;1110
50;Zaragoza;018;Alfamén;1466;776;690
50;Zaragoza;019;Alforque;58;33;25
50;Zaragoza;020;Alhama de Aragón;1034;534;500
50;Zaragoza;021;Almochuel;31;14;17
50;Zaragoza;022;Almolda, La;581;291;290
50;Zaragoza;023;Almonacid de la Cuba;261;132;129
50;Zaragoza;024;Almonacid de la Sierra;703;387;316
50;Zaragoza;025;Almunia de Doña Godina, La;7692;3896;3796
50;Zaragoza;026;Alpartir;547;278;269
50;Zaragoza;027;Ambel;256;125;131
50;Zaragoza;028;Anento;101;65;36
50;Zaragoza;029;Aniñón;740;401;339
50;Zaragoza;030;Añón de Moncayo;197;118;79
50;Zaragoza;031;Aranda de Moncayo;186;118;68
50;Zaragoza;032;Arándiga;317;163;154
50;Zaragoza;033;Ardisa;72;46;26
50;Zaragoza;034;Ariza;1139;575;564
50;Zaragoza;035;Artieda;79;46;33
50;Zaragoza;036;Asín;106;53;53
50;Zaragoza;037;Atea;131;80;51
50;Zaragoza;038;Ateca;1856;956;900
50;Zaragoza;039;Azuara;576;320;256
50;Zaragoza;040;Badules;88;51;37
50;Zaragoza;041;Bagüés;12;8;4
50;Zaragoza;042;Balconchán;14;5;9
50;Zaragoza;043;Bárboles;326;175;151
50;Zaragoza;044;Bardallur;272;132;140
50;Zaragoza;045;Belchite;1559;787;772
50;Zaragoza;046;Belmonte de Gracián;211;118;93
50;Zaragoza;047;Berdejo;52;33;19
50;Zaragoza;048;Berrueco;35;19;16
50;Zaragoza;901;Biel;143;84;59
50;Zaragoza;050;Bijuesca;99;63;36
50;Zaragoza;051;Biota;971;493;478
50;Zaragoza;052;Bisimbre;102;58;44
50;Zaragoza;053;Boquiñeni;852;430;422
50;Zaragoza;054;Bordalba;59;38;21
50;Zaragoza;055;Borja;4955;2485;2470
50;Zaragoza;056;Botorrita;489;268;221
50;Zaragoza;057;Brea de Aragón;1694;860;834
50;Zaragoza;058;Bubierca;69;35;34
50;Zaragoza;059;Bujaraloz;996;518;478
50;Zaragoza;060;Bulbuente;227;122;105
50;Zaragoza;061;Bureta;237;126;111
50;Zaragoza;062;Burgo de Ebro, El;2383;1199;1184
50;Zaragoza;063;Buste, El;64;35;29
50;Zaragoza;064;Cabañas de Ebro;508;269;239
50;Zaragoza;065;Cabolafuente;35;20;15
50;Zaragoza;066;Cadrete;3655;1934;1721
50;Zaragoza;067;Calatayud;20191;9981;10210
50;Zaragoza;068;Calatorao;2829;1487;1342
50;Zaragoza;069;Calcena;72;43;29
50;Zaragoza;070;Calmarza;71;41;30
50;Zaragoza;071;Campillo de Aragón;142;80;62
50;Zaragoza;072;Carenas;172;89;83
50;Zaragoza;073;Cariñena;3384;1709;1675
50;Zaragoza;074;Caspe;9538;4925;4613
50;Zaragoza;075;Castejón de Alarba;85;51;34
50;Zaragoza;076;Castejón de las Armas;91;49;42
50;Zaragoza;077;Castejón de Valdejasa;226;115;111
50;Zaragoza;078;Castiliscar;264;136;128
50;Zaragoza;079;Cervera de la Cañada;305;169;136
50;Zaragoza;080;Cerveruela;34;21;13
50;Zaragoza;081;Cetina;615;318;297
50;Zaragoza;092;Chiprana;483;253;230
50;Zaragoza;093;Chodes;125;69;56
50;Zaragoza;082;Cimballa;109;54;55
50;Zaragoza;083;Cinco Olivas;110;52;58
50;Zaragoza;084;Clarés de Ribota;80;49;31
50;Zaragoza;085;Codo;182;92;90
50;Zaragoza;086;Codos;226;141;85
50;Zaragoza;087;Contamina;35;20;15
50;Zaragoza;088;Cosuenda;384;203;181
50;Zaragoza;089;Cuarte de Huerva;12581;6496;6085
50;Zaragoza;090;Cubel;175;84;91
50;Zaragoza;091;Cuerlas, Las;44;24;20
50;Zaragoza;094;Daroca;2087;1029;1058
50;Zaragoza;095;Ejea de los Caballeros;16541;8428;8113
50;Zaragoza;096;Embid de Ariza;41;20;21
50;Zaragoza;098;Encinacorba;205;102;103
50;Zaragoza;099;Épila;4452;2322;2130
50;Zaragoza;100;Erla;364;182;182
50;Zaragoza;101;Escatrón;1069;530;539
50;Zaragoza;102;Fabara;1184;635;549
50;Zaragoza;104;Farlete;404;201;203
50;Zaragoza;105;Fayón;354;183;171
50;Zaragoza;106;Fayos, Los;147;79;68
50;Zaragoza;107;Figueruelas;1218;608;610
50;Zaragoza;108;Fombuena;54;33;21
50;Zaragoza;109;Frago, El;101;62;39
50;Zaragoza;110;Frasno, El;399;218;181
50;Zaragoza;111;Fréscano;201;107;94
50;Zaragoza;113;Fuendejalón;786;420;366
50;Zaragoza;114;Fuendetodos;126;67;59
50;Zaragoza;115;Fuentes de Ebro;4566;2382;2184
50;Zaragoza;116;Fuentes de Jiloca;269;147;122
50;Zaragoza;117;Gallocanta;152;84;68
50;Zaragoza;118;Gallur;2630;1329;1301
50;Zaragoza;119;Gelsa;1098;572;526
50;Zaragoza;120;Godojos;53;27;26
50;Zaragoza;121;Gotor;326;170;156
50;Zaragoza;122;Grisel;71;42;29
50;Zaragoza;123;Grisén;622;315;307
50;Zaragoza;124;Herrera de los Navarros;536;281;255
50;Zaragoza;125;Ibdes;429;225;204
50;Zaragoza;126;Illueca;3109;1540;1569
50;Zaragoza;128;Isuerre;32;21;11
50;Zaragoza;129;Jaraba;315;159;156
50;Zaragoza;130;Jarque;457;251;206
50;Zaragoza;131;Jaulín;254;129;125
50;Zaragoza;132;Joyosa, La;1032;530;502
50;Zaragoza;133;Lagata;126;71;55
50;Zaragoza;134;Langa del Castillo;134;66;68
50;Zaragoza;135;Layana;101;56;45
50;Zaragoza;136;Lécera;726;395;331
50;Zaragoza;138;Lechón;51;29;22
50;Zaragoza;137;Leciñena;1215;619;596
50;Zaragoza;139;Letux;350;195;155
50;Zaragoza;140;Litago;171;95;76
50;Zaragoza;141;Lituénigo;118;62;56
50;Zaragoza;142;Lobera de Onsella;32;18;14
50;Zaragoza;143;Longares;789;449;340
50;Zaragoza;144;Longás;35;23;12
50;Zaragoza;146;Lucena de Jalón;229;125;104
50;Zaragoza;147;Luceni;989;510;479
50;Zaragoza;148;Luesia;322;175;147
50;Zaragoza;149;Luesma;35;22;13
50;Zaragoza;150;Lumpiaque;867;448;419
50;Zaragoza;151;Luna;733;385;348
50;Zaragoza;152;Maella;1970;1066;904
50;Zaragoza;153;Magallón;1157;599;558
50;Zaragoza;154;Mainar;147;79;68
50;Zaragoza;155;Malanquilla;107;66;41
50;Zaragoza;156;Maleján;254;129;125
50;Zaragoza;160;Mallén;3187;1668;1519
50;Zaragoza;157;Malón;351;176;175
50;Zaragoza;159;Maluenda;989;483;506
50;Zaragoza;161;Manchones;120;71;49
50;Zaragoza;162;Mara;191;96;95
50;Zaragoza;163;María de Huerva;5550;2866;2684
50;Zaragoza;902;Marracos;91;51;40
50;Zaragoza;164;Mediana de Aragón;443;212;231
50;Zaragoza;165;Mequinenza;2316;1179;1137
50;Zaragoza;166;Mesones de Isuela;286;142;144
50;Zaragoza;167;Mezalocha;254;149;105
50;Zaragoza;168;Mianos;28;17;11
50;Zaragoza;169;Miedes de Aragón;467;256;211
50;Zaragoza;170;Monegrillo;418;236;182
50;Zaragoza;171;Moneva;111;65;46
50;Zaragoza;172;Monreal de Ariza;214;122;92
50;Zaragoza;173;Monterde;198;115;83
50;Zaragoza;174;Montón;103;63;40
50;Zaragoza;175;Morata de Jalón;1177;576;601
50;Zaragoza;176;Morata de Jiloca;272;160;112
50;Zaragoza;177;Morés;349;187;162
50;Zaragoza;178;Moros;383;197;186
50;Zaragoza;179;Moyuela;265;145;120
50;Zaragoza;180;Mozota;124;60;64
50;Zaragoza;181;Muel;1312;667;645
50;Zaragoza;182;Muela, La;5090;2657;2433
50;Zaragoza;183;Munébrega;410;224;186
50;Zaragoza;184;Murero;129;74;55
50;Zaragoza;185;Murillo de Gállego;168;100;68
50;Zaragoza;186;Navardún;42;26;16
50;Zaragoza;187;Nigüella;76;44;32
50;Zaragoza;188;Nombrevilla;32;18;14
50;Zaragoza;189;Nonaspe;992;529;463
50;Zaragoza;190;Novallas;871;471;400
50;Zaragoza;191;Novillas;560;277;283
50;Zaragoza;192;Nuévalos;335;179;156
50;Zaragoza;193;Nuez de Ebro;840;429;411
50;Zaragoza;194;Olvés;120;69;51
50;Zaragoza;195;Orcajo;58;39;19
50;Zaragoza;196;Orera;122;63;59
50;Zaragoza;197;Orés;108;65;43
50;Zaragoza;198;Oseja;60;36;24
50;Zaragoza;199;Osera de Ebro;403;201;202
50;Zaragoza;200;Paniza;673;356;317
50;Zaragoza;201;Paracuellos de Jiloca;591;307;284
50;Zaragoza;202;Paracuellos de la Ribera;162;83;79
50;Zaragoza;203;Pastriz;1302;612;690
50;Zaragoza;204;Pedrola;3450;1795;1655
50;Zaragoza;205;Pedrosas, Las;107;53;54
50;Zaragoza;206;Perdiguera;603;316;287
50;Zaragoza;207;Piedratajada;112;59;53
50;Zaragoza;208;Pina de Ebro;2443;1262;1181
50;Zaragoza;209;Pinseque;3726;1945;1781
50;Zaragoza;210;Pintanos, Los;43;25;18
50;Zaragoza;211;Plasencia de Jalón;320;174;146
50;Zaragoza;212;Pleitas;44;19;25
50;Zaragoza;213;Plenas;105;59;46
50;Zaragoza;214;Pomer;33;23;10
50;Zaragoza;215;Pozuel de Ariza;24;16;8
50;Zaragoza;216;Pozuelo de Aragón;282;150;132
50;Zaragoza;217;Pradilla de Ebro;548;290;258
50;Zaragoza;218;Puebla de Albortón;118;73;45
50;Zaragoza;219;Puebla de Alfindén, La;6028;3086;2942
50;Zaragoza;220;Puendeluna;44;24;20
50;Zaragoza;221;Purujosa;38;26;12
50;Zaragoza;222;Quinto;1996;1016;980
50;Zaragoza;223;Remolinos;1113;575;538
50;Zaragoza;224;Retascón;76;46;30
50;Zaragoza;225;Ricla;3027;1580;1447
50;Zaragoza;227;Romanos;127;69;58
50;Zaragoza;228;Rueda de Jalón;328;178;150
50;Zaragoza;229;Ruesca;73;36;37
50;Zaragoza;241;Sabiñán;722;383;339
50;Zaragoza;230;Sádaba;1366;697;669
50;Zaragoza;231;Salillas de Jalón;304;153;151
50;Zaragoza;232;Salvatierra de Esca;208;102;106
50;Zaragoza;233;Samper del Salz;117;69;48
50;Zaragoza;234;San Martín de la Virgen de Moncayo;286;162;124
50;Zaragoza;235;San Mateo de Gállego;3060;1575;1485
50;Zaragoza;236;Santa Cruz de Grío;123;72;51
50;Zaragoza;237;Santa Cruz de Moncayo;130;69;61
50;Zaragoza;238;Santa Eulalia de Gállego;102;55;47
50;Zaragoza;239;Santed;62;40;22
50;Zaragoza;240;Sástago;1183;597;586
50;Zaragoza;242;Sediles;102;63;39
50;Zaragoza;243;Sestrica;391;226;165
50;Zaragoza;244;Sierra de Luna;262;140;122
50;Zaragoza;245;Sigüés;93;51;42
50;Zaragoza;246;Sisamón;35;24;11
50;Zaragoza;247;Sobradiel;1079;514;565
50;Zaragoza;248;Sos del Rey Católico;605;313;292
50;Zaragoza;249;Tabuenca;343;197;146
50;Zaragoza;250;Talamantes;55;27;28
50;Zaragoza;251;Tarazona;10713;5307;5406
50;Zaragoza;252;Tauste;6933;3444;3489
50;Zaragoza;253;Terrer;497;271;226
50;Zaragoza;254;Tierga;197;108;89
50;Zaragoza;255;Tobed;225;120;105
50;Zaragoza;256;Torralba de los Frailes;87;46;41
50;Zaragoza;257;Torralba de Ribota;188;109;79
50;Zaragoza;258;Torralbilla;58;32;26
50;Zaragoza;259;Torrehermosa;67;38;29
50;Zaragoza;260;Torrelapaja;33;20;13
50;Zaragoza;261;Torrellas;248;131;117
50;Zaragoza;262;Torres de Berrellén;1477;775;702
50;Zaragoza;263;Torrijo de la Cañada;231;128;103
50;Zaragoza;264;Tosos;195;108;87
50;Zaragoza;265;Trasmoz;96;54;42
50;Zaragoza;266;Trasobares;126;77;49
50;Zaragoza;267;Uncastillo;668;317;351
50;Zaragoza;268;Undués de Lerda;58;34;24
50;Zaragoza;269;Urrea de Jalón;404;215;189
50;Zaragoza;270;Urriés;40;21;19
50;Zaragoza;271;Used;267;148;119
50;Zaragoza;272;Utebo;18466;9197;9269
50;Zaragoza;274;Val de San Martín;70;40;30
50;Zaragoza;273;Valdehorna;28;13;15
50;Zaragoza;275;Valmadrid;122;77;45
50;Zaragoza;276;Valpalmas;147;70;77
50;Zaragoza;277;Valtorres;73;34;39
50;Zaragoza;278;Velilla de Ebro;231;121;110
50;Zaragoza;279;Velilla de Jiloca;114;55;59
50;Zaragoza;280;Vera de Moncayo;383;198;185
50;Zaragoza;281;Vierlas;85;46;39
50;Zaragoza;283;Villadoz;82;47;35
50;Zaragoza;284;Villafeliche;184;95;89
50;Zaragoza;285;Villafranca de Ebro;829;405;424
50;Zaragoza;286;Villalba de Perejil;99;49;50
50;Zaragoza;287;Villalengua;336;181;155
50;Zaragoza;903;Villamayor de Gállego;2753;1392;1361
50;Zaragoza;288;Villanueva de Gállego;4678;2360;2318
50;Zaragoza;290;Villanueva de Huerva;473;246;227
50;Zaragoza;289;Villanueva de Jiloca;57;27;30
50;Zaragoza;291;Villar de los Navarros;110;62;48
50;Zaragoza;292;Villarreal de Huerva;242;132;110
50;Zaragoza;293;Villarroya de la Sierra;478;258;220
50;Zaragoza;294;Villarroya del Campo;76;41;35
50;Zaragoza;282;Vilueña, La;100;52;48
50;Zaragoza;295;Vistabella;48;30;18
50;Zaragoza;296;Zaida, La;461;226;235
50;Zaragoza;297;Zaragoza;661108;317555;343553
50;Zaragoza;298;Zuera;7978;4093;3885
51;Ceuta;001;Ceuta;84519;42846;41673
52;Melilla;001;Melilla;86026;43768;42258
;;;;46557008;22843610;23713398
